"시점","구군별(1)","연령별(1)",계,남자,여자
"2020.01","중구","65세 이상",10923,4676,6247
"2020.01","서구","65세 이상",26299,11126,15173
"2020.01","동구","65세 이상",22600,9439,13161
"2020.01","영도구","65세 이상",30318,12888,17430
"2020.01","부산진구","65세 이상",67692,29166,38526
"2020.01","동래구","65세 이상",47345,21001,26344
"2020.01","남구","65세 이상",52161,22738,29423
"2020.01","북구","65세 이상",46355,20505,25850
"2020.01","해운대구","65세 이상",67078,28768,38310
"2020.01","사하구","65세 이상",56558,25049,31509
"2020.01","금정구","65세 이상",47039,20515,26524
"2020.01","강서구","65세 이상",15449,7250,8199
"2020.01","연제구","65세 이상",38247,16895,21352
"2020.01","수영구","65세 이상",36007,15603,20404
"2020.01","사상구","65세 이상",36807,16474,20333
"2020.01","기장군","65세 이상",25584,10898,14686
"2020.02","중구","65세 이상",10985,4705,6280
"2020.02","서구","65세 이상",26380,11142,15238
"2020.02","동구","65세 이상",22704,9482,13222
"2020.02","영도구","65세 이상",30465,12944,17521
"2020.02","부산진구","65세 이상",68061,29327,38734
"2020.02","동래구","65세 이상",47705,21145,26560
"2020.02","남구","65세 이상",52380,22821,29559
"2020.02","북구","65세 이상",46686,20642,26044
"2020.02","해운대구","65세 이상",67471,28965,38506
"2020.02","사하구","65세 이상",56979,25252,31727
"2020.02","금정구","65세 이상",47279,20618,26661
"2020.02","강서구","65세 이상",15575,7306,8269
"2020.02","연제구","65세 이상",38546,17028,21518
"2020.02","수영구","65세 이상",36220,15704,20516
"2020.02","사상구","65세 이상",37126,16635,20491
"2020.02","기장군","65세 이상",25797,10997,14800
"2020.03","중구","65세 이상",11062,4736,6326
"2020.03","서구","65세 이상",26604,11241,15363
"2020.03","동구","65세 이상",22951,9573,13378
"2020.03","영도구","65세 이상",30712,13035,17677
"2020.03","부산진구","65세 이상",68609,29536,39073
"2020.03","동래구","65세 이상",48250,21384,26866
"2020.03","남구","65세 이상",52688,22970,29718
"2020.03","북구","65세 이상",47188,20844,26344
"2020.03","해운대구","65세 이상",68063,29239,38824
"2020.03","사하구","65세 이상",57552,25539,32013
"2020.03","금정구","65세 이상",47580,20737,26843
"2020.03","강서구","65세 이상",15719,7385,8334
"2020.03","연제구","65세 이상",38935,17211,21724
"2020.03","수영구","65세 이상",36510,15798,20712
"2020.03","사상구","65세 이상",37496,16820,20676
"2020.03","기장군","65세 이상",26118,11149,14969
"2020.04","중구","65세 이상",11098,4759,6339
"2020.04","서구","65세 이상",26702,11276,15426
"2020.04","동구","65세 이상",23069,9617,13452
"2020.04","영도구","65세 이상",30833,13087,17746
"2020.04","부산진구","65세 이상",68930,29678,39252
"2020.04","동래구","65세 이상",48461,21458,27003
"2020.04","남구","65세 이상",52841,23013,29828
"2020.04","북구","65세 이상",47452,20936,26516
"2020.04","해운대구","65세 이상",68423,29397,39026
"2020.04","사하구","65세 이상",57796,25651,32145
"2020.04","금정구","65세 이상",47770,20809,26961
"2020.04","강서구","65세 이상",15776,7414,8362
"2020.04","연제구","65세 이상",39164,17303,21861
"2020.04","수영구","65세 이상",36688,15869,20819
"2020.04","사상구","65세 이상",37748,16931,20817
"2020.04","기장군","65세 이상",26270,11216,15054
"2020.05","중구","65세 이상",11136,4774,6362
"2020.05","서구","65세 이상",26808,11326,15482
"2020.05","동구","65세 이상",23131,9628,13503
"2020.05","영도구","65세 이상",30909,13128,17781
"2020.05","부산진구","65세 이상",69294,29839,39455
"2020.05","동래구","65세 이상",48673,21549,27124
"2020.05","남구","65세 이상",52992,23081,29911
"2020.05","북구","65세 이상",47772,21088,26684
"2020.05","해운대구","65세 이상",68676,29503,39173
"2020.05","사하구","65세 이상",58019,25727,32292
"2020.05","금정구","65세 이상",47928,20867,27061
"2020.05","강서구","65세 이상",15921,7495,8426
"2020.05","연제구","65세 이상",39328,17346,21982
"2020.05","수영구","65세 이상",36869,15930,20939
"2020.05","사상구","65세 이상",37903,17007,20896
"2020.05","기장군","65세 이상",26480,11315,15165
"2020.06","중구","65세 이상",11151,4781,6370
"2020.06","서구","65세 이상",26842,11322,15520
"2020.06","동구","65세 이상",23218,9668,13550
"2020.06","영도구","65세 이상",30999,13176,17823
"2020.06","부산진구","65세 이상",69517,29927,39590
"2020.06","동래구","65세 이상",48874,21625,27249
"2020.06","남구","65세 이상",53072,23101,29971
"2020.06","북구","65세 이상",47928,21151,26777
"2020.06","해운대구","65세 이상",68893,29586,39307
"2020.06","사하구","65세 이상",58252,25834,32418
"2020.06","금정구","65세 이상",48002,20898,27104
"2020.06","강서구","65세 이상",15950,7522,8428
"2020.06","연제구","65세 이상",39435,17381,22054
"2020.06","수영구","65세 이상",36969,15967,21002
"2020.06","사상구","65세 이상",38012,17066,20946
"2020.06","기장군","65세 이상",26661,11395,15266
"2020.07","중구","65세 이상",11183,4791,6392
"2020.07","서구","65세 이상",26920,11364,15556
"2020.07","동구","65세 이상",23269,9694,13575
"2020.07","영도구","65세 이상",31092,13206,17886
"2020.07","부산진구","65세 이상",69722,30032,39690
"2020.07","동래구","65세 이상",49074,21696,27378
"2020.07","남구","65세 이상",53233,23171,30062
"2020.07","북구","65세 이상",48097,21208,26889
"2020.07","해운대구","65세 이상",69178,29706,39472
"2020.07","사하구","65세 이상",58480,25934,32546
"2020.07","금정구","65세 이상",48106,20910,27196
"2020.07","강서구","65세 이상",16018,7569,8449
"2020.07","연제구","65세 이상",39579,17450,22129
"2020.07","수영구","65세 이상",37054,16005,21049
"2020.07","사상구","65세 이상",38154,17118,21036
"2020.07","기장군","65세 이상",26842,11492,15350
"2020.08","중구","65세 이상",11230,4803,6427
"2020.08","서구","65세 이상",27017,11407,15610
"2020.08","동구","65세 이상",23343,9709,13634
"2020.08","영도구","65세 이상",31185,13240,17945
"2020.08","부산진구","65세 이상",69941,30130,39811
"2020.08","동래구","65세 이상",49281,21767,27514
"2020.08","남구","65세 이상",53448,23288,30160
"2020.08","북구","65세 이상",48359,21347,27012
"2020.08","해운대구","65세 이상",69469,29820,39649
"2020.08","사하구","65세 이상",58775,26059,32716
"2020.08","금정구","65세 이상",48288,20998,27290
"2020.08","강서구","65세 이상",16151,7626,8525
"2020.08","연제구","65세 이상",39825,17561,22264
"2020.08","수영구","65세 이상",37155,16052,21103
"2020.08","사상구","65세 이상",38347,17201,21146
"2020.08","기장군","65세 이상",27047,11589,15458
"2020.09","중구","65세 이상",11276,4813,6463
"2020.09","서구","65세 이상",27110,11451,15659
"2020.09","동구","65세 이상",23403,9736,13667
"2020.09","영도구","65세 이상",31290,13287,18003
"2020.09","부산진구","65세 이상",70157,30237,39920
"2020.09","동래구","65세 이상",49528,21868,27660
"2020.09","남구","65세 이상",53606,23343,30263
"2020.09","북구","65세 이상",48650,21484,27166
"2020.09","해운대구","65세 이상",69791,29960,39831
"2020.09","사하구","65세 이상",59040,26181,32859
"2020.09","금정구","65세 이상",48476,21059,27417
"2020.09","강서구","65세 이상",16338,7724,8614
"2020.09","연제구","65세 이상",40045,17671,22374
"2020.09","수영구","65세 이상",37336,16130,21206
"2020.09","사상구","65세 이상",38567,17303,21264
"2020.09","기장군","65세 이상",27220,11664,15556
"2020.10","중구","65세 이상",11309,4828,6481
"2020.10","서구","65세 이상",27202,11488,15714
"2020.10","동구","65세 이상",23454,9761,13693
"2020.10","영도구","65세 이상",31407,13332,18075
"2020.10","부산진구","65세 이상",70525,30413,40112
"2020.10","동래구","65세 이상",49687,21946,27741
"2020.10","남구","65세 이상",53743,23394,30349
"2020.10","북구","65세 이상",48854,21587,27267
"2020.10","해운대구","65세 이상",70093,30085,40008
"2020.10","사하구","65세 이상",59342,26312,33030
"2020.10","금정구","65세 이상",48633,21146,27487
"2020.10","강서구","65세 이상",16477,7786,8691
"2020.10","연제구","65세 이상",40223,17751,22472
"2020.10","수영구","65세 이상",37488,16187,21301
"2020.10","사상구","65세 이상",38731,17368,21363
"2020.10","기장군","65세 이상",27414,11746,15668
"2020.11","중구","65세 이상",11344,4836,6508
"2020.11","서구","65세 이상",27316,11540,15776
"2020.11","동구","65세 이상",23502,9783,13719
"2020.11","영도구","65세 이상",31477,13367,18110
"2020.11","부산진구","65세 이상",70762,30542,40220
"2020.11","동래구","65세 이상",49850,22020,27830
"2020.11","남구","65세 이상",53915,23474,30441
"2020.11","북구","65세 이상",49109,21712,27397
"2020.11","해운대구","65세 이상",70409,30221,40188
"2020.11","사하구","65세 이상",59541,26429,33112
"2020.11","금정구","65세 이상",48830,21206,27624
"2020.11","강서구","65세 이상",16573,7816,8757
"2020.11","연제구","65세 이상",40384,17812,22572
"2020.11","수영구","65세 이상",37614,16216,21398
"2020.11","사상구","65세 이상",38900,17427,21473
"2020.11","기장군","65세 이상",27620,11846,15774
"2020.12","중구","65세 이상",11406,4862,6544
"2020.12","서구","65세 이상",27439,11594,15845
"2020.12","동구","65세 이상",23572,9792,13780
"2020.12","영도구","65세 이상",31576,13411,18165
"2020.12","부산진구","65세 이상",71090,30686,40404
"2020.12","동래구","65세 이상",50019,22059,27960
"2020.12","남구","65세 이상",54045,23549,30496
"2020.12","북구","65세 이상",49410,21861,27549
"2020.12","해운대구","65세 이상",70654,30348,40306
"2020.12","사하구","65세 이상",59763,26547,33216
"2020.12","금정구","65세 이상",49010,21279,27731
"2020.12","강서구","65세 이상",16712,7872,8840
"2020.12","연제구","65세 이상",40582,17892,22690
"2020.12","수영구","65세 이상",37747,16272,21475
"2020.12","사상구","65세 이상",39039,17468,21571
"2020.12","기장군","65세 이상",27844,11952,15892
"2021.01","중구","65세 이상",11469,4888,6581
"2021.01","서구","65세 이상",27547,11640,15907
"2021.01","동구","65세 이상",23692,9851,13841
"2021.01","영도구","65세 이상",31686,13460,18226
"2021.01","부산진구","65세 이상",71447,30869,40578
"2021.01","동래구","65세 이상",50297,22150,28147
"2021.01","남구","65세 이상",54296,23636,30660
"2021.01","북구","65세 이상",49760,22042,27718
"2021.01","해운대구","65세 이상",71009,30519,40490
"2021.01","사하구","65세 이상",60073,26669,33404
"2021.01","금정구","65세 이상",49254,21387,27867
"2021.01","강서구","65세 이상",16856,7954,8902
"2021.01","연제구","65세 이상",40844,18015,22829
"2021.01","수영구","65세 이상",37949,16354,21595
"2021.01","사상구","65세 이상",39291,17595,21696
"2021.01","기장군","65세 이상",28132,12075,16057
"2021.02","중구","65세 이상",11495,4895,6600
"2021.02","서구","65세 이상",27639,11679,15960
"2021.02","동구","65세 이상",23730,9869,13861
"2021.02","영도구","65세 이상",31742,13482,18260
"2021.02","부산진구","65세 이상",71685,30954,40731
"2021.02","동래구","65세 이상",50544,22262,28282
"2021.02","남구","65세 이상",54462,23696,30766
"2021.02","북구","65세 이상",50028,22170,27858
"2021.02","해운대구","65세 이상",71320,30667,40653
"2021.02","사하구","65세 이상",60341,26789,33552
"2021.02","금정구","65세 이상",49426,21480,27946
"2021.02","강서구","65세 이상",16954,7996,8958
"2021.02","연제구","65세 이상",41059,18126,22933
"2021.02","수영구","65세 이상",38053,16398,21655
"2021.02","사상구","65세 이상",39515,17690,21825
"2021.02","기장군","65세 이상",28283,12148,16135
"2021.03","중구","65세 이상",11418,4862,6556
"2021.03","서구","65세 이상",27107,11504,15603
"2021.03","동구","65세 이상",23546,9804,13742
"2021.03","영도구","65세 이상",31346,13319,18027
"2021.03","부산진구","65세 이상",70638,30555,40083
"2021.03","동래구","65세 이상",50358,22229,28129
"2021.03","남구","65세 이상",54163,23587,30576
"2021.03","북구","65세 이상",50099,22240,27859
"2021.03","해운대구","65세 이상",71445,30777,40668
"2021.03","사하구","65세 이상",60146,26744,33402
"2021.03","금정구","65세 이상",49183,21406,27777
"2021.03","강서구","65세 이상",16926,7976,8950
"2021.03","연제구","65세 이상",40920,18109,22811
"2021.03","수영구","65세 이상",38024,16406,21618
"2021.03","사상구","65세 이상",39544,17694,21850
"2021.03","기장군","65세 이상",28317,12171,16146
"2021.04","중구","65세 이상",11450,4863,6587
"2021.04","서구","65세 이상",27162,11530,15632
"2021.04","동구","65세 이상",23590,9836,13754
"2021.04","영도구","65세 이상",31441,13361,18080
"2021.04","부산진구","65세 이상",70877,30675,40202
"2021.04","동래구","65세 이상",50475,22260,28215
"2021.04","남구","65세 이상",54301,23628,30673
"2021.04","북구","65세 이상",50359,22361,27998
"2021.04","해운대구","65세 이상",71734,30909,40825
"2021.04","사하구","65세 이상",60407,26868,33539
"2021.04","금정구","65세 이상",49328,21468,27860
"2021.04","강서구","65세 이상",17016,8015,9001
"2021.04","연제구","65세 이상",40997,18147,22850
"2021.04","수영구","65세 이상",38179,16478,21701
"2021.04","사상구","65세 이상",39699,17772,21927
"2021.04","기장군","65세 이상",28436,12218,16218
"2021.05","중구","65세 이상",11455,4865,6590
"2021.05","서구","65세 이상",27263,11583,15680
"2021.05","동구","65세 이상",23658,9839,13819
"2021.05","영도구","65세 이상",31543,13402,18141
"2021.05","부산진구","65세 이상",71065,30758,40307
"2021.05","동래구","65세 이상",50625,22310,28315
"2021.05","남구","65세 이상",54456,23708,30748
"2021.05","북구","65세 이상",50730,22548,28182
"2021.05","해운대구","65세 이상",71876,31020,40856
"2021.05","사하구","65세 이상",60616,26975,33641
"2021.05","금정구","65세 이상",49476,21537,27939
"2021.05","강서구","65세 이상",17120,8059,9061
"2021.05","연제구","65세 이상",41160,18202,22958
"2021.05","수영구","65세 이상",38273,16494,21779
"2021.05","사상구","65세 이상",39821,17838,21983
"2021.05","기장군","65세 이상",28570,12281,16289
"2021.06","중구","65세 이상",11084,4710,6374
"2021.06","서구","65세 이상",27299,11583,15716
"2021.06","동구","65세 이상",23671,9848,13823
"2021.06","영도구","65세 이상",31628,13453,18175
"2021.06","부산진구","65세 이상",71226,30842,40384
"2021.06","동래구","65세 이상",50728,22335,28393
"2021.06","남구","65세 이상",54540,23728,30812
"2021.06","북구","65세 이상",51002,22680,28322
"2021.06","해운대구","65세 이상",72061,31096,40965
"2021.06","사하구","65세 이상",60768,27034,33734
"2021.06","금정구","65세 이상",49540,21561,27979
"2021.06","강서구","65세 이상",17186,8093,9093
"2021.06","연제구","65세 이상",41265,18240,23025
"2021.06","수영구","65세 이상",38352,16516,21836
"2021.06","사상구","65세 이상",39954,17904,22050
"2021.06","기장군","65세 이상",28664,12325,16339
"2021.07","중구","65세 이상",11124,4733,6391
"2021.07","서구","65세 이상",27376,11622,15754
"2021.07","동구","65세 이상",23686,9844,13842
"2021.07","영도구","65세 이상",31720,13504,18216
"2021.07","부산진구","65세 이상",71404,30938,40466
"2021.07","동래구","65세 이상",50937,22440,28497
"2021.07","남구","65세 이상",54652,23775,30877
"2021.07","북구","65세 이상",51223,22792,28431
"2021.07","해운대구","65세 이상",72238,31184,41054
"2021.07","사하구","65세 이상",60943,27099,33844
"2021.07","금정구","65세 이상",49706,21649,28057
"2021.07","강서구","65세 이상",17301,8145,9156
"2021.07","연제구","65세 이상",41410,18307,23103
"2021.07","수영구","65세 이상",38485,16580,21905
"2021.07","사상구","65세 이상",40117,17974,22143
"2021.07","기장군","65세 이상",28776,12359,16417
"2021.08","중구","65세 이상",11169,4754,6415
"2021.08","서구","65세 이상",27442,11646,15796
"2021.08","동구","65세 이상",23697,9845,13852
"2021.08","영도구","65세 이상",31817,13538,18279
"2021.08","부산진구","65세 이상",71668,31044,40624
"2021.08","동래구","65세 이상",51143,22531,28612
"2021.08","남구","65세 이상",54844,23834,31010
"2021.08","북구","65세 이상",51519,22911,28608
"2021.08","해운대구","65세 이상",72548,31352,41196
"2021.08","사하구","65세 이상",61278,27248,34030
"2021.08","금정구","65세 이상",49903,21759,28144
"2021.08","강서구","65세 이상",17427,8209,9218
"2021.08","연제구","65세 이상",41573,18374,23199
"2021.08","수영구","65세 이상",38617,16663,21954
"2021.08","사상구","65세 이상",40327,18087,22240
"2021.08","기장군","65세 이상",28929,12424,16505
"2021.09","중구","65세 이상",11194,4767,6427
"2021.09","서구","65세 이상",27513,11689,15824
"2021.09","동구","65세 이상",23765,9893,13872
"2021.09","영도구","65세 이상",31868,13570,18298
"2021.09","부산진구","65세 이상",71934,31147,40787
"2021.09","동래구","65세 이상",51356,22614,28742
"2021.09","남구","65세 이상",55017,23910,31107
"2021.09","북구","65세 이상",51792,23053,28739
"2021.09","해운대구","65세 이상",72877,31493,41384
"2021.09","사하구","65세 이상",61589,27390,34199
"2021.09","금정구","65세 이상",50105,21836,28269
"2021.09","강서구","65세 이상",17545,8264,9281
"2021.09","연제구","65세 이상",41778,18459,23319
"2021.09","수영구","65세 이상",38776,16737,22039
"2021.09","사상구","65세 이상",40549,18194,22355
"2021.09","기장군","65세 이상",29027,12465,16562
"2021.10","중구","65세 이상",11229,4778,6451
"2021.10","서구","65세 이상",27581,11747,15834
"2021.10","동구","65세 이상",23886,9948,13938
"2021.10","영도구","65세 이상",31945,13612,18333
"2021.10","부산진구","65세 이상",72205,31268,40937
"2021.10","동래구","65세 이상",51508,22676,28832
"2021.10","남구","65세 이상",55245,23984,31261
"2021.10","북구","65세 이상",52075,23199,28876
"2021.10","해운대구","65세 이상",73214,31686,41528
"2021.10","사하구","65세 이상",61915,27528,34387
"2021.10","금정구","65세 이상",50256,21919,28337
"2021.10","강서구","65세 이상",17674,8335,9339
"2021.10","연제구","65세 이상",41916,18523,23393
"2021.10","수영구","65세 이상",38906,16771,22135
"2021.10","사상구","65세 이상",40753,18289,22464
"2021.10","기장군","65세 이상",29146,12518,16628
"2021.11","중구","65세 이상",11274,4801,6473
"2021.11","서구","65세 이상",27590,11738,15852
"2021.11","동구","65세 이상",23938,9967,13971
"2021.11","영도구","65세 이상",31995,13632,18363
"2021.11","부산진구","65세 이상",72358,31349,41009
"2021.11","동래구","65세 이상",51649,22750,28899
"2021.11","남구","65세 이상",55387,24054,31333
"2021.11","북구","65세 이상",52349,23324,29025
"2021.11","해운대구","65세 이상",73391,31740,41651
"2021.11","사하구","65세 이상",62180,27648,34532
"2021.11","금정구","65세 이상",50383,21973,28410
"2021.11","강서구","65세 이상",17813,8404,9409
"2021.11","연제구","65세 이상",42084,18583,23501
"2021.11","수영구","65세 이상",38994,16814,22180
"2021.11","사상구","65세 이상",40887,18343,22544
"2021.11","기장군","65세 이상",29312,12588,16724
"2021.12","중구","65세 이상",11307,4812,6495
"2021.12","서구","65세 이상",27627,11765,15862
"2021.12","동구","65세 이상",23968,9981,13987
"2021.12","영도구","65세 이상",32077,13665,18412
"2021.12","부산진구","65세 이상",72521,31424,41097
"2021.12","동래구","65세 이상",51920,22848,29072
"2021.12","남구","65세 이상",55522,24082,31440
"2021.12","북구","65세 이상",52611,23474,29137
"2021.12","해운대구","65세 이상",73667,31848,41819
"2021.12","사하구","65세 이상",62465,27780,34685
"2021.12","금정구","65세 이상",50487,22039,28448
"2021.12","강서구","65세 이상",17921,8455,9466
"2021.12","연제구","65세 이상",42378,18744,23634
"2021.12","수영구","65세 이상",39105,16862,22243
"2021.12","사상구","65세 이상",41048,18427,22621
"2021.12","기장군","65세 이상",29455,12672,16783
"2022.01","중구","65세 이상",11372,4833,6539
"2022.01","서구","65세 이상",27724,11791,15933
"2022.01","동구","65세 이상",24103,10050,14053
"2022.01","영도구","65세 이상",32216,13727,18489
"2022.01","부산진구","65세 이상",72870,31600,41270
"2022.01","동래구","65세 이상",52483,23124,29359
"2022.01","남구","65세 이상",55743,24194,31549
"2022.01","북구","65세 이상",52939,23659,29280
"2022.01","해운대구","65세 이상",74114,32053,42061
"2022.01","사하구","65세 이상",62911,28005,34906
"2022.01","금정구","65세 이상",50728,22150,28578
"2022.01","강서구","65세 이상",18078,8536,9542
"2022.01","연제구","65세 이상",42552,18825,23727
"2022.01","수영구","65세 이상",39289,16935,22354
"2022.01","사상구","65세 이상",41312,18563,22749
"2022.01","기장군","65세 이상",29635,12751,16884
"2022.02","중구","65세 이상",11417,4864,6553
"2022.02","서구","65세 이상",27812,11820,15992
"2022.02","동구","65세 이상",24231,10110,14121
"2022.02","영도구","65세 이상",32276,13764,18512
"2022.02","부산진구","65세 이상",73074,31710,41364
"2022.02","동래구","65세 이상",52902,23289,29613
"2022.02","남구","65세 이상",55972,24294,31678
"2022.02","북구","65세 이상",53260,23799,29461
"2022.02","해운대구","65세 이상",74408,32176,42232
"2022.02","사하구","65세 이상",63314,28193,35121
"2022.02","금정구","65세 이상",50885,22225,28660
"2022.02","강서구","65세 이상",18183,8596,9587
"2022.02","연제구","65세 이상",42765,18924,23841
"2022.02","수영구","65세 이상",39454,16999,22455
"2022.02","사상구","65세 이상",41497,18643,22854
"2022.02","기장군","65세 이상",29802,12825,16977
"2022.03","중구","65세 이상",11420,4866,6554
"2022.03","서구","65세 이상",27847,11830,16017
"2022.03","동구","65세 이상",24300,10153,14147
"2022.03","영도구","65세 이상",32338,13791,18547
"2022.03","부산진구","65세 이상",73257,31795,41462
"2022.03","동래구","65세 이상",53216,23431,29785
"2022.03","남구","65세 이상",56174,24354,31820
"2022.03","북구","65세 이상",53502,23905,29597
"2022.03","해운대구","65세 이상",74713,32331,42382
"2022.03","사하구","65세 이상",63633,28323,35310
"2022.03","금정구","65세 이상",51031,22298,28733
"2022.03","강서구","65세 이상",18280,8637,9643
"2022.03","연제구","65세 이상",42974,19002,23972
"2022.03","수영구","65세 이상",39563,17026,22537
"2022.03","사상구","65세 이상",41721,18752,22969
"2022.03","기장군","65세 이상",29970,12910,17060
"2022.04","중구","65세 이상",11446,4868,6578
"2022.04","서구","65세 이상",27881,11847,16034
"2022.04","동구","65세 이상",24327,10167,14160
"2022.04","영도구","65세 이상",32359,13800,18559
"2022.04","부산진구","65세 이상",73427,31839,41588
"2022.04","동래구","65세 이상",53371,23495,29876
"2022.04","남구","65세 이상",56332,24417,31915
"2022.04","북구","65세 이상",53750,24009,29741
"2022.04","해운대구","65세 이상",74870,32430,42440
"2022.04","사하구","65세 이상",63828,28389,35439
"2022.04","금정구","65세 이상",51121,22359,28762
"2022.04","강서구","65세 이상",18348,8667,9681
"2022.04","연제구","65세 이상",43039,19003,24036
"2022.04","수영구","65세 이상",39637,17054,22583
"2022.04","사상구","65세 이상",41802,18790,23012
"2022.04","기장군","65세 이상",30082,12958,17124
"2022.05","중구","65세 이상",11479,4889,6590
"2022.05","서구","65세 이상",27929,11855,16074
"2022.05","동구","65세 이상",24372,10191,14181
"2022.05","영도구","65세 이상",32408,13811,18597
"2022.05","부산진구","65세 이상",73637,31913,41724
"2022.05","동래구","65세 이상",53604,23571,30033
"2022.05","남구","65세 이상",56463,24448,32015
"2022.05","북구","65세 이상",54016,24144,29872
"2022.05","해운대구","65세 이상",74998,32445,42553
"2022.05","사하구","65세 이상",64099,28523,35576
"2022.05","금정구","65세 이상",51265,22410,28855
"2022.05","강서구","65세 이상",18450,8733,9717
"2022.05","연제구","65세 이상",43154,19054,24100
"2022.05","수영구","65세 이상",39723,17089,22634
"2022.05","사상구","65세 이상",42003,18903,23100
"2022.05","기장군","65세 이상",30171,12999,17172
"2022.06","중구","65세 이상",11471,4877,6594
"2022.06","서구","65세 이상",27997,11876,16121
"2022.06","동구","65세 이상",24412,10221,14191
"2022.06","영도구","65세 이상",32505,13869,18636
"2022.06","부산진구","65세 이상",73819,31989,41830
"2022.06","동래구","65세 이상",53788,23633,30155
"2022.06","남구","65세 이상",56574,24502,32072
"2022.06","북구","65세 이상",54239,24258,29981
"2022.06","해운대구","65세 이상",75164,32508,42656
"2022.06","사하구","65세 이상",64231,28568,35663
"2022.06","금정구","65세 이상",51334,22437,28897
"2022.06","강서구","65세 이상",18534,8779,9755
"2022.06","연제구","65세 이상",43267,19109,24158
"2022.06","수영구","65세 이상",39824,17136,22688
"2022.06","사상구","65세 이상",42159,18976,23183
"2022.06","기장군","65세 이상",30376,13080,17296
"2022.07","중구","65세 이상",11483,4881,6602
"2022.07","서구","65세 이상",28125,11930,16195
"2022.07","동구","65세 이상",24450,10239,14211
"2022.07","영도구","65세 이상",32555,13891,18664
"2022.07","부산진구","65세 이상",74137,32147,41990
"2022.07","동래구","65세 이상",54036,23736,30300
"2022.07","남구","65세 이상",56716,24549,32167
"2022.07","북구","65세 이상",54463,24370,30093
"2022.07","해운대구","65세 이상",75396,32601,42795
"2022.07","사하구","65세 이상",64502,28702,35800
"2022.07","금정구","65세 이상",51492,22490,29002
"2022.07","강서구","65세 이상",18617,8807,9810
"2022.07","연제구","65세 이상",43394,19159,24235
"2022.07","수영구","65세 이상",39935,17185,22750
"2022.07","사상구","65세 이상",42274,19048,23226
"2022.07","기장군","65세 이상",30505,13132,17373
"2022.08","중구","65세 이상",11526,4901,6625
"2022.08","서구","65세 이상",28271,11997,16274
"2022.08","동구","65세 이상",24558,10301,14257
"2022.08","영도구","65세 이상",32632,13930,18702
"2022.08","부산진구","65세 이상",74533,32334,42199
"2022.08","동래구","65세 이상",54308,23846,30462
"2022.08","남구","65세 이상",56867,24632,32235
"2022.08","북구","65세 이상",54819,24517,30302
"2022.08","해운대구","65세 이상",75801,32782,43019
"2022.08","사하구","65세 이상",64883,28868,36015
"2022.08","금정구","65세 이상",51734,22621,29113
"2022.08","강서구","65세 이상",18778,8892,9886
"2022.08","연제구","65세 이상",43598,19233,24365
"2022.08","수영구","65세 이상",40135,17269,22866
"2022.08","사상구","65세 이상",42499,19154,23345
"2022.08","기장군","65세 이상",30645,13200,17445
"2022.09","중구","65세 이상",11500,4893,6607
"2022.09","서구","65세 이상",28295,12011,16284
"2022.09","동구","65세 이상",24362,10254,14108
"2022.09","영도구","65세 이상",32629,13925,18704
"2022.09","부산진구","65세 이상",74596,32337,42259
"2022.09","동래구","65세 이상",54347,23864,30483
"2022.09","남구","65세 이상",56787,24586,32201
"2022.09","북구","65세 이상",55065,24642,30423
"2022.09","해운대구","65세 이상",75768,32745,43023
"2022.09","사하구","65세 이상",65028,28911,36117
"2022.09","금정구","65세 이상",51787,22648,29139
"2022.09","강서구","65세 이상",18796,8906,9890
"2022.09","연제구","65세 이상",43637,19232,24405
"2022.09","수영구","65세 이상",40244,17308,22936
"2022.09","사상구","65세 이상",42517,19141,23376
"2022.09","기장군","65세 이상",30816,13272,17544
"2022.10","중구","65세 이상",11522,4895,6627
"2022.10","서구","65세 이상",28416,12052,16364
"2022.10","동구","65세 이상",24447,10287,14160
"2022.10","영도구","65세 이상",32715,13958,18757
"2022.10","부산진구","65세 이상",75093,32547,42546
"2022.10","동래구","65세 이상",54554,23957,30597
"2022.10","남구","65세 이상",56900,24654,32246
"2022.10","북구","65세 이상",55399,24821,30578
"2022.10","해운대구","65세 이상",76055,32875,43180
"2022.10","사하구","65세 이상",65424,29097,36327
"2022.10","금정구","65세 이상",51962,22734,29228
"2022.10","강서구","65세 이상",18906,8943,9963
"2022.10","연제구","65세 이상",43824,19325,24499
"2022.10","수영구","65세 이상",40513,17411,23102
"2022.10","사상구","65세 이상",42742,19242,23500
"2022.10","기장군","65세 이상",30976,13338,17638
"2022.11","중구","65세 이상",11543,4904,6639
"2022.11","서구","65세 이상",28470,12078,16392
"2022.11","동구","65세 이상",24492,10313,14179
"2022.11","영도구","65세 이상",32824,14012,18812
"2022.11","부산진구","65세 이상",75577,32799,42778
"2022.11","동래구","65세 이상",54775,24055,30720
"2022.11","남구","65세 이상",57018,24729,32289
"2022.11","북구","65세 이상",55651,24956,30695
"2022.11","해운대구","65세 이상",76352,33034,43318
"2022.11","사하구","65세 이상",65691,29237,36454
"2022.11","금정구","65세 이상",52071,22789,29282
"2022.11","강서구","65세 이상",18999,8979,10020
"2022.11","연제구","65세 이상",43963,19386,24577
"2022.11","수영구","65세 이상",40689,17471,23218
"2022.11","사상구","65세 이상",42916,19329,23587
"2022.11","기장군","65세 이상",31137,13402,17735
"2022.12","중구","65세 이상",11578,4921,6657
"2022.12","서구","65세 이상",28536,12104,16432
"2022.12","동구","65세 이상",24568,10364,14204
"2022.12","영도구","65세 이상",32877,14046,18831
"2022.12","부산진구","65세 이상",75866,32912,42954
"2022.12","동래구","65세 이상",54994,24140,30854
"2022.12","남구","65세 이상",57108,24763,32345
"2022.12","북구","65세 이상",55881,25076,30805
"2022.12","해운대구","65세 이상",76657,33192,43465
"2022.12","사하구","65세 이상",65953,29383,36570
"2022.12","금정구","65세 이상",52234,22853,29381
"2022.12","강서구","65세 이상",19082,9018,10064
"2022.12","연제구","65세 이상",44175,19467,24708
"2022.12","수영구","65세 이상",40842,17535,23307
"2022.12","사상구","65세 이상",43141,19448,23693
"2022.12","기장군","65세 이상",31305,13471,17834
"2023.01","중구","65세 이상",11634,4949,6685
"2023.01","서구","65세 이상",28653,12150,16503
"2023.01","동구","65세 이상",24643,10407,14236
"2023.01","영도구","65세 이상",32970,14096,18874
"2023.01","부산진구","65세 이상",76225,33075,43150
"2023.01","동래구","65세 이상",55274,24294,30980
"2023.01","남구","65세 이상",57358,24874,32484
"2023.01","북구","65세 이상",56206,25245,30961
"2023.01","해운대구","65세 이상",77001,33349,43652
"2023.01","사하구","65세 이상",66338,29580,36758
"2023.01","금정구","65세 이상",52420,22941,29479
"2023.01","강서구","65세 이상",19199,9093,10106
"2023.01","연제구","65세 이상",44312,19512,24800
"2023.01","수영구","65세 이상",41049,17625,23424
"2023.01","사상구","65세 이상",43415,19590,23825
"2023.01","기장군","65세 이상",31536,13583,17953
"2023.02","중구","65세 이상",11667,4960,6707
"2023.02","서구","65세 이상",28722,12193,16529
"2023.02","동구","65세 이상",24683,10418,14265
"2023.02","영도구","65세 이상",33030,14133,18897
"2023.02","부산진구","65세 이상",76564,33232,43332
"2023.02","동래구","65세 이상",55547,24426,31121
"2023.02","남구","65세 이상",57516,24923,32593
"2023.02","북구","65세 이상",56466,25356,31110
"2023.02","해운대구","65세 이상",77311,33504,43807
"2023.02","사하구","65세 이상",66646,29719,36927
"2023.02","금정구","65세 이상",52625,23041,29584
"2023.02","강서구","65세 이상",19282,9133,10149
"2023.02","연제구","65세 이상",44458,19553,24905
"2023.02","수영구","65세 이상",41212,17691,23521
"2023.02","사상구","65세 이상",43644,19697,23947
"2023.02","기장군","65세 이상",31720,13670,18050
"2023.03","중구","65세 이상",11690,4972,6718
"2023.03","서구","65세 이상",28773,12199,16574
"2023.03","동구","65세 이상",24735,10433,14302
"2023.03","영도구","65세 이상",33147,14198,18949
"2023.03","부산진구","65세 이상",76864,33355,43509
"2023.03","동래구","65세 이상",55791,24505,31286
"2023.03","남구","65세 이상",57726,25009,32717
"2023.03","북구","65세 이상",56827,25520,31307
"2023.03","해운대구","65세 이상",77696,33644,44052
"2023.03","사하구","65세 이상",67040,29896,37144
"2023.03","금정구","65세 이상",52845,23147,29698
"2023.03","강서구","65세 이상",19411,9198,10213
"2023.03","연제구","65세 이상",44717,19642,25075
"2023.03","수영구","65세 이상",41456,17761,23695
"2023.03","사상구","65세 이상",43867,19796,24071
"2023.03","기장군","65세 이상",31876,13758,18118
"2023.04","중구","65세 이상",11710,4974,6736
"2023.04","서구","65세 이상",28845,12237,16608
"2023.04","동구","65세 이상",24754,10433,14321
"2023.04","영도구","65세 이상",33204,14244,18960
"2023.04","부산진구","65세 이상",77139,33482,43657
"2023.04","동래구","65세 이상",55986,24596,31390
"2023.04","남구","65세 이상",57862,25067,32795
"2023.04","북구","65세 이상",57066,25622,31444
"2023.04","해운대구","65세 이상",77924,33742,44182
"2023.04","사하구","65세 이상",67352,30022,37330
"2023.04","금정구","65세 이상",53025,23213,29812
"2023.04","강서구","65세 이상",19506,9253,10253
"2023.04","연제구","65세 이상",44870,19716,25154
"2023.04","수영구","65세 이상",41608,17831,23777
"2023.04","사상구","65세 이상",44106,19913,24193
"2023.04","기장군","65세 이상",32082,13845,18237
"2023.05","중구","65세 이상",11753,4986,6767
"2023.05","서구","65세 이상",28903,12258,16645
"2023.05","동구","65세 이상",24803,10433,14370
"2023.05","영도구","65세 이상",33234,14256,18978
"2023.05","부산진구","65세 이상",77431,33602,43829
"2023.05","동래구","65세 이상",56196,24684,31512
"2023.05","남구","65세 이상",58026,25133,32893
"2023.05","북구","65세 이상",57298,25719,31579
"2023.05","해운대구","65세 이상",78200,33891,44309
"2023.05","사하구","65세 이상",67617,30133,37484
"2023.05","금정구","65세 이상",53178,23273,29905
"2023.05","강서구","65세 이상",19585,9296,10289
"2023.05","연제구","65세 이상",45010,19776,25234
"2023.05","수영구","65세 이상",41739,17864,23875
"2023.05","사상구","65세 이상",44353,20011,24342
"2023.05","기장군","65세 이상",32239,13903,18336
"2023.06","중구","65세 이상",11796,4999,6797
"2023.06","서구","65세 이상",28945,12291,16654
"2023.06","동구","65세 이상",24894,10492,14402
"2023.06","영도구","65세 이상",33257,14272,18985
"2023.06","부산진구","65세 이상",77609,33654,43955
"2023.06","동래구","65세 이상",56293,24719,31574
"2023.06","남구","65세 이상",58112,25161,32951
"2023.06","북구","65세 이상",57485,25805,31680
"2023.06","해운대구","65세 이상",78346,33972,44374
"2023.06","사하구","65세 이상",67787,30212,37575
"2023.06","금정구","65세 이상",53310,23333,29977
"2023.06","강서구","65세 이상",19654,9326,10328
"2023.06","연제구","65세 이상",45119,19825,25294
"2023.06","수영구","65세 이상",41859,17904,23955
"2023.06","사상구","65세 이상",44476,20065,24411
"2023.06","기장군","65세 이상",32323,13962,18361
"2023.07","중구","65세 이상",11819,5018,6801
"2023.07","서구","65세 이상",29030,12328,16702
"2023.07","동구","65세 이상",25009,10544,14465
"2023.07","영도구","65세 이상",33361,14334,19027
"2023.07","부산진구","65세 이상",77825,33776,44049
"2023.07","동래구","65세 이상",56457,24789,31668
"2023.07","남구","65세 이상",58251,25212,33039
"2023.07","북구","65세 이상",57712,25926,31786
"2023.07","해운대구","65세 이상",78609,34060,44549
"2023.07","사하구","65세 이상",67926,30291,37635
"2023.07","금정구","65세 이상",53386,23360,30026
"2023.07","강서구","65세 이상",19728,9371,10357
"2023.07","연제구","65세 이상",45249,19853,25396
"2023.07","수영구","65세 이상",41968,17945,24023
"2023.07","사상구","65세 이상",44677,20160,24517
"2023.07","기장군","65세 이상",32419,13989,18430
"2023.08","중구","65세 이상",11859,5029,6830
"2023.08","서구","65세 이상",29095,12356,16739
"2023.08","동구","65세 이상",25091,10587,14504
"2023.08","영도구","65세 이상",33461,14379,19082
"2023.08","부산진구","65세 이상",78126,33895,44231
"2023.08","동래구","65세 이상",56676,24872,31804
"2023.08","남구","65세 이상",58401,25271,33130
"2023.08","북구","65세 이상",58037,26083,31954
"2023.08","해운대구","65세 이상",78900,34168,44732
"2023.08","사하구","65세 이상",68175,30398,37777
"2023.08","금정구","65세 이상",53573,23443,30130
"2023.08","강서구","65세 이상",19848,9435,10413
"2023.08","연제구","65세 이상",45394,19902,25492
"2023.08","수영구","65세 이상",42120,18025,24095
"2023.08","사상구","65세 이상",44986,20305,24681
"2023.08","기장군","65세 이상",32511,14023,18488
"2023.09","중구","65세 이상",11899,5049,6850
"2023.09","서구","65세 이상",29188,12390,16798
"2023.09","동구","65세 이상",25170,10627,14543
"2023.09","영도구","65세 이상",33562,14394,19168
"2023.09","부산진구","65세 이상",78547,34075,44472
"2023.09","동래구","65세 이상",56893,24970,31923
"2023.09","남구","65세 이상",58550,25323,33227
"2023.09","북구","65세 이상",58315,26205,32110
"2023.09","해운대구","65세 이상",79279,34346,44933
"2023.09","사하구","65세 이상",68450,30535,37915
"2023.09","금정구","65세 이상",53754,23509,30245
"2023.09","강서구","65세 이상",19987,9494,10493
"2023.09","연제구","65세 이상",45591,19996,25595
"2023.09","수영구","65세 이상",42244,18069,24175
"2023.09","사상구","65세 이상",45206,20398,24808
"2023.09","기장군","65세 이상",32651,14090,18561
"2023.10","중구","65세 이상",11922,5069,6853
"2023.10","서구","65세 이상",29279,12443,16836
"2023.10","동구","65세 이상",25198,10653,14545
"2023.10","영도구","65세 이상",33649,14448,19201
"2023.10","부산진구","65세 이상",78912,34238,44674
"2023.10","동래구","65세 이상",57170,25094,32076
"2023.10","남구","65세 이상",58756,25411,33345
"2023.10","북구","65세 이상",58657,26378,32279
"2023.10","해운대구","65세 이상",79621,34502,45119
"2023.10","사하구","65세 이상",68755,30684,38071
"2023.10","금정구","65세 이상",53906,23592,30314
"2023.10","강서구","65세 이상",20108,9559,10549
"2023.10","연제구","65세 이상",45809,20090,25719
"2023.10","수영구","65세 이상",42401,18127,24274
"2023.10","사상구","65세 이상",45469,20513,24956
"2023.10","기장군","65세 이상",32785,14154,18631
"2023.11","중구","65세 이상",11938,5068,6870
"2023.11","서구","65세 이상",29327,12465,16862
"2023.11","동구","65세 이상",25272,10688,14584
"2023.11","영도구","65세 이상",33683,14451,19232
"2023.11","부산진구","65세 이상",79221,34374,44847
"2023.11","동래구","65세 이상",57420,25195,32225
"2023.11","남구","65세 이상",58916,25478,33438
"2023.11","북구","65세 이상",58968,26544,32424
"2023.11","해운대구","65세 이상",79850,34628,45222
"2023.11","사하구","65세 이상",69019,30829,38190
"2023.11","금정구","65세 이상",54066,23648,30418
"2023.11","강서구","65세 이상",20192,9610,10582
"2023.11","연제구","65세 이상",45960,20147,25813
"2023.11","수영구","65세 이상",42487,18161,24326
"2023.11","사상구","65세 이상",45661,20601,25060
"2023.11","기장군","65세 이상",32920,14206,18714
"2023.12","중구","65세 이상",11983,5085,6898
"2023.12","서구","65세 이상",29412,12509,16903
"2023.12","동구","65세 이상",25335,10712,14623
"2023.12","영도구","65세 이상",33797,14520,19277
"2023.12","부산진구","65세 이상",79548,34494,45054
"2023.12","동래구","65세 이상",57638,25302,32336
"2023.12","남구","65세 이상",59119,25558,33561
"2023.12","북구","65세 이상",59277,26698,32579
"2023.12","해운대구","65세 이상",80145,34794,45351
"2023.12","사하구","65세 이상",69304,30970,38334
"2023.12","금정구","65세 이상",54200,23685,30515
"2023.12","강서구","65세 이상",20287,9662,10625
"2023.12","연제구","65세 이상",46314,20296,26018
"2023.12","수영구","65세 이상",42691,18246,24445
"2023.12","사상구","65세 이상",45897,20728,25169
"2023.12","기장군","65세 이상",33055,14260,18795
"2024.01","중구","65세 이상",12015,5114,6901
"2024.01","서구","65세 이상",29496,12534,16962
"2024.01","동구","65세 이상",25417,10741,14676
"2024.01","영도구","65세 이상",33934,14586,19348
"2024.01","부산진구","65세 이상",79892,34677,45215
"2024.01","동래구","65세 이상",57826,25366,32460
"2024.01","남구","65세 이상",59364,25644,33720
"2024.01","북구","65세 이상",59580,26855,32725
"2024.01","해운대구","65세 이상",80542,35003,45539
"2024.01","사하구","65세 이상",69669,31140,38529
"2024.01","금정구","65세 이상",54394,23787,30607
"2024.01","강서구","65세 이상",20409,9728,10681
"2024.01","연제구","65세 이상",46711,20456,26255
"2024.01","수영구","65세 이상",42837,18301,24536
"2024.01","사상구","65세 이상",46206,20882,25324
"2024.01","기장군","65세 이상",33197,14330,18867
"2024.02","중구","65세 이상",12046,5144,6902
"2024.02","서구","65세 이상",29560,12563,16997
"2024.02","동구","65세 이상",25470,10775,14695
"2024.02","영도구","65세 이상",34001,14621,19380
"2024.02","부산진구","65세 이상",80246,34802,45444
"2024.02","동래구","65세 이상",58007,25440,32567
"2024.02","남구","65세 이상",59630,25773,33857
"2024.02","북구","65세 이상",59917,26997,32920
"2024.02","해운대구","65세 이상",80822,35137,45685
"2024.02","사하구","65세 이상",70015,31300,38715
"2024.02","금정구","65세 이상",54624,23869,30755
"2024.02","강서구","65세 이상",20505,9779,10726
"2024.02","연제구","65세 이상",46968,20537,26431
"2024.02","수영구","65세 이상",42940,18334,24606
"2024.02","사상구","65세 이상",46431,21000,25431
"2024.02","기장군","65세 이상",33267,14368,18899
"2024.03","중구","65세 이상",12100,5158,6942
"2024.03","서구","65세 이상",29653,12605,17048
"2024.03","동구","65세 이상",25533,10792,14741
"2024.03","영도구","65세 이상",34136,14691,19445
"2024.03","부산진구","65세 이상",80710,34999,45711
"2024.03","동래구","65세 이상",58313,25584,32729
"2024.03","남구","65세 이상",59949,25900,34049
"2024.03","북구","65세 이상",60378,27187,33191
"2024.03","해운대구","65세 이상",81197,35290,45907
"2024.03","사하구","65세 이상",70327,31416,38911
"2024.03","금정구","65세 이상",54831,23960,30871
"2024.03","강서구","65세 이상",20657,9837,10820
"2024.03","연제구","65세 이상",47277,20661,26616
"2024.03","수영구","65세 이상",43121,18418,24703
"2024.03","사상구","65세 이상",46739,21142,25597
"2024.03","기장군","65세 이상",33453,14440,19013
"2024.04","중구","65세 이상",12134,5182,6952
"2024.04","서구","65세 이상",29737,12641,17096
"2024.04","동구","65세 이상",25582,10803,14779
"2024.04","영도구","65세 이상",34209,14717,19492
"2024.04","부산진구","65세 이상",81016,35102,45914
"2024.04","동래구","65세 이상",58544,25678,32866
"2024.04","남구","65세 이상",60092,25965,34127
"2024.04","북구","65세 이상",60624,27296,33328
"2024.04","해운대구","65세 이상",81457,35391,46066
"2024.04","사하구","65세 이상",70580,31503,39077
"2024.04","금정구","65세 이상",54989,24029,30960
"2024.04","강서구","65세 이상",20758,9888,10870
"2024.04","연제구","65세 이상",47442,20700,26742
"2024.04","수영구","65세 이상",43258,18471,24787
"2024.04","사상구","65세 이상",46970,21278,25692
"2024.04","기장군","65세 이상",33517,14464,19053
"2024.05","중구","65세 이상",12144,5186,6958
"2024.05","서구","65세 이상",29819,12661,17158
"2024.05","동구","65세 이상",25606,10818,14788
"2024.05","영도구","65세 이상",34311,14770,19541
"2024.05","부산진구","65세 이상",81341,35211,46130
"2024.05","동래구","65세 이상",58799,25793,33006
"2024.05","남구","65세 이상",60329,26064,34265
"2024.05","북구","65세 이상",60866,27410,33456
"2024.05","해운대구","65세 이상",81722,35513,46209
"2024.05","사하구","65세 이상",70874,31662,39212
"2024.05","금정구","65세 이상",55177,24106,31071
"2024.05","강서구","65세 이상",20827,9906,10921
"2024.05","연제구","65세 이상",47623,20762,26861
"2024.05","수영구","65세 이상",43387,18520,24867
"2024.05","사상구","65세 이상",47185,21377,25808
"2024.05","기장군","65세 이상",33632,14507,19125
"2024.06","중구","65세 이상",12166,5208,6958
"2024.06","서구","65세 이상",29880,12687,17193
"2024.06","동구","65세 이상",25634,10838,14796
"2024.06","영도구","65세 이상",34380,14792,19588
"2024.06","부산진구","65세 이상",81602,35301,46301
"2024.06","동래구","65세 이상",59016,25882,33134
"2024.06","남구","65세 이상",60523,26153,34370
"2024.06","북구","65세 이상",61118,27529,33589
"2024.06","해운대구","65세 이상",81944,35619,46325
"2024.06","사하구","65세 이상",71101,31739,39362
"2024.06","금정구","65세 이상",55298,24171,31127
"2024.06","강서구","65세 이상",20875,9935,10940
"2024.06","연제구","65세 이상",47792,20816,26976
"2024.06","수영구","65세 이상",43492,18550,24942
"2024.06","사상구","65세 이상",47351,21457,25894
"2024.06","기장군","65세 이상",33705,14520,19185
"2024.07","중구","65세 이상",12185,5212,6973
"2024.07","서구","65세 이상",29967,12706,17261
"2024.07","동구","65세 이상",25680,10872,14808
"2024.07","영도구","65세 이상",34424,14822,19602
"2024.07","부산진구","65세 이상",81884,35439,46445
"2024.07","동래구","65세 이상",59216,25971,33245
"2024.07","남구","65세 이상",60705,26236,34469
"2024.07","북구","65세 이상",61333,27628,33705
"2024.07","해운대구","65세 이상",82301,35786,46515
"2024.07","사하구","65세 이상",71361,31864,39497
"2024.07","금정구","65세 이상",55400,24220,31180
"2024.07","강서구","65세 이상",20977,9996,10981
"2024.07","연제구","65세 이상",47923,20842,27081
"2024.07","수영구","65세 이상",43577,18579,24998
"2024.07","사상구","65세 이상",47493,21519,25974
"2024.07","기장군","65세 이상",33801,14568,19233
"2024.08","중구","65세 이상",12197,5220,6977
"2024.08","서구","65세 이상",30081,12750,17331
"2024.08","동구","65세 이상",25727,10902,14825
"2024.08","영도구","65세 이상",34499,14864,19635
"2024.08","부산진구","65세 이상",82146,35569,46577
"2024.08","동래구","65세 이상",59427,26044,33383
"2024.08","남구","65세 이상",60867,26296,34571
"2024.08","북구","65세 이상",61609,27756,33853
"2024.08","해운대구","65세 이상",82609,35936,46673
"2024.08","사하구","65세 이상",71625,31980,39645
"2024.08","금정구","65세 이상",55642,24326,31316
"2024.08","강서구","65세 이상",21081,10049,11032
"2024.08","연제구","65세 이상",48125,20905,27220
"2024.08","수영구","65세 이상",43724,18638,25086
"2024.08","사상구","65세 이상",47668,21618,26050
"2024.08","기장군","65세 이상",33940,14644,19296
"2024.09","중구","65세 이상",12219,5236,6983
"2024.09","서구","65세 이상",30236,12826,17410
"2024.09","동구","65세 이상",25772,10934,14838
"2024.09","영도구","65세 이상",34568,14883,19685
"2024.09","부산진구","65세 이상",82377,35652,46725
"2024.09","동래구","65세 이상",59700,26163,33537
"2024.09","남구","65세 이상",61061,26383,34678
"2024.09","북구","65세 이상",61938,27906,34032
"2024.09","해운대구","65세 이상",82916,36090,46826
"2024.09","사하구","65세 이상",71895,32063,39832
"2024.09","금정구","65세 이상",55817,24404,31413
"2024.09","강서구","65세 이상",21179,10085,11094
"2024.09","연제구","65세 이상",48340,20991,27349
"2024.09","수영구","65세 이상",43867,18671,25196
"2024.09","사상구","65세 이상",47888,21723,26165
"2024.09","기장군","65세 이상",34035,14687,19348
"2024.10","중구","65세 이상",12219,5230,6989
"2024.10","서구","65세 이상",30355,12862,17493
"2024.10","동구","65세 이상",25818,10949,14869
"2024.10","영도구","65세 이상",34662,14922,19740
"2024.10","부산진구","65세 이상",82628,35743,46885
"2024.10","동래구","65세 이상",60194,26388,33806
"2024.10","남구","65세 이상",61256,26482,34774
"2024.10","북구","65세 이상",62267,28052,34215
"2024.10","해운대구","65세 이상",83310,36270,47040
"2024.10","사하구","65세 이상",72200,32194,40006
"2024.10","금정구","65세 이상",55986,24472,31514
"2024.10","강서구","65세 이상",21262,10118,11144
"2024.10","연제구","65세 이상",48509,21076,27433
"2024.10","수영구","65세 이상",43988,18691,25297
"2024.10","사상구","65세 이상",48105,21843,26262
"2024.10","기장군","65세 이상",34162,14741,19421
"2024.11","중구","65세 이상",12271,5258,7013
"2024.11","서구","65세 이상",30436,12894,17542
"2024.11","동구","65세 이상",25855,10960,14895
"2024.11","영도구","65세 이상",34691,14949,19742
"2024.11","부산진구","65세 이상",82777,35785,46992
"2024.11","동래구","65세 이상",60662,26598,34064
"2024.11","남구","65세 이상",61408,26543,34865
"2024.11","북구","65세 이상",62456,28128,34328
"2024.11","해운대구","65세 이상",83618,36384,47234
"2024.11","사하구","65세 이상",72494,32330,40164
"2024.11","금정구","65세 이상",56180,24576,31604
"2024.11","강서구","65세 이상",21343,10146,11197
"2024.11","연제구","65세 이상",48773,21185,27588
"2024.11","수영구","65세 이상",44121,18729,25392
"2024.11","사상구","65세 이상",48381,21984,26397
"2024.11","기장군","65세 이상",34266,14771,19495
"2024.12","중구","65세 이상",12289,5280,7009
"2024.12","서구","65세 이상",30568,12946,17622
"2024.12","동구","65세 이상",25923,10983,14940
"2024.12","영도구","65세 이상",34809,14997,19812
"2024.12","부산진구","65세 이상",83086,35899,47187
"2024.12","동래구","65세 이상",61085,26762,34323
"2024.12","남구","65세 이상",61734,26670,35064
"2024.12","북구","65세 이상",62843,28297,34546
"2024.12","해운대구","65세 이상",84047,36580,47467
"2024.12","사하구","65세 이상",72895,32481,40414
"2024.12","금정구","65세 이상",56402,24679,31723
"2024.12","강서구","65세 이상",21465,10210,11255
"2024.12","연제구","65세 이상",49080,21314,27766
"2024.12","수영구","65세 이상",44268,18752,25516
"2024.12","사상구","65세 이상",48713,22126,26587
"2024.12","기장군","65세 이상",34456,14838,19618
