"시점","구·군별",읍면동수 (개),세대수 (세대),인구수  (명),남자인구수 (명),여자인구수 (명),시전체 인구에 대한 구성비 (%),면적 (㎢),인구밀도 (명/㎢)
"2020.01","중구",9,23189,44107,21902,22205,1.3,2.83,15586
"2020.01","서구",13,52735,110097,53795,56302,3.2,13.98,7875
"2020.01","동구",12,44734,90632,44480,46152,2.6,9.87,9183
"2020.01","영도구",11,54852,118353,58647,59706,3.4,14.20,8335
"2020.01","부산진구",20,166981,360439,174373,186066,10.4,29.67,12148
"2020.01","동래구",13,112473,272820,132832,139988,7.9,16.63,16405
"2020.01","남구",17,117212,280052,137258,142794,8.1,26.82,10442
"2020.01","북구",13,120406,293482,145311,148171,8.5,39.37,7454
"2020.01","해운대구",18,168851,411497,198570,212927,11.9,51.47,7995
"2020.01","사하구",16,138670,325219,162775,162444,9.4,41.77,7786
"2020.01","금정구",16,106857,243328,118742,124586,7.0,65.27,3728
"2020.01","강서구",8,54087,135812,71980,63832,3.9,181.49,748
"2020.01","연제구",12,90601,211026,101888,109138,6.1,12.10,17440
"2020.01","수영구",10,81608,177861,84307,93554,5.1,10.21,17420
"2020.01","사상구",12,96652,222840,112913,109927,6.4,36.09,6175
"2020.01","기장군",5,69244,166943,83126,83817,4.8,218.30,765
"2020.02","중구",9,23272,44115,21899,22216,1.3,2.83,15588
"2020.02","서구",13,52806,109971,53679,56292,3.2,13.98,7866
"2020.02","동구",12,44894,90778,44557,46221,2.6,9.87,9197
"2020.02","영도구",11,54824,118055,58463,59592,3.4,14.20,8314
"2020.02","부산진구",20,167266,359945,174090,185855,10.4,29.67,12132
"2020.02","동래구",13,112724,272785,132783,140002,7.9,16.63,16403
"2020.02","남구",17,117208,279203,136804,142399,8.1,26.82,10410
"2020.02","북구",13,120435,292797,144945,147852,8.5,39.37,7437
"2020.02","해운대구",18,168916,410898,198269,212629,11.9,51.47,7983
"2020.02","사하구",16,138770,324510,162456,162054,9.4,41.77,7769
"2020.02","금정구",16,107042,242911,118501,124410,7.0,65.27,3722
"2020.02","강서구",8,54359,136226,72139,64087,3.9,181.49,751
"2020.02","연제구",12,90948,211562,102142,109420,6.1,12.10,17484
"2020.02","수영구",10,82083,178637,84582,94055,5.2,10.21,17496
"2020.02","사상구",12,96781,222476,112720,109756,6.4,36.09,6164
"2020.02","기장군",5,70005,168560,83878,84682,4.9,218.30,772
"2020.03","중구",9,23305,44031,21839,22192,1.3,2.83,15559
"2020.03","서구",13,52792,109756,53507,56249,3.2,13.98,7851
"2020.03","동구",12,45356,91585,44918,46667,2.6,9.87,9279
"2020.03","영도구",11,54837,117765,58299,59466,3.4,14.20,8293
"2020.03","부산진구",20,167761,359790,173899,185891,10.4,29.67,12126
"2020.03","동래구",13,113266,273573,133179,140394,7.9,16.63,16451
"2020.03","남구",17,117299,278619,136448,142171,8.0,26.82,10388
"2020.03","북구",13,120496,292106,144564,147542,8.4,39.37,7420
"2020.03","해운대구",18,169141,410223,197881,212342,11.9,51.47,7970
"2020.03","사하구",16,138864,323758,162020,161738,9.4,41.77,7751
"2020.03","금정구",16,107184,242147,118010,124137,7.0,65.27,3710
"2020.03","강서구",8,54611,136491,72232,64259,3.9,181.49,752
"2020.03","연제구",12,91106,211385,101999,109386,6.1,12.10,17470
"2020.03","수영구",10,82334,178715,84577,94138,5.2,10.21,17504
"2020.03","사상구",12,96859,221983,112448,109535,6.4,36.09,6151
"2020.03","기장군",5,70686,169797,84487,85310,4.9,218.30,778
"2020.04","중구",9,23313,43931,21791,22140,1.3,2.83,15523
"2020.04","서구",13,52884,109730,53489,56241,3.2,13.98,7849
"2020.04","동구",12,45578,91994,45109,46885,2.7,9.87,9321
"2020.04","영도구",11,54812,117469,58138,59331,3.4,14.20,8272
"2020.04","부산진구",20,168189,359968,173926,186042,10.4,29.67,12132
"2020.04","동래구",13,113547,273819,133324,140495,7.9,16.63,16465
"2020.04","남구",17,117167,277599,136018,141581,8.0,26.82,10350
"2020.04","북구",13,120449,291527,144265,147262,8.4,39.37,7405
"2020.04","해운대구",18,169357,410242,197838,212404,11.9,51.47,7971
"2020.04","사하구",16,138813,322960,161595,161365,9.3,41.77,7732
"2020.04","금정구",16,107101,241100,117535,123565,7.0,65.27,3694
"2020.04","강서구",8,54725,136516,72206,64310,3.9,181.49,752
"2020.04","연제구",12,91122,211136,101828,109308,6.1,12.10,17449
"2020.04","수영구",10,82464,178722,84504,94218,5.2,10.21,17505
"2020.04","사상구",12,96924,221480,112219,109261,6.4,36.09,6137
"2020.04","기장군",5,71059,170313,84740,85573,4.9,218.30,780
"2020.05","중구",9,23406,43835,21755,22080,1.3,2.83,15489
"2020.05","서구",13,53072,109820,53529,56291,3.2,13.98,7856
"2020.05","동구",12,45755,91996,45089,46907,2.7,9.87,9321
"2020.05","영도구",11,54884,117176,57970,59206,3.4,14.20,8252
"2020.05","부산진구",20,168789,360102,173984,186118,10.4,29.67,12137
"2020.05","동래구",13,113823,273785,133313,140472,7.9,16.63,16463
"2020.05","남구",17,117350,276728,135553,141175,8.0,26.82,10318
"2020.05","북구",13,120663,291433,144186,147247,8.4,39.37,7402
"2020.05","해운대구",18,169532,409307,197310,211997,11.8,51.47,7952
"2020.05","사하구",16,138962,322439,161281,161158,9.3,41.77,7719
"2020.05","금정구",16,107313,240623,117312,123311,7.0,65.27,3687
"2020.05","강서구",8,54994,136814,72352,64462,4.0,181.49,754
"2020.05","연제구",12,91287,210893,101643,109250,6.1,12.10,17429
"2020.05","수영구",10,82670,178605,84422,94183,5.2,10.21,17493
"2020.05","사상구",12,97038,220861,111907,108954,6.4,36.09,6120
"2020.05","기장군",5,71661,171301,85207,86094,5.0,218.30,785
"2020.06","중구",9,23456,43722,21702,22020,1.3,2.83,15449
"2020.06","서구",13,53248,109885,53544,56341,3.2,13.98,7860
"2020.06","동구",12,45873,91975,45080,46895,2.7,9.87,9319
"2020.06","영도구",11,54866,116896,57795,59101,3.4,14.20,8232
"2020.06","부산진구",20,169203,360176,173950,186226,10.4,29.67,12139
"2020.06","동래구",13,114058,273713,133195,140518,7.9,16.63,16459
"2020.06","남구",17,117429,276111,135244,140867,8.0,26.82,10295
"2020.06","북구",13,120694,290808,143863,146945,8.4,39.37,7387
"2020.06","해운대구",18,169825,408732,196993,211739,11.8,51.47,7941
"2020.06","사하구",16,139108,321916,161035,160881,9.3,41.77,7707
"2020.06","금정구",16,107358,240006,117016,122990,7.0,65.27,3677
"2020.06","강서구",8,55158,137005,72436,64569,4.0,181.49,755
"2020.06","연제구",12,91412,210515,101437,109078,6.1,12.10,17398
"2020.06","수영구",10,82989,178702,84448,94254,5.2,10.21,17503
"2020.06","사상구",12,97113,220468,111722,108746,6.4,36.09,6109
"2020.06","기장군",5,72166,172280,85639,86641,5.0,218.30,789
"2020.07","중구",9,23544,43721,21688,22033,1.3,2.83,15449
"2020.07","서구",13,53340,109870,53519,56351,3.2,13.98,7859
"2020.07","동구",12,45954,91979,45092,46887,2.7,9.87,9319
"2020.07","영도구",11,54914,116752,57748,59004,3.4,14.20,8222
"2020.07","부산진구",20,169952,360582,174125,186457,10.4,29.67,12153
"2020.07","동래구",13,114414,273793,133256,140537,7.9,16.63,16464
"2020.07","남구",17,117537,275565,134988,140577,8.0,26.82,10275
"2020.07","북구",13,120706,290157,143561,146596,8.4,39.37,7370
"2020.07","해운대구",18,170255,408611,196894,211717,11.8,51.47,7939
"2020.07","사하구",16,139163,321352,160716,160636,9.3,41.77,7693
"2020.07","금정구",16,107273,238974,116481,122493,6.9,65.27,3661
"2020.07","강서구",8,55314,137122,72447,64675,4.0,181.49,756
"2020.07","연제구",12,91608,210336,101353,108983,6.1,12.10,17383
"2020.07","수영구",10,83207,178463,84334,94129,5.2,10.21,17479
"2020.07","사상구",12,97215,220011,111480,108531,6.4,36.09,6096
"2020.07","기장군",5,72804,173495,86236,87259,5.0,218.30,795
"2020.08","중구",9,23626,43691,21663,22028,1.3,2.83,15439
"2020.08","서구",13,53342,109691,53411,56280,3.2,13.98,7846
"2020.08","동구",12,45994,91907,45015,46892,2.7,9.87,9312
"2020.08","영도구",11,54870,116477,57634,58843,3.4,14.20,8203
"2020.08","부산진구",20,170624,360634,174170,186464,10.5,29.67,12155
"2020.08","동래구",13,114527,273413,132982,140431,7.9,16.63,16441
"2020.08","남구",17,117649,274994,134693,140301,8.0,26.82,10253
"2020.08","북구",13,120652,289260,143072,146188,8.4,39.37,7347
"2020.08","해운대구",18,170290,407804,196437,211367,11.8,51.47,7923
"2020.08","사하구",16,139139,320351,160190,160161,9.3,41.77,7669
"2020.08","금정구",16,107323,238347,116173,122174,6.9,65.27,3652
"2020.08","강서구",8,55958,138423,73091,65332,4.0,181.49,763
"2020.08","연제구",12,92154,211128,101701,109427,6.1,12.10,17449
"2020.08","수영구",10,83579,178642,84444,94198,5.2,10.21,17497
"2020.08","사상구",12,97274,219383,111114,108269,6.4,36.09,6079
"2020.08","기장군",5,73320,174425,86717,87708,5.1,218.30,799
"2020.09","중구",9,23682,43644,21660,21984,1.3,2.83,15422
"2020.09","서구",13,53359,109614,53381,56233,3.2,13.98,7841
"2020.09","동구",12,45985,91639,44889,46750,2.7,9.87,9285
"2020.09","영도구",11,54896,116212,57502,58710,3.4,14.20,8184
"2020.09","부산진구",20,171008,360431,173987,186444,10.5,29.67,12148
"2020.09","동래구",13,114679,273215,132886,140329,7.9,16.63,16429
"2020.09","남구",17,117696,274824,134572,140252,8.0,26.82,10247
"2020.09","북구",13,120703,288689,142787,145902,8.4,39.37,7333
"2020.09","해운대구",18,170518,407443,196191,211252,11.8,51.47,7916
"2020.09","사하구",16,139047,319277,159550,159727,9.3,41.77,7644
"2020.09","금정구",16,107383,238173,115984,122189,6.9,65.27,3649
"2020.09","강서구",8,56828,140337,74069,66268,4.1,181.49,773
"2020.09","연제구",12,92418,211344,101768,109576,6.1,12.10,17466
"2020.09","수영구",10,83906,178975,84598,94377,5.2,10.21,17529
"2020.09","사상구",12,97357,218913,110845,108068,6.3,36.09,6066
"2020.09","기장군",5,73657,174882,86962,87920,5.1,218.30,801
"2020.10","중구",9,23723,43645,21649,21996,1.3,2.83,15422
"2020.10","서구",13,53576,109911,53498,56413,3.2,13.98,7862
"2020.10","동구",12,45994,91401,44730,46671,2.7,9.87,9260
"2020.10","영도구",11,54876,115850,57320,58530,3.4,14.20,8158
"2020.10","부산진구",20,171637,361166,174403,186763,10.5,29.67,12173
"2020.10","동래구",13,114739,272862,132690,140172,7.9,16.63,16408
"2020.10","남구",17,117685,274219,134328,139891,8.0,26.82,10224
"2020.10","북구",13,120604,287861,142375,145486,8.4,39.37,7312
"2020.10","해운대구",18,170815,407484,196175,211309,11.8,51.47,7917
"2020.10","사하구",16,138879,318198,158937,159261,9.2,41.77,7618
"2020.10","금정구",16,107345,237527,115633,121894,6.9,65.27,3639
"2020.10","강서구",8,57341,141408,74564,66844,4.1,181.49,779
"2020.10","연제구",12,92475,211174,101674,109500,6.1,12.10,17452
"2020.10","수영구",10,83941,178780,84457,94323,5.2,10.21,17510
"2020.10","사상구",12,97343,218344,110547,107797,6.3,36.09,6050
"2020.10","기장군",5,73915,175259,87135,88124,5.1,218.30,803
"2020.11","중구",9,23773,43571,21609,21962,1.3,2.83,15396
"2020.11","서구",13,53724,110027,53535,56492,3.2,13.98,7870
"2020.11","동구",12,46003,91194,44619,46575,2.6,9.87,9240
"2020.11","영도구",11,54896,115513,57142,58371,3.4,14.20,8135
"2020.11","부산진구",20,172561,362213,174861,187352,10.5,29.67,12208
"2020.11","동래구",13,114826,272403,132444,139959,7.9,16.63,16380
"2020.11","남구",17,117804,273735,134096,139639,8.0,26.82,10206
"2020.11","북구",13,120665,287203,142052,145151,8.3,39.37,7295
"2020.11","해운대구",18,171099,407182,196040,211142,11.8,51.47,7911
"2020.11","사하구",16,138906,317333,158470,158863,9.2,41.77,7597
"2020.11","금정구",16,107491,237153,115433,121720,6.9,65.27,3633
"2020.11","강서구",8,57690,142064,74866,67198,4.1,181.49,783
"2020.11","연제구",12,92535,210666,101381,109285,6.1,12.10,17410
"2020.11","수영구",10,84049,178576,84335,94241,5.2,10.21,17490
"2020.11","사상구",12,97419,217787,110221,107566,6.3,36.09,6035
"2020.11","기장군",5,74280,176013,87529,88484,5.1,218.30,806
"2020.12","중구",9,23847,43617,21621,21996,1.3,2.83,15412
"2020.12","서구",13,53853,110051,53521,56530,3.2,13.96,7883
"2020.12","동구",12,46003,91061,44528,46533,2.6,9.86,9235
"2020.12","영도구",11,54903,115144,56953,58191,3.3,14.20,8109
"2020.12","부산진구",20,173263,362701,175064,187637,10.5,29.67,12225
"2020.12","동래구",13,114987,271966,132164,139802,7.9,16.63,16354
"2020.12","남구",17,117876,273144,133785,139359,7.9,26.82,10184
"2020.12","북구",13,120668,286291,141605,144686,8.3,39.37,7272
"2020.12","해운대구",18,171376,406818,195883,210935,11.8,51.50,7899
"2020.12","사하구",16,138854,316226,157924,158302,9.2,41.77,7571
"2020.12","금정구",16,107561,236485,115133,121352,6.9,65.26,3624
"2020.12","강서구",8,58141,142719,75157,67562,4.2,181.49,786
"2020.12","연제구",12,92583,210128,101055,109073,6.1,12.10,17366
"2020.12","수영구",10,84311,178589,84332,94257,5.2,10.21,17492
"2020.12","사상구",12,97556,217135,109876,107259,6.3,36.10,6015
"2020.12","기장군",5,74649,176635,87811,88824,5.1,218.30,809
"2021.01","중구",9,23923,43657,21599,22058,1.3,2.83,15427
"2021.01","서구",13,53881,109876,53464,56412,3.2,13.96,7871
"2021.01","동구",12,46081,90905,44464,46441,2.6,9.86,9220
"2021.01","영도구",11,54905,114844,56803,58041,3.3,14.20,8088
"2021.01","부산진구",20,173746,362772,174998,187774,10.6,29.67,12227
"2021.01","동래구",13,115221,271917,132126,139791,7.9,16.63,16351
"2021.01","남구",17,117885,272700,133507,139193,7.9,26.82,10168
"2021.01","북구",13,120728,285787,141324,144463,8.3,39.37,7259
"2021.01","해운대구",18,171528,406349,195600,210749,11.8,51.50,7890
"2021.01","사하구",16,138852,315489,157568,157921,9.2,41.77,7553
"2021.01","금정구",16,107415,235664,114741,120923,6.9,65.26,3611
"2021.01","강서구",8,58512,143347,75515,67832,4.2,181.49,790
"2021.01","연제구",12,92694,209856,100913,108943,6.1,12.10,17343
"2021.01","수영구",10,84460,178441,84273,94168,5.2,10.21,17477
"2021.01","사상구",12,97687,216678,109640,107038,6.3,36.10,6002
"2021.01","기장군",5,75182,177505,88202,89303,5.2,218.30,813
"2021.02","중구",9,24010,43629,21598,22031,1.3,2.83,15417
"2021.02","서구",13,53962,109759,53367,56392,3.2,13.96,7862
"2021.02","동구",12,46128,90744,44354,46390,2.6,9.86,9203
"2021.02","영도구",11,54936,114636,56704,57932,3.3,14.20,8073
"2021.02","부산진구",20,174327,362796,174884,187912,10.6,29.67,12228
"2021.02","동래구",13,115476,271884,132133,139751,7.9,16.63,16349
"2021.02","남구",17,118052,272272,133311,138961,7.9,26.82,10152
"2021.02","북구",13,120741,285105,140890,144215,8.3,39.37,7242
"2021.02","해운대구",18,171770,405922,195335,210587,11.8,51.50,7882
"2021.02","사하구",16,139159,315140,157418,157722,9.2,41.77,7545
"2021.02","금정구",16,107710,235357,114692,120665,6.9,65.26,3606
"2021.02","강서구",8,58905,143787,75736,68051,4.2,181.49,792
"2021.02","연제구",12,92851,209692,100802,108890,6.1,12.10,17330
"2021.02","수영구",10,84736,178389,84261,94128,5.2,10.21,17472
"2021.02","사상구",12,97946,216436,109530,106906,6.3,36.10,5995
"2021.02","기장군",5,75533,178176,88533,89643,5.2,218.30,816
"2021.03","중구",9,23951,43438,21511,21927,1.3,2.83,15349
"2021.03","서구",13,52876,108375,52726,55649,3.2,13.96,7763
"2021.03","동구",12,45786,90330,44204,46126,2.6,9.86,9161
"2021.03","영도구",11,54048,113332,56124,57208,3.3,14.20,7981
"2021.03","부산진구",20,172683,360491,173860,186631,10.5,29.67,12150
"2021.03","동래구",13,114936,270706,131639,139067,7.9,16.63,16278
"2021.03","남구",17,117391,271176,132814,138362,7.9,26.82,10111
"2021.03","북구",13,120370,284127,140402,143725,8.3,39.37,7217
"2021.03","해운대구",18,171352,404748,194836,209912,11.8,51.50,7859
"2021.03","사하구",16,138478,313704,156712,156992,9.2,41.77,7510
"2021.03","금정구",16,107184,234561,114304,120257,6.9,65.26,3594
"2021.03","강서구",8,58879,143899,75819,68080,4.2,181.49,793
"2021.03","연제구",12,92104,208352,100297,108055,6.1,12.10,17219
"2021.03","수영구",10,84569,177833,84027,93806,5.2,10.21,17418
"2021.03","사상구",12,97727,215731,109124,106607,6.3,36.10,5976
"2021.03","기장군",5,75496,178121,88509,89612,5.2,218.30,816
"2021.04","중구",9,24006,43362,21452,21910,1.3,2.83,15322
"2021.04","서구",13,53018,108453,52738,55715,3.2,13.96,7769
"2021.04","동구",12,45865,90257,44159,46098,2.6,9.86,9154
"2021.04","영도구",11,54141,113204,56078,57126,3.3,14.20,7972
"2021.04","부산진구",20,172771,360021,173641,186380,10.5,29.67,12134
"2021.04","동래구",13,114977,270221,131322,138899,7.9,16.63,16249
"2021.04","남구",17,117426,270610,132538,138072,7.9,26.82,10090
"2021.04","북구",13,120807,284334,140532,143802,8.3,39.37,7222
"2021.04","해운대구",18,171558,404514,194679,209835,11.8,51.50,7855
"2021.04","사하구",16,138475,313036,156337,156699,9.2,41.77,7494
"2021.04","금정구",16,107157,234173,114086,120087,6.9,65.26,3588
"2021.04","강서구",8,59236,144243,75992,68251,4.2,181.49,795
"2021.04","연제구",12,92091,207912,100048,107864,6.1,12.10,17183
"2021.04","수영구",10,84717,177962,84067,93895,5.2,10.21,17430
"2021.04","사상구",12,97841,215465,108954,106511,6.3,36.10,5969
"2021.04","기장군",5,75708,178323,88616,89707,5.2,218.30,817
"2021.05","중구",9,24022,43216,21366,21850,1.3,2.83,15271
"2021.05","서구",13,53115,108450,52686,55764,3.2,13.96,7769
"2021.05","동구",12,45918,90136,44063,46073,2.6,9.86,9142
"2021.05","영도구",11,54388,113378,56123,57255,3.3,14.20,7984
"2021.05","부산진구",20,172912,359504,173351,186153,10.5,29.67,12117
"2021.05","동래구",13,115078,269829,131102,138727,7.9,16.63,16225
"2021.05","남구",17,117429,270063,132274,137789,7.9,26.82,10069
"2021.05","북구",13,121596,285389,141065,144324,8.4,39.37,7249
"2021.05","해운대구",18,171558,403908,194388,209520,11.8,51.50,7843
"2021.05","사하구",16,138530,312377,156022,156355,9.2,41.77,7479
"2021.05","금정구",16,107158,233642,113868,119774,6.8,65.26,3580
"2021.05","강서구",8,59598,144752,76249,68503,4.2,181.49,798
"2021.05","연제구",12,92100,207472,99817,107655,6.1,12.10,17146
"2021.05","수영구",10,84790,177739,83958,93781,5.2,10.21,17408
"2021.05","사상구",12,98003,215117,108761,106356,6.3,36.10,5959
"2021.05","기장군",5,75858,178443,88672,89771,5.2,218.30,817
"2021.06","중구",9,23583,42619,21140,21479,1.2,2.83,15060
"2021.06","서구",13,53133,108383,52665,55718,3.2,13.96,7764
"2021.06","동구",12,45911,89982,43987,45995,2.6,9.86,9126
"2021.06","영도구",11,54568,113510,56185,57325,3.3,14.20,7994
"2021.06","부산진구",20,172864,358896,173049,185847,10.5,29.67,12096
"2021.06","동래구",13,115173,269590,130971,138619,7.9,16.63,16211
"2021.06","남구",17,117410,269492,131951,137541,7.9,26.82,10048
"2021.06","북구",13,122023,285847,141260,144587,8.4,39.37,7261
"2021.06","해운대구",18,171791,403635,194245,209390,11.8,51.50,7838
"2021.06","사하구",16,138589,311859,155713,156146,9.1,41.77,7466
"2021.06","금정구",16,107165,233081,113601,119480,6.8,65.26,3572
"2021.06","강서구",8,59954,145270,76539,68731,4.3,181.49,800
"2021.06","연제구",12,92165,207173,99637,107536,6.1,12.10,17122
"2021.06","수영구",10,84948,177568,83819,93749,5.2,10.21,17392
"2021.06","사상구",12,98179,214810,108587,106223,6.3,36.10,5950
"2021.06","기장군",5,76058,178637,88783,89854,5.2,218.30,818
"2021.07","중구",9,23714,42734,21213,21521,1.3,2.83,15100
"2021.07","서구",13,53159,108279,52647,55632,3.2,13.96,7756
"2021.07","동구",12,45930,89813,43881,45932,2.6,9.86,9109
"2021.07","영도구",11,54643,113411,56127,57284,3.3,14.20,7987
"2021.07","부산진구",20,172962,358333,172745,185588,10.5,29.67,12077
"2021.07","동래구",13,115239,269171,130761,138410,7.9,16.63,16186
"2021.07","남구",17,117384,269085,131692,137393,7.9,26.82,10033
"2021.07","북구",13,122336,285928,141260,144668,8.4,39.37,7263
"2021.07","해운대구",18,171911,403262,194033,209229,11.8,51.50,7830
"2021.07","사하구",16,138547,311146,155337,155809,9.1,41.77,7449
"2021.07","금정구",16,107360,232947,113558,119389,6.8,65.26,3570
"2021.07","강서구",8,60289,145740,76786,68954,4.3,181.49,803
"2021.07","연제구",12,92192,206864,99444,107420,6.1,12.10,17096
"2021.07","수영구",10,85083,177424,83772,93652,5.2,10.21,17377
"2021.07","사상구",12,98304,214401,108376,106025,6.3,36.10,5939
"2021.07","기장군",5,76241,178812,88852,89960,5.2,218.30,819
"2021.08","중구",9,23820,42768,21216,21552,1.3,2.83,15112
"2021.08","서구",13,53095,107976,52498,55478,3.2,13.96,7735
"2021.08","동구",12,45914,89602,43777,45825,2.6,9.86,9087
"2021.08","영도구",11,54681,113193,55995,57198,3.3,14.20,7971
"2021.08","부산진구",20,173084,357872,172349,185523,10.5,29.67,12062
"2021.08","동래구",13,115276,268834,130575,138259,7.9,16.63,16166
"2021.08","남구",17,117494,268615,131412,137203,7.9,26.82,10015
"2021.08","북구",13,122676,286121,141315,144806,8.4,39.37,7267
"2021.08","해운대구",18,172076,402709,193728,208981,11.8,51.50,7820
"2021.08","사하구",16,138893,311154,155328,155826,9.1,41.77,7449
"2021.08","금정구",16,107559,232836,113527,119309,6.8,65.26,3568
"2021.08","강서구",8,60574,146189,77049,69140,4.3,181.49,805
"2021.08","연제구",12,92236,206624,99365,107259,6.1,12.10,17076
"2021.08","수영구",10,85343,177520,83797,93723,5.2,10.21,17387
"2021.08","사상구",12,98305,213856,108131,105725,6.3,36.10,5924
"2021.08","기장군",5,76369,178840,88837,90003,5.3,218.30,819
"2021.09","중구",9,23878,42760,21217,21543,1.3,2.83,15110
"2021.09","서구",13,53097,107787,52395,55392,3.2,13.96,7721
"2021.09","동구",12,46046,89617,43822,45795,2.6,9.86,9089
"2021.09","영도구",11,54701,113026,55895,57131,3.3,14.20,7960
"2021.09","부산진구",20,173279,357670,172161,185509,10.5,29.67,12055
"2021.09","동래구",13,115356,268587,130446,138141,7.9,16.63,16151
"2021.09","남구",17,117793,268683,131395,137288,7.9,26.82,10018
"2021.09","북구",13,122950,286138,141259,144879,8.4,39.37,7268
"2021.09","해운대구",18,172237,402554,193562,208992,11.8,51.50,7817
"2021.09","사하구",16,139174,311091,155259,155832,9.1,41.77,7448
"2021.09","금정구",16,107990,233472,113699,119773,6.9,65.26,3578
"2021.09","강서구",8,60878,146607,77292,69315,4.3,181.49,808
"2021.09","연제구",12,92451,206585,99349,107236,6.1,12.10,17073
"2021.09","수영구",10,85573,177537,83785,93752,5.2,10.21,17389
"2021.09","사상구",12,98505,213940,108100,105840,6.3,36.10,5926
"2021.09","기장군",5,76434,178822,88790,90032,5.3,218.30,819
"2021.10","중구",9,23909,42734,21189,21545,1.3,2.83,15100
"2021.10","서구",13,53038,107536,52275,55261,3.2,13.96,7703
"2021.10","동구",12,46123,89731,43886,45845,2.6,9.86,9101
"2021.10","영도구",11,54721,112928,55813,57115,3.3,14.20,7953
"2021.10","부산진구",20,173300,357200,171877,185323,10.5,29.67,12039
"2021.10","동래구",13,115301,268074,130178,137896,7.9,16.63,16120
"2021.10","남구",17,118005,268663,131343,137320,7.9,26.82,10017
"2021.10","북구",13,123090,285961,141185,144776,8.4,39.37,7263
"2021.10","해운대구",18,172349,402195,193432,208763,11.8,51.50,7810
"2021.10","사하구",16,139393,310836,155076,155760,9.1,41.77,7442
"2021.10","금정구",16,108131,233233,113583,119650,6.9,65.26,3574
"2021.10","강서구",8,61157,146910,77451,69459,4.3,181.49,809
"2021.10","연제구",12,92572,206511,99339,107172,6.1,12.10,17067
"2021.10","수영구",10,85693,177319,83679,93640,5.2,10.21,17367
"2021.10","사상구",12,98616,213685,107961,105724,6.3,36.10,5919
"2021.10","기장군",5,76577,178898,88810,90088,5.3,218.30,820
"2021.11","중구",9,23898,42602,21119,21483,1.3,2.83,15054
"2021.11","서구",13,53019,107381,52178,55203,3.2,13.96,7692
"2021.11","동구",12,46243,89798,43923,45875,2.6,9.86,9107
"2021.11","영도구",11,54721,112715,55720,56995,3.3,14.20,7938
"2021.11","부산진구",20,173278,356546,171585,184961,10.5,29.67,12017
"2021.11","동래구",13,115310,267705,129977,137728,7.9,16.63,16098
"2021.11","남구",17,117987,268246,131125,137121,7.9,26.82,10002
"2021.11","북구",13,123283,285767,141023,144744,8.4,39.37,7258
"2021.11","해운대구",18,172455,401778,193218,208560,11.8,51.50,7802
"2021.11","사하구",16,139558,310651,154977,155674,9.1,41.77,7437
"2021.11","금정구",16,108257,232989,113466,119523,6.9,65.26,3570
"2021.11","강서구",8,61397,147215,77590,69625,4.3,181.49,811
"2021.11","연제구",12,92850,206649,99389,107260,6.1,12.10,17078
"2021.11","수영구",10,85830,177120,83560,93560,5.2,10.21,17348
"2021.11","사상구",12,98627,213290,107732,105558,6.3,36.10,5908
"2021.11","기장군",5,76725,179202,88960,90242,5.3,218.30,821
"2021.12","중구",9,23925,42609,21120,21489,1.3,2.83,15056
"2021.12","서구",13,52960,107143,52051,55092,3.2,13.95,7681
"2021.12","동구",12,46362,89712,43851,45861,2.6,9.87,9089
"2021.12","영도구",11,54659,112451,55576,56875,3.3,14.20,7919
"2021.12","부산진구",20,173353,355902,171262,184640,10.5,29.67,11995
"2021.12","동래구",13,115718,268004,130093,137911,7.9,16.63,16116
"2021.12","남구",17,117821,267422,130654,136768,7.9,26.82,9971
"2021.12","북구",13,123316,285390,140791,144599,8.4,39.37,7249
"2021.12","해운대구",18,172397,401131,192901,208230,11.8,51.54,7783
"2021.12","사하구",16,139604,310195,154681,155514,9.1,41.77,7426
"2021.12","금정구",16,108070,231996,113067,118929,6.8,65.28,3554
"2021.12","강서구",8,61502,147347,77658,69689,4.3,181.50,812
"2021.12","연제구",12,93606,208050,100107,107943,6.1,12.10,17194
"2021.12","수영구",10,85896,176812,83375,93437,5.2,10.22,17301
"2021.12","사상구",12,98621,212771,107440,105331,6.3,36.10,5894
"2021.12","기장군",5,76853,179174,88992,90182,5.3,218.32,821
"2022.01","중구",9,23979,42636,21149,21487,1.3,2.83,15066
"2022.01","서구",13,52853,106863,51951,54912,3.1,13.95,7660
"2022.01","동구",12,46597,89950,43953,45997,2.6,9.87,9113
"2022.01","영도구",11,54609,112237,55482,56755,3.3,14.20,7904
"2022.01","부산진구",20,173327,355187,170949,184238,10.5,29.67,11971
"2022.01","동래구",13,117211,271480,131810,139670,8.0,16.63,16325
"2022.01","남구",17,117619,266557,130274,136283,7.9,26.82,9939
"2022.01","북구",13,123247,284705,140402,144303,8.4,39.37,7232
"2022.01","해운대구",18,172327,400488,192518,207970,11.8,51.54,7770
"2022.01","사하구",16,139856,310108,154597,155511,9.1,41.77,7424
"2022.01","금정구",16,107737,230711,112455,118256,6.8,65.28,3534
"2022.01","강서구",8,61711,147512,77712,69800,4.3,181.50,813
"2022.01","연제구",12,93890,208255,100213,108042,6.1,12.10,17211
"2022.01","수영구",10,86014,176586,83261,93325,5.2,10.22,17278
"2022.01","사상구",12,98536,212177,107160,105017,6.3,36.10,5877
"2022.01","기장군",5,76901,178998,88883,90115,5.3,218.32,820
"2022.02","중구",9,24129,42680,21156,21524,1.3,2.83,15081
"2022.02","서구",13,52900,106634,51836,54798,3.1,13.95,7644
"2022.02","동구",12,46829,90283,44108,46175,2.7,9.87,9147
"2022.02","영도구",11,54560,111807,55305,56502,3.3,14.20,7874
"2022.02","부산진구",20,173496,354445,170555,183890,10.4,29.67,11946
"2022.02","동래구",13,118748,274961,133387,141574,8.1,16.63,16534
"2022.02","남구",17,117815,265905,129966,135939,7.8,26.82,9914
"2022.02","북구",13,123263,283878,139985,143893,8.4,39.37,7211
"2022.02","해운대구",18,172279,399486,191987,207499,11.8,51.54,7751
"2022.02","사하구",16,140385,310274,154680,155594,9.1,41.77,7428
"2022.02","금정구",16,107785,229763,112011,117752,6.8,65.28,3520
"2022.02","강서구",8,61929,147652,77762,69890,4.4,181.50,814
"2022.02","연제구",12,94026,208090,100065,108025,6.1,12.10,17198
"2022.02","수영구",10,86261,176542,83210,93332,5.2,10.22,17274
"2022.02","사상구",12,98603,211432,106793,104639,6.2,36.10,5857
"2022.02","기장군",5,76959,178779,88781,89998,5.3,218.32,819
"2022.03","중구",9,24218,42725,21157,21568,1.3,2.83,15097
"2022.03","서구",13,52895,106334,51687,54647,3.1,13.95,7623
"2022.03","동구",12,46938,90335,44135,46200,2.7,9.87,9152
"2022.03","영도구",11,54518,111479,55151,56328,3.3,14.20,7851
"2022.03","부산진구",20,173573,353840,170248,183592,10.4,29.67,11926
"2022.03","동래구",13,119112,275297,133522,141775,8.1,16.63,16554
"2022.03","남구",17,118153,266025,130008,136017,7.8,26.82,9919
"2022.03","북구",13,123286,283300,139680,143620,8.4,39.37,7196
"2022.03","해운대구",18,172227,398483,191470,207013,11.8,51.54,7732
"2022.03","사하구",16,140594,309924,154517,155407,9.1,41.77,7420
"2022.03","금정구",16,107916,229693,111883,117810,6.8,65.28,3519
"2022.03","강서구",8,62135,147857,77818,70039,4.4,181.50,815
"2022.03","연제구",12,94091,207847,99905,107942,6.1,12.10,17177
"2022.03","수영구",10,86445,176361,83049,93312,5.2,10.22,17256
"2022.03","사상구",12,98651,211304,106596,104708,6.2,36.10,5853
"2022.03","기장군",5,77015,178618,88723,89895,5.3,218.32,818
"2022.04","중구",9,24269,42773,21193,21580,1.3,2.83,15114
"2022.04","서구",13,52822,105963,51487,54476,3.1,13.95,7596
"2022.04","동구",12,46970,90308,44092,46216,2.7,9.87,9150
"2022.04","영도구",11,54478,111254,55011,56243,3.3,14.20,7835
"2022.04","부산진구",20,173947,353687,170112,183575,10.4,29.67,11921
"2022.04","동래구",13,119227,275134,133411,141723,8.1,16.63,16544
"2022.04","남구",17,118406,266059,130045,136014,7.9,26.82,9920
"2022.04","북구",13,123330,282955,139491,143464,8.4,39.37,7187
"2022.04","해운대구",18,172217,397957,191257,206700,11.8,51.54,7721
"2022.04","사하구",16,140807,309718,154399,155319,9.1,41.77,7415
"2022.04","금정구",16,107856,229112,111612,117500,6.8,65.28,3510
"2022.04","강서구",8,62285,148066,77948,70118,4.4,181.50,816
"2022.04","연제구",12,94123,207592,99716,107876,6.1,12.10,17156
"2022.04","수영구",10,86584,176350,83040,93310,5.2,10.22,17255
"2022.04","사상구",12,98618,210863,106360,104503,6.2,36.10,5841
"2022.04","기장군",5,77093,178558,88691,89867,5.3,218.32,818
"2022.05","중구",9,24303,42680,21186,21494,1.3,2.83,15081
"2022.05","서구",13,52852,105851,51389,54462,3.1,13.95,7588
"2022.05","동구",12,47024,90296,44068,46228,2.7,9.87,9149
"2022.05","영도구",11,54650,111321,55051,56270,3.3,14.20,7840
"2022.05","부산진구",20,174306,353659,169997,183662,10.4,29.67,11920
"2022.05","동래구",13,119446,275173,133310,141863,8.1,16.63,16547
"2022.05","남구",17,118544,265675,129842,135833,7.8,26.82,9906
"2022.05","북구",13,123469,282753,139382,143371,8.4,39.37,7182
"2022.05","해운대구",18,172126,396931,190686,206245,11.7,51.54,7701
"2022.05","사하구",16,140991,309583,154369,155214,9.1,41.77,7412
"2022.05","금정구",16,107900,228835,111429,117406,6.8,65.28,3505
"2022.05","강서구",8,62530,148386,78147,70239,4.4,181.50,818
"2022.05","연제구",12,94182,207425,99622,107803,6.1,12.10,17143
"2022.05","수영구",10,86829,176398,83060,93338,5.2,10.22,17260
"2022.05","사상구",12,98702,210605,106220,104385,6.2,36.10,5834
"2022.05","기장군",5,77472,178883,88867,90016,5.3,218.32,819
"2022.06","중구",9,24304,42692,21173,21519,1.3,2.83,15086
"2022.06","서구",13,53109,106397,51630,54767,3.1,13.95,7627
"2022.06","동구",12,47052,90186,44022,46164,2.7,9.87,9137
"2022.06","영도구",11,54700,111307,55055,56252,3.3,14.20,7839
"2022.06","부산진구",20,174624,353674,169982,183692,10.5,29.67,11920
"2022.06","동래구",13,119772,275668,133524,142144,8.1,16.63,16577
"2022.06","남구",17,118480,265158,129581,135577,7.8,26.82,9887
"2022.06","북구",13,123579,282625,139282,143343,8.4,39.37,7179
"2022.06","해운대구",18,171960,396120,190250,205870,11.7,51.54,7686
"2022.06","사하구",16,141003,309199,154125,155074,9.1,41.77,7402
"2022.06","금정구",16,107827,228255,111153,117102,6.7,65.28,3497
"2022.06","강서구",8,62674,148522,78244,70278,4.4,181.50,818
"2022.06","연제구",12,94167,207060,99451,107609,6.1,12.10,17112
"2022.06","수영구",10,86992,176490,83094,93396,5.2,10.22,17269
"2022.06","사상구",12,98741,210294,106072,104222,6.2,36.10,5825
"2022.06","기장군",5,77954,179607,89238,90369,5.3,218.32,823
"2022.07","중구",9,24275,42594,21124,21470,1.3,2.83,15051
"2022.07","서구",13,53342,106818,51834,54984,3.2,13.95,7657
"2022.07","동구",12,46982,89944,43898,46046,2.7,9.87,9113
"2022.07","영도구",11,54725,111271,55039,56232,3.3,14.20,7836
"2022.07","부산진구",20,175150,354120,170222,183898,10.5,29.67,11935
"2022.07","동래구",13,120011,275956,133663,142293,8.2,16.63,16594
"2022.07","남구",17,118358,264557,129277,135280,7.8,26.82,9864
"2022.07","북구",13,123626,282381,139124,143257,8.4,39.37,7172
"2022.07","해운대구",18,172005,395601,189985,205616,11.7,51.54,7676
"2022.07","사하구",16,141082,308777,153906,154871,9.1,41.77,7392
"2022.07","금정구",16,107729,227728,110901,116827,6.7,65.28,3488
"2022.07","강서구",8,62758,148586,78263,70323,4.4,181.50,819
"2022.07","연제구",12,94147,206812,99295,107517,6.1,12.10,17092
"2022.07","수영구",10,87128,176476,83055,93421,5.2,10.22,17268
"2022.07","사상구",12,98690,209771,105780,103991,6.2,36.10,5811
"2022.07","기장군",5,78044,179751,89281,90470,5.3,218.32,823
"2022.08","중구",9,24265,42455,21055,21400,1.3,2.83,15002
"2022.08","서구",13,53667,107522,52184,55338,3.2,13.95,7708
"2022.08","동구",12,47011,89800,43830,45970,2.7,9.87,9098
"2022.08","영도구",11,54711,111100,54973,56127,3.3,14.20,7824
"2022.08","부산진구",20,175696,354367,170267,184100,10.5,29.67,11944
"2022.08","동래구",13,119984,275830,133543,142287,8.2,16.63,16586
"2022.08","남구",17,118468,264112,129045,135067,7.8,26.82,9848
"2022.08","북구",13,123788,282230,139034,143196,8.4,39.37,7169
"2022.08","해운대구",18,171837,394626,189458,205168,11.7,51.54,7657
"2022.08","사하구",16,141176,308286,153638,154648,9.1,41.77,7381
"2022.08","금정구",16,107887,227436,110798,116638,6.7,65.28,3484
"2022.08","강서구",8,62728,148447,78219,70228,4.4,181.50,818
"2022.08","연제구",12,94136,206433,99077,107356,6.1,12.10,17061
"2022.08","수영구",10,87245,176370,82976,93394,5.2,10.22,17257
"2022.08","사상구",12,98694,209199,105492,103707,6.2,36.10,5795
"2022.08","기장군",5,78169,179819,89311,90508,5.3,218.32,824
"2022.09","중구",9,24107,42267,20951,21316,1.3,2.83,14935
"2022.09","서구",13,53621,107514,52202,55312,3.2,13.95,7707
"2022.09","동구",12,46553,89213,43618,45595,2.6,9.87,9039
"2022.09","영도구",11,54474,110813,54787,56026,3.3,14.20,7804
"2022.09","부산진구",20,175448,353819,169947,183872,10.5,29.67,11925
"2022.09","동래구",13,119696,275354,133287,142067,8.2,16.63,16558
"2022.09","남구",17,118179,263401,128694,134707,7.8,26.82,9821
"2022.09","북구",13,123761,282072,138909,143163,8.4,39.37,7165
"2022.09","해운대구",18,170998,393151,188716,204435,11.7,51.54,7628
"2022.09","사하구",16,140869,307465,153183,154282,9.1,41.77,7361
"2022.09","금정구",16,107535,227471,110637,116834,6.7,65.28,3485
"2022.09","강서구",8,62645,148292,78217,70075,4.4,181.50,817
"2022.09","연제구",12,93840,205804,98703,107101,6.1,12.10,17009
"2022.09","수영구",10,87065,176074,82810,93264,5.2,10.22,17228
"2022.09","사상구",12,98256,208630,105155,103475,6.2,36.10,5779
"2022.09","기장군",5,78402,180339,89556,90783,5.3,218.32,826
"2022.10","중구",9,24056,42136,20846,21290,1.3,2.83,14889
"2022.10","서구",13,53657,107490,52192,55298,3.2,13.95,7705
"2022.10","동구",12,46535,89030,43518,45512,2.6,9.87,9020
"2022.10","영도구",11,54440,110574,54641,55933,3.3,14.20,7787
"2022.10","부산진구",20,176765,356251,171164,185087,10.6,29.67,12007
"2022.10","동래구",13,119629,274992,133065,141927,8.2,16.63,16536
"2022.10","남구",17,117964,262904,128458,134446,7.8,26.82,9803
"2022.10","북구",13,123831,281871,138758,143113,8.4,39.37,7160
"2022.10","해운대구",18,170828,392763,188511,204252,11.7,51.54,7621
"2022.10","사하구",16,140904,307196,153035,154161,9.1,41.77,7354
"2022.10","금정구",16,107403,226775,110341,116434,6.7,65.28,3474
"2022.10","강서구",8,62601,148213,78210,70003,4.4,181.50,817
"2022.10","연제구",12,93706,205309,98432,106877,6.1,12.10,16968
"2022.10","수영구",10,87311,176481,82974,93507,5.2,10.22,17268
"2022.10","사상구",12,98135,208037,104846,103191,6.2,36.10,5763
"2022.10","기장군",5,78528,180428,89604,90824,5.4,218.32,826
"2022.11","중구",9,24012,42001,20778,21223,1.2,2.83,14841
"2022.11","서구",13,53648,107476,52170,55306,3.2,13.95,7704
"2022.11","동구",12,46402,88773,43399,45374,2.6,9.87,8994
"2022.11","영도구",11,54362,110386,54570,55816,3.3,14.20,7774
"2022.11","부산진구",20,177576,358021,171996,186025,10.6,29.67,12067
"2022.11","동래구",13,119508,274660,132883,141777,8.2,16.63,16516
"2022.11","남구",17,117707,262584,128355,134229,7.8,26.82,9791
"2022.11","북구",13,123693,281408,138496,142912,8.4,39.37,7148
"2022.11","해운대구",18,170637,392291,188227,204064,11.6,51.54,7611
"2022.11","사하구",16,140839,306893,152924,153969,9.1,41.77,7347
"2022.11","금정구",16,107061,226141,110009,116132,6.7,65.28,3464
"2022.11","강서구",8,62497,148165,78259,69906,4.4,181.50,816
"2022.11","연제구",12,93581,204819,98167,106652,6.1,12.10,16927
"2022.11","수영구",10,87360,176704,83024,93680,5.2,10.22,17290
"2022.11","사상구",12,98324,208272,104977,103295,6.2,36.10,5769
"2022.11","기장군",5,78629,180652,89717,90935,5.4,218.32,827
"2022.12","중구",9,23960,41909,20725,21184,1.2,2.83,14809
"2022.12","서구",13,53626,107402,52118,55284,3.2,13.95,7699
"2022.12","동구",12,46349,88601,43284,45317,2.6,9.87,8977
"2022.12","영도구",11,54342,110254,54498,55756,3.3,14.20,7764
"2022.12","부산진구",20,178049,358644,172214,186430,10.7,29.67,12088
"2022.12","동래구",13,119503,274445,132739,141706,8.2,16.63,16503
"2022.12","남구",17,117601,262253,128182,134071,7.8,26.82,9778
"2022.12","북구",13,123569,280940,138213,142727,8.3,39.37,7136
"2022.12","해운대구",18,170435,391763,187958,203805,11.6,51.54,7601
"2022.12","사하구",16,140778,306511,152728,153783,9.1,41.77,7338
"2022.12","금정구",16,106950,225717,109797,115920,6.7,65.28,3458
"2022.12","강서구",8,62426,148257,78413,69844,4.4,181.50,817
"2022.12","연제구",12,93557,204504,97988,106516,6.1,12.10,16901
"2022.12","수영구",10,87361,176615,82951,93664,5.2,10.22,17281
"2022.12","사상구",12,98625,208553,105119,103434,6.2,36.10,5777
"2022.12","기장군",5,78736,180878,89880,90998,5.4,218.32,828
"2023.01","중구",9,23965,41913,20703,21210,1.2,2.83,14810
"2023.01","서구",13,53592,107255,52035,55220,3.2,13.95,7689
"2023.01","동구",12,46322,88513,43250,45263,2.6,9.87,8968
"2023.01","영도구",11,54304,110063,54398,55665,3.3,14.20,7751
"2023.01","부산진구",20,178397,359061,172381,186680,10.7,29.67,12102
"2023.01","동래구",13,119557,274400,132696,141704,8.2,16.63,16500
"2023.01","남구",17,117668,262093,128079,134014,7.8,26.82,9772
"2023.01","북구",13,123569,280662,138026,142636,8.3,39.37,7129
"2023.01","해운대구",18,170261,391279,187735,203544,11.6,51.54,7592
"2023.01","사하구",16,140814,306473,152722,153751,9.1,41.77,7337
"2023.01","금정구",16,106606,224861,109361,115500,6.7,65.28,3445
"2023.01","강서구",8,62358,148217,78438,69779,4.4,181.50,817
"2023.01","연제구",12,93490,204173,97821,106352,6.1,12.10,16874
"2023.01","수영구",10,87487,176725,82964,93761,5.3,10.22,17292
"2023.01","사상구",12,98779,208500,105074,103426,6.2,36.10,5776
"2023.01","기장군",5,78917,181365,90096,91269,5.4,218.32,831
"2023.02","중구",9,24123,41957,20738,21219,1.2,2.83,14826
"2023.02","서구",13,53689,107209,51973,55236,3.2,13.95,7685
"2023.02","동구",12,46224,88151,43021,45130,2.6,9.87,8931
"2023.02","영도구",11,54322,109865,54304,55561,3.3,14.20,7737
"2023.02","부산진구",20,179307,360045,172765,187280,10.7,29.67,12135
"2023.02","동래구",13,119887,274567,132730,141837,8.2,16.63,16510
"2023.02","남구",17,118209,262157,128132,134025,7.8,26.82,9775
"2023.02","북구",13,123568,280121,137747,142374,8.3,39.37,7115
"2023.02","해운대구",18,170331,390489,187324,203165,11.6,51.54,7576
"2023.02","사하구",16,141291,306635,152804,153831,9.1,41.77,7341
"2023.02","금정구",16,106851,224410,109197,115213,6.7,65.28,3438
"2023.02","강서구",8,62350,148060,78393,69667,4.4,181.50,816
"2023.02","연제구",12,93538,204025,97696,106329,6.1,12.10,16862
"2023.02","수영구",10,87774,176992,83067,93925,5.3,10.22,17318
"2023.02","사상구",12,99040,208353,104972,103381,6.2,36.10,5772
"2023.02","기장군",5,79089,181611,90253,91358,5.4,218.32,832
"2023.03","중구",9,24099,41862,20698,21164,1.2,2.83,14792
"2023.03","서구",13,53670,107035,51815,55220,3.2,13.95,7673
"2023.03","동구",12,46196,88013,42926,45087,2.6,9.87,8917
"2023.03","영도구",11,54335,109774,54241,55533,3.3,14.20,7731
"2023.03","부산진구",20,179744,360354,172892,187462,10.7,29.67,12145
"2023.03","동래구",13,119963,274419,132596,141823,8.2,16.63,16501
"2023.03","남구",17,118462,262385,128209,134176,7.8,26.82,9783
"2023.03","북구",13,123573,279814,137586,142228,8.3,39.37,7107
"2023.03","해운대구",18,170251,389843,186999,202844,11.6,51.54,7564
"2023.03","사하구",16,141398,306547,152712,153835,9.1,41.77,7339
"2023.03","금정구",16,106954,224488,109119,115369,6.7,65.28,3439
"2023.03","강서구",8,62376,148176,78446,69730,4.4,181.50,816
"2023.03","연제구",12,93650,204094,97715,106379,6.1,12.10,16867
"2023.03","수영구",10,87985,177230,83140,94090,5.3,10.22,17341
"2023.03","사상구",12,99173,208557,104973,103584,6.2,36.10,5777
"2023.03","기장군",5,79179,181475,90243,91232,5.4,218.32,831
"2023.04","중구",9,24061,41890,20662,21228,1.2,2.83,14802
"2023.04","서구",13,53640,106977,51760,55217,3.2,13.95,7669
"2023.04","동구",12,46162,87818,42819,44999,2.6,9.87,8897
"2023.04","영도구",11,54299,109553,54131,55422,3.3,14.20,7715
"2023.04","부산진구",20,179949,360365,172886,187479,10.7,29.67,12146
"2023.04","동래구",13,119980,274273,132498,141775,8.2,16.63,16493
"2023.04","남구",17,118556,262382,128177,134205,7.8,26.82,9783
"2023.04","북구",13,123532,279440,137379,142061,8.3,39.37,7098
"2023.04","해운대구",18,170185,389361,186762,202599,11.6,51.54,7555
"2023.04","사하구",16,141450,306358,152578,153780,9.1,41.77,7334
"2023.04","금정구",16,106821,224011,108873,115138,6.7,65.28,3432
"2023.04","강서구",8,62443,148315,78561,69754,4.4,181.50,817
"2023.04","연제구",12,93724,204073,97695,106378,6.1,12.10,16866
"2023.04","수영구",10,88084,177271,83151,94120,5.3,10.22,17345
"2023.04","사상구",12,99293,208601,104954,103647,6.2,36.10,5778
"2023.04","기장군",5,79487,181742,90360,91382,5.4,218.32,832
"2023.05","중구",9,24066,41732,20594,21138,1.2,2.83,14746
"2023.05","서구",13,53593,106877,51671,55206,3.2,13.95,7661
"2023.05","동구",12,46152,87744,42757,44987,2.6,9.87,8890
"2023.05","영도구",11,54248,109412,54070,55342,3.3,14.20,7705
"2023.05","부산진구",20,180263,360565,172971,187594,10.7,29.67,12153
"2023.05","동래구",13,120032,274065,132445,141620,8.2,16.63,16480
"2023.05","남구",17,118686,262272,128089,134183,7.8,26.82,9779
"2023.05","북구",13,123510,279074,137171,141903,8.3,39.37,7088
"2023.05","해운대구",18,170221,389117,186620,202497,11.6,51.54,7550
"2023.05","사하구",16,141510,306147,152407,153740,9.1,41.77,7329
"2023.05","금정구",16,106809,223670,108693,114977,6.7,65.28,3426
"2023.05","강서구",8,62466,148504,78739,69765,4.4,181.50,818
"2023.05","연제구",12,93852,204023,97637,106386,6.1,12.10,16861
"2023.05","수영구",10,88211,177368,83143,94225,5.3,10.22,17355
"2023.05","사상구",12,99353,208586,104953,103633,6.2,36.10,5778
"2023.05","기장군",5,79623,181897,90429,91468,5.4,218.32,833
"2023.06","중구",9,24040,41733,20591,21142,1.2,2.83,14747
"2023.06","서구",13,53542,106761,51601,55160,3.2,13.95,7653
"2023.06","동구",12,46797,89082,43427,45655,2.7,9.87,9026
"2023.06","영도구",11,54218,109255,54008,55247,3.3,14.20,7694
"2023.06","부산진구",20,180383,360309,172828,187481,10.7,29.67,12144
"2023.06","동래구",13,120060,273878,132307,141571,8.2,16.63,16469
"2023.06","남구",17,118673,261921,127899,134022,7.8,26.82,9766
"2023.06","북구",13,123558,278784,137057,141727,8.3,39.37,7081
"2023.06","해운대구",18,170143,388452,186312,202140,11.6,51.54,7537
"2023.06","사하구",16,141455,305761,152255,153506,9.1,41.77,7320
"2023.06","금정구",16,106725,223182,108425,114757,6.6,65.28,3419
"2023.06","강서구",8,62494,148597,78813,69784,4.4,181.50,819
"2023.06","연제구",12,93904,203939,97559,106380,6.1,12.10,16854
"2023.06","수영구",10,88315,177435,83207,94228,5.3,10.22,17362
"2023.06","사상구",12,99364,208275,104792,103483,6.2,36.10,5769
"2023.06","기장군",5,79691,181873,90476,91397,5.4,218.32,833
"2023.07","중구",9,23983,41645,20550,21095,1.2,2.83,14716
"2023.07","서구",13,53519,106660,51545,55115,3.2,13.95,7646
"2023.07","동구",12,47279,90044,43882,46162,2.7,9.87,9123
"2023.07","영도구",11,54342,109483,54109,55374,3.3,14.20,7710
"2023.07","부산진구",20,180514,360153,172778,187375,10.7,29.67,12139
"2023.07","동래구",13,120056,273671,132199,141472,8.2,16.63,16456
"2023.07","남구",17,118641,261486,127672,133814,7.8,26.82,9750
"2023.07","북구",13,123504,278417,136868,141549,8.3,39.37,7072
"2023.07","해운대구",18,170207,388123,186156,201967,11.6,51.54,7531
"2023.07","사하구",16,141438,305316,152061,153255,9.1,41.77,7309
"2023.07","금정구",16,106693,222657,108194,114463,6.6,65.28,3411
"2023.07","강서구",8,62482,148678,78900,69778,4.4,181.50,819
"2023.07","연제구",12,94064,204051,97566,106485,6.1,12.10,16864
"2023.07","수영구",10,88385,177358,83183,94175,5.3,10.22,17354
"2023.07","사상구",12,99400,208162,104724,103438,6.2,36.10,5766
"2023.07","기장군",5,79745,181833,90452,91381,5.4,218.32,833
"2023.08","중구",9,23931,41483,20513,20970,1.2,2.83,14658
"2023.08","서구",13,53521,106737,51540,55197,3.2,13.95,7651
"2023.08","동구",12,47445,90418,44075,46343,2.7,9.87,9161
"2023.08","영도구",11,54409,109437,54102,55335,3.3,14.20,7707
"2023.08","부산진구",20,180664,360119,172757,187362,10.7,29.67,12137
"2023.08","동래구",13,120076,273489,132097,141392,8.2,16.63,16446
"2023.08","남구",17,118641,261141,127485,133656,7.8,26.82,9737
"2023.08","북구",13,123417,277800,136572,141228,8.3,39.37,7056
"2023.08","해운대구",18,170087,387499,185774,201725,11.5,51.54,7518
"2023.08","사하구",16,141279,304768,151770,152998,9.1,41.77,7296
"2023.08","금정구",16,106726,222095,108002,114093,6.6,65.28,3402
"2023.08","강서구",8,62506,148693,78970,69723,4.4,181.50,819
"2023.08","연제구",12,94093,203961,97500,106461,6.1,12.10,16856
"2023.08","수영구",10,88469,177416,83244,94172,5.3,10.22,17360
"2023.08","사상구",12,99813,208823,105017,103806,6.2,36.10,5785
"2023.08","기장군",5,79823,181811,90457,91354,5.4,218.32,833
"2023.09","중구",9,23874,41359,20468,20891,1.2,2.83,14614
"2023.09","서구",13,53510,106722,51513,55209,3.2,13.95,7650
"2023.09","동구",12,47503,90458,44076,46382,2.7,9.87,9165
"2023.09","영도구",11,54425,109350,54024,55326,3.3,14.20,7701
"2023.09","부산진구",20,181219,361250,173322,187928,10.8,29.67,12176
"2023.09","동래구",13,119933,273197,131963,141234,8.1,16.63,16428
"2023.09","남구",17,118470,260910,127358,133552,7.8,26.82,9728
"2023.09","북구",13,123253,277099,136201,140898,8.3,39.37,7038
"2023.09","해운대구",18,170022,387193,185613,201580,11.5,51.54,7512
"2023.09","사하구",16,141165,304469,151624,152845,9.1,41.77,7289
"2023.09","금정구",16,106616,222232,107888,114344,6.6,65.28,3404
"2023.09","강서구",8,62513,148762,79014,69748,4.4,181.50,820
"2023.09","연제구",12,94338,203937,97480,106457,6.1,12.10,16854
"2023.09","수영구",10,88357,177145,83123,94022,5.3,10.22,17333
"2023.09","사상구",12,100053,209605,105396,104209,6.2,36.10,5806
"2023.09","기장군",5,79864,181836,90484,91352,5.4,218.32,833
"2023.10","중구",9,23798,41376,20453,20923,1.2,3.01,13746
"2023.10","서구",13,53590,106725,51490,55235,3.2,13.98,7634
"2023.10","동구",12,47466,90387,44049,46338,2.7,10.12,8932
"2023.10","영도구",11,54373,109329,54036,55293,3.3,14.20,7699
"2023.10","부산진구",20,181565,362282,173805,188477,10.8,29.67,12210
"2023.10","동래구",13,119841,273002,131864,141138,8.1,16.63,16416
"2023.10","남구",17,118390,261212,127517,133695,7.8,26.82,9739
"2023.10","북구",13,123164,276638,135987,140651,8.2,39.37,7027
"2023.10","해운대구",18,169820,386622,185305,201317,11.5,51.54,7501
"2023.10","사하구",16,140951,303886,151409,152477,9.1,41.78,7273
"2023.10","금정구",16,106297,221486,107566,113920,6.6,65.28,3393
"2023.10","강서구",8,62465,148705,79008,69697,4.4,182.16,816
"2023.10","연제구",12,94650,204073,97501,106572,6.1,12.11,16852
"2023.10","수영구",10,88321,176992,83025,93967,5.3,10.22,17318
"2023.10","사상구",12,100043,209302,105216,104086,6.2,36.11,5796
"2023.10","기장군",5,79812,181799,90479,91320,5.4,218.33,833
"2023.11","중구",9,23766,41164,20364,20800,1.2,3.01,13676
"2023.11","서구",13,53657,106793,51514,55279,3.2,13.98,7639
"2023.11","동구",12,47471,90325,44001,46324,2.7,10.12,8925
"2023.11","영도구",11,54325,109301,54045,55256,3.3,14.20,7697
"2023.11","부산진구",20,181807,362675,173957,188718,10.8,29.67,12224
"2023.11","동래구",13,119814,272849,131768,141081,8.1,16.63,16407
"2023.11","남구",17,118495,261166,127485,133681,7.8,26.82,9738
"2023.11","북구",13,123077,276258,135815,140443,8.2,39.37,7017
"2023.11","해운대구",18,169633,386185,185131,201054,11.5,51.54,7493
"2023.11","사하구",16,140857,303412,151132,152280,9.1,41.78,7262
"2023.11","금정구",16,106121,221049,107344,113705,6.6,65.28,3386
"2023.11","강서구",8,62354,148736,79077,69659,4.4,182.16,817
"2023.11","연제구",12,94760,204087,97442,106645,6.1,12.11,16853
"2023.11","수영구",10,88285,176715,82896,93819,5.3,10.22,17291
"2023.11","사상구",12,99998,209015,105052,103963,6.2,36.11,5788
"2023.11","기장군",5,79779,181696,90456,91240,5.4,218.33,832
"2023.12","중구",9,23747,41153,20333,20820,1.2,3.01,13672
"2023.12","서구",13,53630,106708,51477,55231,3.2,13.98,7633
"2023.12","동구",12,47428,90190,43889,46301,2.7,10.12,8912
"2023.12","영도구",11,54293,109151,53978,55173,3.3,14.20,7687
"2023.12","부산진구",20,181914,362505,173815,188690,10.8,29.67,12218
"2023.12","동래구",13,119706,272178,131435,140743,8.1,16.63,16367
"2023.12","남구",17,118427,260899,127288,133611,7.8,26.82,9728
"2023.12","북구",13,123082,275773,135532,140241,8.2,39.37,7005
"2023.12","해운대구",18,169532,385618,184825,200793,11.5,51.54,7482
"2023.12","사하구",16,140764,302947,150934,152013,9.0,41.78,7251
"2023.12","금정구",16,105906,220286,106926,113360,6.6,65.28,3374
"2023.12","강서구",8,62238,148540,79016,69524,4.4,182.16,815
"2023.12","연제구",12,95873,206853,98788,108065,6.2,12.11,17081
"2023.12","수영구",10,88299,176486,82787,93699,5.3,10.22,17269
"2023.12","사상구",12,100003,208794,105007,103787,6.2,36.11,5782
"2023.12","기장군",5,79746,181475,90369,91106,5.4,218.33,831
"2024.01","중구",9,23729,41103,20324,20779,1.2,3.01,13655
"2024.01","서구",13,53521,106500,51402,55098,3.2,13.98,7618
"2024.01","동구",12,47383,90028,43753,46275,2.7,10.12,8896
"2024.01","영도구",11,54249,108959,53885,55074,3.3,14.20,7673
"2024.01","부산진구",20,182417,363092,174039,189053,10.8,29.67,12238
"2024.01","동래구",13,119440,271164,130888,140276,8.1,16.63,16306
"2024.01","남구",17,118473,261011,127272,133739,7.8,26.82,9732
"2024.01","북구",13,123062,275137,135207,139930,8.2,39.37,6988
"2024.01","해운대구",18,169375,385015,184495,200520,11.5,51.54,7470
"2024.01","사하구",16,140523,302178,150553,151625,9.0,41.78,7233
"2024.01","금정구",16,105465,219268,106414,112854,6.5,65.28,3359
"2024.01","강서구",8,62153,148516,79144,69372,4.4,182.16,815
"2024.01","연제구",12,97257,210412,100471,109941,6.3,12.11,17375
"2024.01","수영구",10,88195,176083,82556,93527,5.3,10.22,17229
"2024.01","사상구",12,99827,208373,104747,103626,6.2,36.11,5771
"2024.01","기장군",5,79694,181172,90255,90917,5.4,218.33,830
"2024.02","중구",9,23829,40983,20296,20687,1.2,3.01,13616
"2024.02","서구",13,53551,106446,51349,55097,3.2,13.98,7614
"2024.02","동구",12,47413,89848,43682,46166,2.7,10.12,8878
"2024.02","영도구",11,54309,108852,53832,55020,3.3,14.20,7666
"2024.02","부산진구",20,183261,363965,174414,189551,10.9,29.67,12267
"2024.02","동래구",13,119497,270713,130585,140128,8.1,16.63,16279
"2024.02","남구",17,119141,261630,127622,134008,7.8,26.82,9755
"2024.02","북구",13,123020,274504,134877,139627,8.2,39.37,6972
"2024.02","해운대구",18,169282,383960,183992,199968,11.5,51.54,7450
"2024.02","사하구",16,140577,301477,150253,151224,9.0,41.78,7216
"2024.02","금정구",16,105513,218544,106131,112413,6.5,65.28,3348
"2024.02","강서구",8,62085,148245,79047,69198,4.4,182.16,814
"2024.02","연제구",12,97985,212085,101288,110797,6.3,12.11,17513
"2024.02","수영구",10,88250,175915,82407,93508,5.3,10.22,17213
"2024.02","사상구",12,99966,207974,104538,103436,6.2,36.11,5759
"2024.02","기장군",5,79730,180776,90113,90663,5.4,218.33,828
"2024.03","중구",9,23824,40970,20296,20674,1.2,3.01,13611
"2024.03","서구",13,53534,106265,51264,55001,3.2,13.98,7601
"2024.03","동구",12,47389,89644,43577,46067,2.7,10.12,8858
"2024.03","영도구",11,54364,108766,53811,54955,3.3,14.20,7660
"2024.03","부산진구",20,183826,364357,174587,189770,10.9,29.67,12280
"2024.03","동래구",13,119481,270392,130392,140000,8.1,16.63,16259
"2024.03","남구",17,119660,262024,127813,134211,7.8,26.82,9770
"2024.03","북구",13,123025,274204,134713,139491,8.2,39.37,6965
"2024.03","해운대구",18,169193,383255,183668,199587,11.5,51.54,7436
"2024.03","사하구",16,140621,301091,150049,151042,9.0,41.78,7207
"2024.03","금정구",16,105729,218408,106001,112407,6.5,65.28,3346
"2024.03","강서구",8,62113,148315,79103,69212,4.4,182.16,814
"2024.03","연제구",12,98268,212532,101465,111067,6.4,12.11,17550
"2024.03","수영구",10,88285,175730,82314,93416,5.3,10.22,17195
"2024.03","사상구",12,100076,208231,104558,103673,6.2,36.11,5767
"2024.03","기장군",5,79696,180521,89995,90526,5.4,218.33,827
"2024.04","중구",9,23819,41069,20304,20765,1.2,3.01,13644
"2024.04","서구",13,53458,106019,51142,54877,3.2,13.98,7584
"2024.04","동구",12,47375,89572,43510,46062,2.7,10.12,8851
"2024.04","영도구",11,54312,108529,53665,54864,3.2,14.20,7643
"2024.04","부산진구",20,183993,364499,174590,189909,10.9,29.67,12285
"2024.04","동래구",13,119528,270252,130232,140020,8.1,16.63,16251
"2024.04","남구",17,119893,262834,128179,134655,7.9,26.82,9800
"2024.04","북구",13,122975,273798,134460,139338,8.2,39.37,6954
"2024.04","해운대구",18,169165,382904,183484,199420,11.5,51.54,7429
"2024.04","사하구",16,140503,300597,149807,150790,9.0,41.78,7195
"2024.04","금정구",16,105621,218355,105890,112465,6.5,65.28,3345
"2024.04","강서구",8,62215,148720,79315,69405,4.4,182.16,816
"2024.04","연제구",12,98521,212962,101634,111328,6.4,12.11,17586
"2024.04","수영구",10,88261,175539,82222,93317,5.2,10.22,17176
"2024.04","사상구",12,100051,207977,104452,103525,6.2,36.11,5760
"2024.04","기장군",5,79603,180277,89883,90394,5.4,218.33,826
"2024.05","중구",9,23772,40814,20199,20615,1.2,3.01,13559
"2024.05","서구",13,53394,105988,51082,54906,3.2,13.98,7581
"2024.05","동구",12,47354,89380,43397,45983,2.7,10.12,8832
"2024.05","영도구",11,54267,108336,53555,54781,3.2,14.20,7629
"2024.05","부산진구",20,184283,364666,174690,189976,10.9,29.67,12291
"2024.05","동래구",13,119577,270255,130208,140047,8.1,16.63,16251
"2024.05","남구",17,119954,262794,128123,134671,7.9,26.82,9798
"2024.05","북구",13,123027,273532,134325,139207,8.2,39.37,6948
"2024.05","해운대구",18,169067,382370,183235,199135,11.4,51.54,7419
"2024.05","사하구",16,140513,300161,149656,150505,9.0,41.78,7184
"2024.05","금정구",16,105706,218105,105717,112388,6.5,65.28,3341
"2024.05","강서구",8,62312,149009,79452,69557,4.5,182.16,818
"2024.05","연제구",12,98715,213162,101696,111466,6.4,12.11,17602
"2024.05","수영구",10,88266,175404,82192,93212,5.2,10.22,17163
"2024.05","사상구",12,100110,207812,104376,103436,6.2,36.11,5755
"2024.05","기장군",5,79637,180260,89913,90347,5.4,218.33,826
"2024.06","중구",9,23751,40782,20216,20566,1.2,3.01,13549
"2024.06","서구",13,53365,105861,51048,54813,3.2,13.98,7572
"2024.06","동구",12,47311,89226,43304,45922,2.7,10.12,8817
"2024.06","영도구",11,54167,108128,53468,54660,3.2,14.20,7615
"2024.06","부산진구",20,184639,365193,174939,190254,10.9,29.67,12308
"2024.06","동래구",13,119755,270504,130320,140184,8.1,16.63,16266
"2024.06","남구",17,120102,262982,128269,134713,7.9,26.82,9805
"2024.06","북구",13,122992,273139,134074,139065,8.2,39.37,6938
"2024.06","해운대구",18,169102,382082,183092,198990,11.4,51.54,7413
"2024.06","사하구",16,140424,299692,149390,150302,9.0,41.78,7173
"2024.06","금정구",16,105566,217550,105467,112083,6.5,65.28,3333
"2024.06","강서구",8,62322,148997,79451,69546,4.5,182.16,818
"2024.06","연제구",12,98837,213212,101674,111538,6.4,12.11,17606
"2024.06","수영구",10,88261,175259,82084,93175,5.2,10.22,17149
"2024.06","사상구",12,100047,207440,104140,103300,6.2,36.11,5745
"2024.06","기장군",5,79571,180099,89808,90291,5.4,218.33,825
"2024.07","중구",9,23735,40773,20191,20582,1.2,3.01,13546
"2024.07","서구",13,53344,105747,50988,54759,3.2,13.98,7564
"2024.07","동구",12,47275,89152,43285,45867,2.7,10.12,8809
"2024.07","영도구",11,54105,107824,53330,54494,3.2,14.20,7593
"2024.07","부산진구",20,184721,365057,174816,190241,10.9,29.67,12304
"2024.07","동래구",13,119824,270453,130334,140119,8.1,16.63,16263
"2024.07","남구",17,120157,262903,128231,134672,7.9,26.82,9802
"2024.07","북구",13,122927,272645,133819,138826,8.2,39.37,6925
"2024.07","해운대구",18,169499,382425,183237,199188,11.5,51.54,7420
"2024.07","사하구",16,140375,299290,149216,150074,9.0,41.78,7163
"2024.07","금정구",16,105390,216866,105179,111687,6.5,65.28,3322
"2024.07","강서구",8,62463,149400,79667,69733,4.5,182.16,820
"2024.07","연제구",12,98999,213334,101698,111636,6.4,12.11,17616
"2024.07","수영구",10,88287,175060,81999,93061,5.2,10.22,17129
"2024.07","사상구",12,99970,207029,103882,103147,6.2,36.11,5733
"2024.07","기장군",5,79474,179865,89677,90188,5.4,218.33,824
"2024.08","중구",9,23705,40633,20149,20484,1.2,3.01,13499
"2024.08","서구",13,53397,105822,51023,54799,3.2,13.98,7570
"2024.08","동구",12,47210,88930,43154,45776,2.7,10.12,8788
"2024.08","영도구",11,54052,107603,53246,54357,3.2,14.20,7578
"2024.08","부산진구",20,184796,364908,174741,190167,10.9,29.67,12299
"2024.08","동래구",13,119850,270402,130279,140123,8.1,16.63,16260
"2024.08","남구",17,120126,262440,127989,134451,7.9,26.82,9785
"2024.08","북구",13,122867,272155,133562,138593,8.2,39.37,6913
"2024.08","해운대구",18,169707,382543,183303,199240,11.5,51.54,7422
"2024.08","사하구",16,140252,298679,148889,149790,9.0,41.78,7149
"2024.08","금정구",16,105401,216285,104969,111316,6.5,65.28,3313
"2024.08","강서구",8,62605,149855,79891,69964,4.5,182.16,823
"2024.08","연제구",12,99136,213352,101699,111653,6.4,12.11,17618
"2024.08","수영구",10,88287,174952,81915,93037,5.2,10.22,17119
"2024.08","사상구",12,99870,206579,103683,102896,6.2,36.11,5721
"2024.08","기장군",5,79499,179658,89573,90085,5.4,218.33,823
"2024.09","중구",9,23694,40543,20105,20438,1.2,3.01,13469
"2024.09","서구",13,53580,106120,51169,54951,3.2,13.98,7591
"2024.09","동구",12,47120,88758,43095,45663,2.7,10.12,8771
"2024.09","영도구",11,53973,107397,53162,54235,3.2,14.20,7563
"2024.09","부산진구",20,184863,364873,174756,190117,10.9,29.67,12298
"2024.09","동래구",13,119959,270513,130296,140217,8.1,16.63,16267
"2024.09","남구",17,120134,262584,128077,134507,7.9,26.82,9791
"2024.09","북구",13,122794,271835,133370,138465,8.2,39.37,6905
"2024.09","해운대구",18,169827,382498,183319,199179,11.5,51.54,7421
"2024.09","사하구",16,140206,298316,148642,149674,8.9,41.78,7140
"2024.09","금정구",16,105363,216543,104930,111613,6.5,65.28,3317
"2024.09","강서구",8,62617,149951,79960,69991,4.5,182.16,823
"2024.09","연제구",12,99274,213546,101808,111738,6.4,12.11,17634
"2024.09","수영구",10,88281,174824,81791,93033,5.2,10.22,17106
"2024.09","사상구",12,99812,206531,103645,102886,6.2,36.11,5719
"2024.09","기장군",5,79456,179399,89442,89957,5.4,218.33,822
"2024.10","중구",9,23621,40481,20033,20448,1.2,3.01,13449
"2024.10","서구",13,53673,106268,51210,55058,3.2,13.98,7601
"2024.10","동구",12,47064,88631,43022,45609,2.7,10.12,8758
"2024.10","영도구",11,53837,107057,52990,54067,3.2,14.20,7539
"2024.10","부산진구",20,184557,364256,174454,189802,10.9,29.67,12277
"2024.10","동래구",13,120971,273084,131528,141556,8.2,16.63,16421
"2024.10","남구",17,120050,262893,128233,134660,7.9,26.82,9802
"2024.10","북구",13,122603,271054,132994,138060,8.1,39.37,6885
"2024.10","해운대구",18,169697,382102,183148,198954,11.5,51.54,7414
"2024.10","사하구",16,140404,298318,148634,149684,8.9,41.78,7140
"2024.10","금정구",16,105059,215919,104598,111321,6.5,65.28,3308
"2024.10","강서구",8,62569,149954,79968,69986,4.5,182.16,823
"2024.10","연제구",12,99326,213536,101795,111741,6.4,12.11,17633
"2024.10","수영구",10,88139,174503,81603,92900,5.2,10.22,17075
"2024.10","사상구",12,99707,206401,103632,102769,6.2,36.11,5716
"2024.10","기장군",5,79381,179201,89344,89857,5.4,218.33,821
"2024.11","중구",9,23564,40348,19988,20360,1.2,3.01,13405
"2024.11","서구",13,53622,106206,51164,55042,3.2,13.98,7597
"2024.11","동구",12,47057,88579,42991,45588,2.7,10.12,8753
"2024.11","영도구",11,53721,106744,52839,53905,3.2,14.20,7517
"2024.11","부산진구",20,184341,363394,173928,189466,10.9,29.67,12248
"2024.11","동래구",13,121775,275121,132514,142607,8.3,16.63,16544
"2024.11","남구",17,119904,262605,128085,134520,7.9,26.82,9791
"2024.11","북구",13,122417,270431,132658,137773,8.1,39.37,6869
"2024.11","해운대구",18,169675,381964,183019,198945,11.5,51.54,7411
"2024.11","사하구",16,140610,298418,148681,149737,9.0,41.78,7143
"2024.11","금정구",16,104956,215413,104355,111058,6.5,65.28,3300
"2024.11","강서구",8,62457,149906,79980,69926,4.5,182.16,823
"2024.11","연제구",12,99440,213622,101897,111725,6.4,12.11,17640
"2024.11","수영구",10,88095,174208,81452,92756,5.2,10.22,17046
"2024.11","사상구",12,99661,206106,103492,102614,6.2,36.11,5708
"2024.11","기장군",5,79261,178901,89183,89718,5.4,218.33,819
"2024.12","중구",9,23529,40346,19981,20365,1.2,3.01,13391
"2024.12","서구",13,53648,106194,51106,55088,3.2,13.97,7600
"2024.12","동구",12,47048,88412,42887,45525,2.7,10.12,8735
"2024.12","영도구",11,53659,106515,52704,53811,3.2,14.20,7501
"2024.12","부산진구",20,184179,362839,173651,189188,10.9,29.67,12231
"2024.12","동래구",13,122121,275848,132855,142993,8.3,16.63,16587
"2024.12","남구",17,119763,262318,127913,134405,7.9,26.82,9779
"2024.12","북구",13,122360,270127,132522,137605,8.1,39.37,6861
"2024.12","해운대구",18,169821,381936,182995,198941,11.5,51.52,7413
"2024.12","사하구",16,140631,298201,148601,149600,9.0,41.78,7137
"2024.12","금정구",16,104817,214922,104108,110814,6.5,65.28,3292
"2024.12","강서구",8,62433,149982,80013,69969,4.5,182.16,823
"2024.12","연제구",12,99568,213732,101972,111760,6.4,12.11,17655
"2024.12","수영구",10,88068,174124,81393,92731,5.2,10.22,17042
"2024.12","사상구",12,99563,205618,103254,102364,6.2,36.10,5695
"2024.12","기장군",5,79195,178774,89162,89612,5.4,218.34,819
