"구·군별","내외국인별","시점","세대수[세대]","인구[명]","남자인구[명]","여자인구[명]",
"중구","총인구","2020.01 월","23189","44107","21902","22205",
"중구","총인구","2020.02 월","23272","44115","21899","22216",
"중구","총인구","2020.03 월","23305","44031","21839","22192",
"중구","총인구","2020.04 월","23313","43931","21791","22140",
"중구","총인구","2020.05 월","23406","43835","21755","22080",
"중구","총인구","2020.06 월","23456","43722","21702","22020",
"중구","총인구","2020.07 월","23544","43721","21688","22033",
"중구","총인구","2020.08 월","23626","43691","21663","22028",
"중구","총인구","2020.09 월","23682","43644","21660","21984",
"중구","총인구","2020.10 월","23723","43645","21649","21996",
"중구","총인구","2020.11 월","23773","43571","21609","21962",
"중구","총인구","2020.12 월","23847","43617","21621","21996",
"중구","총인구","2021.01 월","23923","43657","21599","22058",
"중구","총인구","2021.02 월","24010","43629","21598","22031",
"중구","총인구","2021.03 월","23951","43438","21511","21927",
"중구","총인구","2021.04 월","24006","43362","21452","21910",
"중구","총인구","2021.05 월","24022","43216","21366","21850",
"중구","총인구","2021.06 월","23583","42619","21140","21479",
"중구","총인구","2021.07 월","23714","42734","21213","21521",
"중구","총인구","2021.08 월","23820","42768","21216","21552",
"중구","총인구","2021.09 월","23878","42760","21217","21543",
"중구","총인구","2021.10 월","23909","42734","21189","21545",
"중구","총인구","2021.11 월","23898","42602","21119","21483",
"중구","총인구","2021.12 월","23925","42609","21120","21489",
"중구","총인구","2022.01 월","23979","42636","21149","21487",
"중구","총인구","2022.02 월","24129","42680","21156","21524",
"중구","총인구","2022.03 월","24218","42725","21157","21568",
"중구","총인구","2022.04 월","24269","42773","21193","21580",
"중구","총인구","2022.05 월","24303","42680","21186","21494",
"중구","총인구","2022.06 월","24304","42692","21173","21519",
"중구","총인구","2022.07 월","24275","42594","21124","21470",
"중구","총인구","2022.08 월","24265","42455","21055","21400",
"중구","총인구","2022.09 월","24107","42267","20951","21316",
"중구","총인구","2022.10 월","24056","42136","20846","21290",
"중구","총인구","2022.11 월","24012","42001","20778","21223",
"중구","총인구","2022.12 월","23960","41909","20725","21184",
"중구","총인구","2023.01 월","23965","41913","20703","21210",
"중구","총인구","2023.02 월","24123","41957","20738","21219",
"중구","총인구","2023.03 월","24099","41862","20698","21164",
"중구","총인구","2023.04 월","24061","41890","20662","21228",
"중구","총인구","2023.05 월","24066","41732","20594","21138",
"중구","총인구","2023.06 월","24040","41733","20591","21142",
"중구","총인구","2023.07 월","23983","41645","20550","21095",
"중구","총인구","2023.08 월","23931","41483","20513","20970",
"중구","총인구","2023.09 월","23874","41359","20468","20891",
"중구","총인구","2023.10 월","23798","41376","20453","20923",
"중구","총인구","2023.11 월","23766","41164","20364","20800",
"중구","총인구","2023.12 월","23747","41153","20333","20820",
"중구","총인구","2024.01 월","23729","41103","20324","20779",
"중구","총인구","2024.02 월","23829","40983","20296","20687",
"중구","총인구","2024.03 월","23824","40970","20296","20674",
"중구","총인구","2024.04 월","23819","41069","20304","20765",
"중구","총인구","2024.05 월","23772","40814","20199","20615",
"중구","총인구","2024.06 월","23751","40782","20216","20566",
"중구","총인구","2024.07 월","23735","40773","20191","20582",
"중구","총인구","2024.08 월","23705","40633","20149","20484",
"중구","총인구","2024.09 월","23694","40543","20105","20438",
"중구","총인구","2024.10 월","23621","40481","20033","20448",
"중구","총인구","2024.11 월","23564","40348","19988","20360",
"중구","총인구","2024.12 월","23529","40346","19981","20365",
"중앙동","총인구","2020.01 월","1346","2534","1473","1061",
"중앙동","총인구","2020.02 월","1409","2600","1502","1098",
"중앙동","총인구","2020.03 월","1467","2653","1523","1130",
"중앙동","총인구","2020.04 월","1476","2635","1500","1135",
"중앙동","총인구","2020.05 월","1534","2674","1503","1171",
"중앙동","총인구","2020.06 월","1581","2728","1527","1201",
"중앙동","총인구","2020.07 월","1634","2799","1559","1240",
"중앙동","총인구","2020.08 월","1674","2855","1582","1273",
"중앙동","총인구","2020.09 월","1692","2878","1601","1277",
"중앙동","총인구","2020.10 월","1708","2901","1614","1287",
"중앙동","총인구","2020.11 월","1732","2889","1596","1293",
"중앙동","총인구","2020.12 월","1766","2934","1614","1320",
"중앙동","총인구","2021.01 월","1813","2963","1620","1343",
"중앙동","총인구","2021.02 월","1856","3023","1661","1362",
"중앙동","총인구","2021.03 월","1814","2972","1620","1352",
"중앙동","총인구","2021.04 월","1834","3000","1621","1379",
"중앙동","총인구","2021.05 월","1826","2980","1597","1383",
"중앙동","총인구","2021.06 월","1888","3040","1641","1399",
"중앙동","총인구","2021.07 월","1974","3127","1682","1445",
"중앙동","총인구","2021.08 월","2081","3241","1739","1502",
"중앙동","총인구","2021.09 월","2114","3268","1743","1525",
"중앙동","총인구","2021.10 월","2157","3311","1766","1545",
"중앙동","총인구","2021.11 월","2164","3303","1757","1546",
"중앙동","총인구","2021.12 월","2226","3380","1790","1590",
"중앙동","총인구","2022.01 월","2279","3447","1827","1620",
"중앙동","총인구","2022.02 월","2366","3554","1870","1684",
"중앙동","총인구","2022.03 월","2422","3628","1902","1726",
"중앙동","총인구","2022.04 월","2437","3680","1952","1728",
"중앙동","총인구","2022.05 월","2460","3715","1986","1729",
"중앙동","총인구","2022.06 월","2468","3718","1984","1734",
"중앙동","총인구","2022.07 월","2445","3683","1959","1724",
"중앙동","총인구","2022.08 월","2435","3677","1954","1723",
"중앙동","총인구","2022.09 월","2437","3669","1933","1736",
"중앙동","총인구","2022.10 월","2431","3658","1919","1739",
"중앙동","총인구","2022.11 월","2430","3649","1904","1745",
"중앙동","총인구","2022.12 월","2437","3655","1911","1744",
"중앙동","총인구","2023.01 월","2419","3653","1920","1733",
"중앙동","총인구","2023.02 월","2435","3668","1925","1743",
"중앙동","총인구","2023.03 월","2434","3689","1960","1729",
"중앙동","총인구","2023.04 월","2443","3710","1966","1744",
"중앙동","총인구","2023.05 월","2454","3724","1970","1754",
"중앙동","총인구","2023.06 월","2447","3735","1976","1759",
"중앙동","총인구","2023.07 월","2436","3721","1969","1752",
"중앙동","총인구","2023.08 월","2421","3721","1970","1751",
"중앙동","총인구","2023.09 월","2403","3691","1951","1740",
"중앙동","총인구","2023.10 월","2399","3696","1957","1739",
"중앙동","총인구","2023.11 월","2402","3698","1963","1735",
"중앙동","총인구","2023.12 월","2420","3692","1961","1731",
"중앙동","총인구","2024.01 월","2425","3699","1967","1732",
"중앙동","총인구","2024.02 월","2432","3725","1982","1743",
"중앙동","총인구","2024.03 월","2449","3750","2002","1748",
"중앙동","총인구","2024.04 월","2467","3774","2016","1758",
"중앙동","총인구","2024.05 월","2456","3772","2018","1754",
"중앙동","총인구","2024.06 월","2452","3764","2017","1747",
"중앙동","총인구","2024.07 월","2461","3785","2023","1762",
"중앙동","총인구","2024.08 월","2468","3810","2053","1757",
"중앙동","총인구","2024.09 월","2472","3813","2064","1749",
"중앙동","총인구","2024.10 월","2456","3794","2057","1737",
"중앙동","총인구","2024.11 월","2451","3781","2056","1725",
"중앙동","총인구","2024.12 월","2439","3758","2030","1728",
"동광동","총인구","2020.01 월","1897","3200","1663","1537",
"동광동","총인구","2020.02 월","1900","3205","1665","1540",
"동광동","총인구","2020.03 월","1912","3208","1672","1536",
"동광동","총인구","2020.04 월","1909","3196","1664","1532",
"동광동","총인구","2020.05 월","1922","3203","1667","1536",
"동광동","총인구","2020.06 월","1912","3181","1651","1530",
"동광동","총인구","2020.07 월","1910","3179","1651","1528",
"동광동","총인구","2020.08 월","1903","3171","1652","1519",
"동광동","총인구","2020.09 월","1906","3173","1661","1512",
"동광동","총인구","2020.10 월","1896","3161","1658","1503",
"동광동","총인구","2020.11 월","1886","3167","1667","1500",
"동광동","총인구","2020.12 월","1884","3190","1689","1501",
"동광동","총인구","2021.01 월","1875","3182","1694","1488",
"동광동","총인구","2021.02 월","1858","3149","1675","1474",
"동광동","총인구","2021.03 월","1839","3118","1664","1454",
"동광동","총인구","2021.04 월","1850","3109","1656","1453",
"동광동","총인구","2021.05 월","1852","3111","1653","1458",
"동광동","총인구","2021.06 월","1773","3025","1617","1408",
"동광동","총인구","2021.07 월","1762","3022","1618","1404",
"동광동","총인구","2021.08 월","1760","3019","1615","1404",
"동광동","총인구","2021.09 월","1750","3005","1610","1395",
"동광동","총인구","2021.10 월","1739","2993","1607","1386",
"동광동","총인구","2021.11 월","1729","2994","1605","1389",
"동광동","총인구","2021.12 월","1729","2998","1613","1385",
"동광동","총인구","2022.01 월","1726","2982","1607","1375",
"동광동","총인구","2022.02 월","1716","2957","1598","1359",
"동광동","총인구","2022.03 월","1708","2927","1582","1345",
"동광동","총인구","2022.04 월","1711","2935","1590","1345",
"동광동","총인구","2022.05 월","1706","2914","1577","1337",
"동광동","총인구","2022.06 월","1696","2898","1566","1332",
"동광동","총인구","2022.07 월","1699","2894","1562","1332",
"동광동","총인구","2022.08 월","1703","2889","1549","1340",
"동광동","총인구","2022.09 월","1683","2875","1540","1335",
"동광동","총인구","2022.10 월","1670","2855","1526","1329",
"동광동","총인구","2022.11 월","1661","2845","1513","1332",
"동광동","총인구","2022.12 월","1660","2853","1524","1329",
"동광동","총인구","2023.01 월","1653","2838","1518","1320",
"동광동","총인구","2023.02 월","1656","2848","1522","1326",
"동광동","총인구","2023.03 월","1662","2870","1528","1342",
"동광동","총인구","2023.04 월","1646","2853","1519","1334",
"동광동","총인구","2023.05 월","1645","2848","1512","1336",
"동광동","총인구","2023.06 월","1646","2854","1520","1334",
"동광동","총인구","2023.07 월","1638","2842","1515","1327",
"동광동","총인구","2023.08 월","1621","2822","1497","1325",
"동광동","총인구","2023.09 월","1625","2821","1493","1328",
"동광동","총인구","2023.10 월","1607","2789","1479","1310",
"동광동","총인구","2023.11 월","1613","2795","1477","1318",
"동광동","총인구","2023.12 월","1608","2779","1469","1310",
"동광동","총인구","2024.01 월","1614","2778","1475","1303",
"동광동","총인구","2024.02 월","1616","2784","1475","1309",
"동광동","총인구","2024.03 월","1607","2770","1465","1305",
"동광동","총인구","2024.04 월","1603","2750","1448","1302",
"동광동","총인구","2024.05 월","1601","2761","1447","1314",
"동광동","총인구","2024.06 월","1591","2767","1454","1313",
"동광동","총인구","2024.07 월","1589","2761","1454","1307",
"동광동","총인구","2024.08 월","1579","2739","1443","1296",
"동광동","총인구","2024.09 월","1570","2728","1435","1293",
"동광동","총인구","2024.10 월","1568","2702","1422","1280",
"동광동","총인구","2024.11 월","1561","2705","1423","1282",
"동광동","총인구","2024.12 월","1555","2679","1415","1264",
"대청동","총인구","2020.01 월","3492","6750","3187","3563",
"대청동","총인구","2020.02 월","3501","6745","3186","3559",
"대청동","총인구","2020.03 월","3483","6693","3160","3533",
"대청동","총인구","2020.04 월","3499","6690","3160","3530",
"대청동","총인구","2020.05 월","3504","6672","3151","3521",
"대청동","총인구","2020.06 월","3501","6630","3145","3485",
"대청동","총인구","2020.07 월","3523","6640","3142","3498",
"대청동","총인구","2020.08 월","3543","6642","3139","3503",
"대청동","총인구","2020.09 월","3561","6656","3147","3509",
"대청동","총인구","2020.10 월","3571","6653","3141","3512",
"대청동","총인구","2020.11 월","3564","6621","3116","3505",
"대청동","총인구","2020.12 월","3553","6601","3101","3500",
"대청동","총인구","2021.01 월","3553","6589","3085","3504",
"대청동","총인구","2021.02 월","3567","6586","3083","3503",
"대청동","총인구","2021.03 월","3561","6542","3056","3486",
"대청동","총인구","2021.04 월","3579","6540","3055","3485",
"대청동","총인구","2021.05 월","3579","6538","3058","3480",
"대청동","총인구","2021.06 월","3521","6457","3027","3430",
"대청동","총인구","2021.07 월","3517","6434","3015","3419",
"대청동","총인구","2021.08 월","3518","6416","3008","3408",
"대청동","총인구","2021.09 월","3528","6404","3002","3402",
"대청동","총인구","2021.10 월","3523","6390","2985","3405",
"대청동","총인구","2021.11 월","3508","6359","2971","3388",
"대청동","총인구","2021.12 월","3502","6351","2964","3387",
"대청동","총인구","2022.01 월","3511","6352","2961","3391",
"대청동","총인구","2022.02 월","3507","6326","2942","3384",
"대청동","총인구","2022.03 월","3515","6312","2946","3366",
"대청동","총인구","2022.04 월","3517","6283","2924","3359",
"대청동","총인구","2022.05 월","3522","6281","2928","3353",
"대청동","총인구","2022.06 월","3545","6279","2929","3350",
"대청동","총인구","2022.07 월","3557","6287","2916","3371",
"대청동","총인구","2022.08 월","3562","6279","2913","3366",
"대청동","총인구","2022.09 월","3539","6246","2901","3345",
"대청동","총인구","2022.10 월","3536","6223","2885","3338",
"대청동","총인구","2022.11 월","3520","6206","2880","3326",
"대청동","총인구","2022.12 월","3515","6183","2873","3310",
"대청동","총인구","2023.01 월","3523","6172","2877","3295",
"대청동","총인구","2023.02 월","3526","6159","2876","3283",
"대청동","총인구","2023.03 월","3509","6112","2851","3261",
"대청동","총인구","2023.04 월","3506","6079","2844","3235",
"대청동","총인구","2023.05 월","3502","6065","2836","3229",
"대청동","총인구","2023.06 월","3502","6063","2840","3223",
"대청동","총인구","2023.07 월","3488","6025","2827","3198",
"대청동","총인구","2023.08 월","3474","5991","2823","3168",
"대청동","총인구","2023.09 월","3463","5966","2817","3149",
"대청동","총인구","2023.10 월","3445","5938","2798","3140",
"대청동","총인구","2023.11 월","3437","5919","2793","3126",
"대청동","총인구","2023.12 월","3416","5887","2776","3111",
"대청동","총인구","2024.01 월","3416","5852","2766","3086",
"대청동","총인구","2024.02 월","3428","5841","2767","3074",
"대청동","총인구","2024.03 월","3438","5860","2773","3087",
"대청동","총인구","2024.04 월","3438","5839","2765","3074",
"대청동","총인구","2024.05 월","3429","5818","2766","3052",
"대청동","총인구","2024.06 월","3433","5816","2764","3052",
"대청동","총인구","2024.07 월","3428","5798","2750","3048",
"대청동","총인구","2024.08 월","3433","5790","2753","3037",
"대청동","총인구","2024.09 월","3433","5781","2743","3038",
"대청동","총인구","2024.10 월","3423","5759","2738","3021",
"대청동","총인구","2024.11 월","3413","5747","2729","3018",
"대청동","총인구","2024.12 월","3414","5751","2733","3018",
"보수동","총인구","2020.01 월","5768","10975","5343","5632",
"보수동","총인구","2020.02 월","5774","10959","5318","5641",
"보수동","총인구","2020.03 월","5779","10951","5312","5639",
"보수동","총인구","2020.04 월","5784","10945","5326","5619",
"보수동","총인구","2020.05 월","5781","10944","5327","5617",
"보수동","총인구","2020.06 월","5775","10893","5293","5600",
"보수동","총인구","2020.07 월","5788","10876","5280","5596",
"보수동","총인구","2020.08 월","5810","10892","5282","5610",
"보수동","총인구","2020.09 월","5830","10887","5273","5614",
"보수동","총인구","2020.10 월","5844","10878","5264","5614",
"보수동","총인구","2020.11 월","5877","10924","5286","5638",
"보수동","총인구","2020.12 월","5896","10934","5281","5653",
"보수동","총인구","2021.01 월","5922","10955","5286","5669",
"보수동","총인구","2021.02 월","5944","10978","5291","5687",
"보수동","총인구","2021.03 월","5983","11019","5319","5700",
"보수동","총인구","2021.04 월","5972","10964","5289","5675",
"보수동","총인구","2021.05 월","5970","10942","5268","5674",
"보수동","총인구","2021.06 월","5908","10868","5242","5626",
"보수동","총인구","2021.07 월","5926","10880","5244","5636",
"보수동","총인구","2021.08 월","5927","10853","5235","5618",
"보수동","총인구","2021.09 월","5941","10844","5224","5620",
"보수동","총인구","2021.10 월","5955","10840","5218","5622",
"보수동","총인구","2021.11 월","5954","10798","5196","5602",
"보수동","총인구","2021.12 월","5953","10760","5169","5591",
"보수동","총인구","2022.01 월","5943","10740","5166","5574",
"보수동","총인구","2022.02 월","5995","10757","5170","5587",
"보수동","총인구","2022.03 월","6017","10761","5165","5596",
"보수동","총인구","2022.04 월","6029","10756","5165","5591",
"보수동","총인구","2022.05 월","6043","10762","5165","5597",
"보수동","총인구","2022.06 월","6041","10747","5150","5597",
"보수동","총인구","2022.07 월","6035","10726","5144","5582",
"보수동","총인구","2022.08 월","6029","10713","5130","5583",
"보수동","총인구","2022.09 월","5988","10690","5121","5569",
"보수동","총인구","2022.10 월","5981","10633","5085","5548",
"보수동","총인구","2022.11 월","5969","10604","5077","5527",
"보수동","총인구","2022.12 월","5971","10606","5068","5538",
"보수동","총인구","2023.01 월","6011","10640","5065","5575",
"보수동","총인구","2023.02 월","6124","10757","5104","5653",
"보수동","총인구","2023.03 월","6139","10746","5090","5656",
"보수동","총인구","2023.04 월","6136","10727","5081","5646",
"보수동","총인구","2023.05 월","6143","10725","5074","5651",
"보수동","총인구","2023.06 월","6140","10707","5066","5641",
"보수동","총인구","2023.07 월","6124","10663","5041","5622",
"보수동","총인구","2023.08 월","6129","10687","5047","5640",
"보수동","총인구","2023.09 월","6124","10678","5048","5630",
"보수동","총인구","2023.10 월","6118","10662","5041","5621",
"보수동","총인구","2023.11 월","6114","10633","5028","5605",
"보수동","총인구","2023.12 월","6136","10668","5045","5623",
"보수동","총인구","2024.01 월","6132","10629","5036","5593",
"보수동","총인구","2024.02 월","6193","10707","5048","5659",
"보수동","총인구","2024.03 월","6180","10693","5043","5650",
"보수동","총인구","2024.04 월","6175","10660","5041","5619",
"보수동","총인구","2024.05 월","6180","10655","5019","5636",
"보수동","총인구","2024.06 월","6185","10636","5015","5621",
"보수동","총인구","2024.07 월","6179","10609","5002","5607",
"보수동","총인구","2024.08 월","6170","10587","4984","5603",
"보수동","총인구","2024.09 월","6178","10582","4971","5611",
"보수동","총인구","2024.10 월","6166","10537","4942","5595",
"보수동","총인구","2024.11 월","6142","10496","4928","5568",
"보수동","총인구","2024.12 월","6130","10478","4921","5557",
"부평동","총인구","2020.01 월","2678","4977","2341","2636",
"부평동","총인구","2020.02 월","2691","4957","2325","2632",
"부평동","총인구","2020.03 월","2701","4948","2344","2604",
"부평동","총인구","2020.04 월","2700","4950","2339","2611",
"부평동","총인구","2020.05 월","2713","4901","2323","2578",
"부평동","총인구","2020.06 월","2725","4904","2321","2583",
"부평동","총인구","2020.07 월","2734","4930","2329","2601",
"부평동","총인구","2020.08 월","2739","4907","2315","2592",
"부평동","총인구","2020.09 월","2737","4867","2295","2572",
"부평동","총인구","2020.10 월","2743","4903","2301","2602",
"부평동","총인구","2020.11 월","2746","4883","2293","2590",
"부평동","총인구","2020.12 월","2767","4889","2312","2577",
"부평동","총인구","2021.01 월","2772","4936","2318","2618",
"부평동","총인구","2021.02 월","2804","4921","2320","2601",
"부평동","총인구","2021.03 월","2800","4914","2313","2601",
"부평동","총인구","2021.04 월","2815","4929","2313","2616",
"부평동","총인구","2021.05 월","2826","4893","2308","2585",
"부평동","총인구","2021.06 월","2718","4710","2217","2493",
"부평동","총인구","2021.07 월","2735","4738","2237","2501",
"부평동","총인구","2021.08 월","2743","4717","2231","2486",
"부평동","총인구","2021.09 월","2748","4725","2242","2483",
"부평동","총인구","2021.10 월","2750","4729","2238","2491",
"부평동","총인구","2021.11 월","2754","4709","2230","2479",
"부평동","총인구","2021.12 월","2745","4711","2238","2473",
"부평동","총인구","2022.01 월","2746","4715","2234","2481",
"부평동","총인구","2022.02 월","2767","4718","2237","2481",
"부평동","총인구","2022.03 월","2771","4759","2243","2516",
"부평동","총인구","2022.04 월","2769","4755","2234","2521",
"부평동","총인구","2022.05 월","2772","4683","2210","2473",
"부평동","총인구","2022.06 월","2763","4726","2233","2493",
"부평동","총인구","2022.07 월","2748","4708","2226","2482",
"부평동","총인구","2022.08 월","2748","4615","2193","2422",
"부평동","총인구","2022.09 월","2735","4583","2172","2411",
"부평동","총인구","2022.10 월","2732","4631","2186","2445",
"부평동","총인구","2022.11 월","2738","4600","2182","2418",
"부평동","총인구","2022.12 월","2723","4592","2166","2426",
"부평동","총인구","2023.01 월","2720","4634","2178","2456",
"부평동","총인구","2023.02 월","2714","4544","2156","2388",
"부평동","총인구","2023.03 월","2716","4526","2146","2380",
"부평동","총인구","2023.04 월","2699","4644","2158","2486",
"부평동","총인구","2023.05 월","2695","4519","2125","2394",
"부평동","총인구","2023.06 월","2684","4539","2121","2418",
"부평동","총인구","2023.07 월","2678","4576","2129","2447",
"부평동","총인구","2023.08 월","2684","4454","2101","2353",
"부평동","총인구","2023.09 월","2676","4433","2095","2338",
"부평동","총인구","2023.10 월","2669","4561","2135","2426",
"부평동","총인구","2023.11 월","2665","4423","2094","2329",
"부평동","총인구","2023.12 월","2659","4504","2115","2389",
"부평동","총인구","2024.01 월","2641","4577","2145","2432",
"부평동","총인구","2024.02 월","2654","4369","2074","2295",
"부평동","총인구","2024.03 월","2637","4357","2070","2287",
"부평동","총인구","2024.04 월","2631","4539","2108","2431",
"부평동","총인구","2024.05 월","2618","4359","2059","2300",
"부평동","총인구","2024.06 월","2613","4352","2061","2291",
"부평동","총인구","2024.07 월","2608","4411","2077","2334",
"부평동","총인구","2024.08 월","2601","4357","2059","2298",
"부평동","총인구","2024.09 월","2591","4304","2037","2267",
"부평동","총인구","2024.10 월","2588","4412","2063","2349",
"부평동","총인구","2024.11 월","2590","4367","2053","2314",
"부평동","총인구","2024.12 월","2590","4439","2075","2364",
"광복동","총인구","2020.01 월","666","1136","575","561",
"광복동","총인구","2020.02 월","659","1129","579","550",
"광복동","총인구","2020.03 월","653","1117","565","552",
"광복동","총인구","2020.04 월","656","1117","568","549",
"광복동","총인구","2020.05 월","655","1115","573","542",
"광복동","총인구","2020.06 월","656","1113","567","546",
"광복동","총인구","2020.07 월","653","1103","565","538",
"광복동","총인구","2020.08 월","653","1098","561","537",
"광복동","총인구","2020.09 월","655","1099","560","539",
"광복동","총인구","2020.10 월","649","1097","564","533",
"광복동","총인구","2020.11 월","650","1094","562","532",
"광복동","총인구","2020.12 월","646","1089","557","532",
"광복동","총인구","2021.01 월","650","1091","556","535",
"광복동","총인구","2021.02 월","646","1096","560","536",
"광복동","총인구","2021.03 월","647","1097","562","535",
"광복동","총인구","2021.04 월","648","1088","562","526",
"광복동","총인구","2021.05 월","649","1086","562","524",
"광복동","총인구","2021.06 월","615","1040","547","493",
"광복동","총인구","2021.07 월","615","1040","550","490",
"광복동","총인구","2021.08 월","607","1031","540","491",
"광복동","총인구","2021.09 월","597","1020","533","487",
"광복동","총인구","2021.10 월","598","1020","533","487",
"광복동","총인구","2021.11 월","597","1023","537","486",
"광복동","총인구","2021.12 월","593","1021","534","487",
"광복동","총인구","2022.01 월","590","1020","532","488",
"광복동","총인구","2022.02 월","590","1023","537","486",
"광복동","총인구","2022.03 월","584","1013","532","481",
"광복동","총인구","2022.04 월","584","1011","533","478",
"광복동","총인구","2022.05 월","578","1004","532","472",
"광복동","총인구","2022.06 월","577","1014","541","473",
"광복동","총인구","2022.07 월","578","1012","542","470",
"광복동","총인구","2022.08 월","579","1021","545","476",
"광복동","총인구","2022.09 월","569","1010","540","470",
"광복동","총인구","2022.10 월","566","999","533","466",
"광복동","총인구","2022.11 월","565","997","534","463",
"광복동","총인구","2022.12 월","563","1000","536","464",
"광복동","총인구","2023.01 월","559","993","532","461",
"광복동","총인구","2023.02 월","559","986","528","458",
"광복동","총인구","2023.03 월","560","985","528","457",
"광복동","총인구","2023.04 월","561","989","530","459",
"광복동","총인구","2023.05 월","559","980","524","456",
"광복동","총인구","2023.06 월","553","974","516","458",
"광복동","총인구","2023.07 월","555","987","526","461",
"광복동","총인구","2023.08 월","556","989","528","461",
"광복동","총인구","2023.09 월","549","991","530","461",
"광복동","총인구","2023.10 월","550","993","530","463",
"광복동","총인구","2023.11 월","551","996","538","458",
"광복동","총인구","2023.12 월","551","1003","541","462",
"광복동","총인구","2024.01 월","547","991","529","462",
"광복동","총인구","2024.02 월","542","982","524","458",
"광복동","총인구","2024.03 월","543","977","520","457",
"광복동","총인구","2024.04 월","543","976","518","458",
"광복동","총인구","2024.05 월","542","966","513","453",
"광복동","총인구","2024.06 월","539","961","510","451",
"광복동","총인구","2024.07 월","540","964","511","453",
"광복동","총인구","2024.08 월","536","953","505","448",
"광복동","총인구","2024.09 월","539","952","504","448",
"광복동","총인구","2024.10 월","531","947","499","448",
"광복동","총인구","2024.11 월","529","937","498","439",
"광복동","총인구","2024.12 월","526","933","496","437",
"남포동","총인구","2020.01 월","700","1308","817","491",
"남포동","총인구","2020.02 월","693","1307","818","489",
"남포동","총인구","2020.03 월","691","1293","805","488",
"남포동","총인구","2020.04 월","693","1287","798","489",
"남포동","총인구","2020.05 월","690","1274","796","478",
"남포동","총인구","2020.06 월","696","1281","801","480",
"남포동","총인구","2020.07 월","697","1285","811","474",
"남포동","총인구","2020.08 월","696","1287","818","469",
"남포동","총인구","2020.09 월","695","1284","813","471",
"남포동","총인구","2020.10 월","706","1289","820","469",
"남포동","총인구","2020.11 월","706","1278","817","461",
"남포동","총인구","2020.12 월","704","1279","812","467",
"남포동","총인구","2021.01 월","699","1274","809","465",
"남포동","총인구","2021.02 월","690","1260","802","458",
"남포동","총인구","2021.03 월","682","1236","788","448",
"남포동","총인구","2021.04 월","682","1224","781","443",
"남포동","총인구","2021.05 월","681","1215","771","444",
"남포동","총인구","2021.06 월","635","1174","752","422",
"남포동","총인구","2021.07 월","635","1184","762","422",
"남포동","총인구","2021.08 월","632","1178","763","415",
"남포동","총인구","2021.09 월","632","1177","764","413",
"남포동","총인구","2021.10 월","629","1166","765","401",
"남포동","총인구","2021.11 월","630","1159","761","398",
"남포동","총인구","2021.12 월","634","1156","761","395",
"남포동","총인구","2022.01 월","626","1155","768","387",
"남포동","총인구","2022.02 월","629","1157","772","385",
"남포동","총인구","2022.03 월","622","1139","754","385",
"남포동","총인구","2022.04 월","623","1136","751","385",
"남포동","총인구","2022.05 월","624","1133","752","381",
"남포동","총인구","2022.06 월","622","1129","747","382",
"남포동","총인구","2022.07 월","624","1149","766","383",
"남포동","총인구","2022.08 월","618","1139","763","376",
"남포동","총인구","2022.09 월","604","1124","759","365",
"남포동","총인구","2022.10 월","601","1122","760","362",
"남포동","총인구","2022.11 월","601","1118","755","363",
"남포동","총인구","2022.12 월","596","1113","753","360",
"남포동","총인구","2023.01 월","596","1111","749","362",
"남포동","총인구","2023.02 월","602","1115","750","365",
"남포동","총인구","2023.03 월","592","1097","739","358",
"남포동","총인구","2023.04 월","582","1080","729","351",
"남포동","총인구","2023.05 월","580","1073","718","355",
"남포동","총인구","2023.06 월","580","1080","723","357",
"남포동","총인구","2023.07 월","575","1077","723","354",
"남포동","총인구","2023.08 월","571","1074","721","353",
"남포동","총인구","2023.09 월","570","1068","717","351",
"남포동","총인구","2023.10 월","566","1064","713","351",
"남포동","총인구","2023.11 월","562","1063","713","350",
"남포동","총인구","2023.12 월","562","1057","710","347",
"남포동","총인구","2024.01 월","563","1050","705","345",
"남포동","총인구","2024.02 월","566","1053","708","345",
"남포동","총인구","2024.03 월","571","1057","709","348",
"남포동","총인구","2024.04 월","573","1049","707","342",
"남포동","총인구","2024.05 월","565","1038","695","343",
"남포동","총인구","2024.06 월","562","1054","713","341",
"남포동","총인구","2024.07 월","561","1048","707","341",
"남포동","총인구","2024.08 월","563","1046","704","342",
"남포동","총인구","2024.09 월","562","1041","701","340",
"남포동","총인구","2024.10 월","564","1038","700","338",
"남포동","총인구","2024.11 월","563","1044","704","340",
"남포동","총인구","2024.12 월","569","1047","705","342",
"영주1동","총인구","2020.01 월","2926","5358","2691","2667",
"영주1동","총인구","2020.02 월","2934","5347","2697","2650",
"영주1동","총인구","2020.03 월","2913","5322","2684","2638",
"영주1동","총인구","2020.04 월","2896","5273","2662","2611",
"영주1동","총인구","2020.05 월","2899","5252","2658","2594",
"영주1동","총인구","2020.06 월","2907","5238","2655","2583",
"영주1동","총인구","2020.07 월","2905","5220","2638","2582",
"영주1동","총인구","2020.08 월","2916","5208","2636","2572",
"영주1동","총인구","2020.09 월","2914","5192","2640","2552",
"영주1동","총인구","2020.10 월","2901","5154","2614","2540",
"영주1동","총인구","2020.11 월","2913","5148","2618","2530",
"영주1동","총인구","2020.12 월","2925","5161","2628","2533",
"영주1동","총인구","2021.01 월","2932","5146","2617","2529",
"영주1동","총인구","2021.02 월","2932","5136","2611","2525",
"영주1동","총인구","2021.03 월","2916","5094","2602","2492",
"영주1동","총인구","2021.04 월","2941","5119","2614","2505",
"영주1동","총인구","2021.05 월","2953","5093","2599","2494",
"영주1동","총인구","2021.06 월","2912","5036","2586","2450",
"영주1동","총인구","2021.07 월","2930","5038","2588","2450",
"영주1동","총인구","2021.08 월","2939","5056","2582","2474",
"영주1동","총인구","2021.09 월","2952","5069","2596","2473",
"영주1동","총인구","2021.10 월","2945","5051","2585","2466",
"영주1동","총인구","2021.11 월","2953","5053","2583","2470",
"영주1동","총인구","2021.12 월","2941","5047","2586","2461",
"영주1동","총인구","2022.01 월","2946","5046","2590","2456",
"영주1동","총인구","2022.02 월","2954","5041","2578","2463",
"영주1동","총인구","2022.03 월","2976","5053","2591","2462",
"영주1동","총인구","2022.04 월","2998","5087","2603","2484",
"영주1동","총인구","2022.05 월","2988","5066","2596","2470",
"영주1동","총인구","2022.06 월","2981","5062","2586","2476",
"영주1동","총인구","2022.07 월","2993","5047","2581","2466",
"영주1동","총인구","2022.08 월","2996","5043","2574","2469",
"영주1동","총인구","2022.09 월","2983","5019","2560","2459",
"영주1동","총인구","2022.10 월","2974","4996","2548","2448",
"영주1동","총인구","2022.11 월","2963","4978","2542","2436",
"영주1동","총인구","2022.12 월","2936","4947","2520","2427",
"영주1동","총인구","2023.01 월","2932","4928","2505","2423",
"영주1동","총인구","2023.02 월","2948","4930","2515","2415",
"영주1동","총인구","2023.03 월","2932","4908","2509","2399",
"영주1동","총인구","2023.04 월","2935","4907","2502","2405",
"영주1동","총인구","2023.05 월","2933","4904","2506","2398",
"영주1동","총인구","2023.06 월","2939","4914","2513","2401",
"영주1동","총인구","2023.07 월","2944","4910","2513","2397",
"영주1동","총인구","2023.08 월","2942","4921","2525","2396",
"영주1동","총인구","2023.09 월","2941","4907","2529","2378",
"영주1동","총인구","2023.10 월","2917","4880","2513","2367",
"영주1동","총인구","2023.11 월","2897","4846","2488","2358",
"영주1동","총인구","2023.12 월","2874","4794","2462","2332",
"영주1동","총인구","2024.01 월","2873","4782","2461","2321",
"영주1동","총인구","2024.02 월","2888","4817","2494","2323",
"영주1동","총인구","2024.03 월","2895","4815","2500","2315",
"영주1동","총인구","2024.04 월","2900","4814","2496","2318",
"영주1동","총인구","2024.05 월","2898","4804","2488","2316",
"영주1동","총인구","2024.06 월","2905","4811","2493","2318",
"영주1동","총인구","2024.07 월","2909","4793","2485","2308",
"영주1동","총인구","2024.08 월","2895","4774","2473","2301",
"영주1동","총인구","2024.09 월","2893","4783","2481","2302",
"영주1동","총인구","2024.10 월","2872","4756","2454","2302",
"영주1동","총인구","2024.11 월","2871","4748","2451","2297",
"영주1동","총인구","2024.12 월","2861","4730","2450","2280",
"영주2동","총인구","2020.01 월","3716","7869","3812","4057",
"영주2동","총인구","2020.02 월","3711","7866","3809","4057",
"영주2동","총인구","2020.03 월","3706","7846","3774","4072",
"영주2동","총인구","2020.04 월","3700","7838","3774","4064",
"영주2동","총인구","2020.05 월","3708","7800","3757","4043",
"영주2동","총인구","2020.06 월","3703","7754","3742","4012",
"영주2동","총인구","2020.07 월","3700","7689","3713","3976",
"영주2동","총인구","2020.08 월","3692","7631","3678","3953",
"영주2동","총인구","2020.09 월","3692","7608","3670","3938",
"영주2동","총인구","2020.10 월","3705","7609","3673","3936",
"영주2동","총인구","2020.11 월","3699","7567","3654","3913",
"영주2동","총인구","2020.12 월","3706","7540","3627","3913",
"영주2동","총인구","2021.01 월","3707","7521","3614","3907",
"영주2동","총인구","2021.02 월","3713","7480","3595","3885",
"영주2동","총인구","2021.03 월","3709","7446","3587","3859",
"영주2동","총인구","2021.04 월","3685","7389","3561","3828",
"영주2동","총인구","2021.05 월","3686","7358","3550","3808",
"영주2동","총인구","2021.06 월","3613","7269","3511","3758",
"영주2동","총인구","2021.07 월","3620","7271","3517","3754",
"영주2동","총인구","2021.08 월","3613","7257","3503","3754",
"영주2동","총인구","2021.09 월","3616","7248","3503","3745",
"영주2동","총인구","2021.10 월","3613","7234","3492","3742",
"영주2동","총인구","2021.11 월","3609","7204","3479","3725",
"영주2동","총인구","2021.12 월","3602","7185","3465","3720",
"영주2동","총인구","2022.01 월","3612","7179","3464","3715",
"영주2동","총인구","2022.02 월","3605","7147","3452","3695",
"영주2동","총인구","2022.03 월","3603","7133","3442","3691",
"영주2동","총인구","2022.04 월","3601","7130","3441","3689",
"영주2동","총인구","2022.05 월","3610","7122","3440","3682",
"영주2동","총인구","2022.06 월","3611","7119","3437","3682",
"영주2동","총인구","2022.07 월","3596","7088","3428","3660",
"영주2동","총인구","2022.08 월","3595","7079","3434","3645",
"영주2동","총인구","2022.09 월","3569","7051","3425","3626",
"영주2동","총인구","2022.10 월","3565","7019","3404","3615",
"영주2동","총인구","2022.11 월","3565","7004","3391","3613",
"영주2동","총인구","2022.12 월","3559","6960","3374","3586",
"영주2동","총인구","2023.01 월","3552","6944","3359","3585",
"영주2동","총인구","2023.02 월","3559","6950","3362","3588",
"영주2동","총인구","2023.03 월","3555","6929","3347","3582",
"영주2동","총인구","2023.04 월","3553","6901","3333","3568",
"영주2동","총인구","2023.05 월","3555","6894","3329","3565",
"영주2동","총인구","2023.06 월","3549","6867","3316","3551",
"영주2동","총인구","2023.07 월","3545","6844","3307","3537",
"영주2동","총인구","2023.08 월","3533","6824","3301","3523",
"영주2동","총인구","2023.09 월","3523","6804","3288","3516",
"영주2동","총인구","2023.10 월","3527","6793","3287","3506",
"영주2동","총인구","2023.11 월","3525","6791","3270","3521",
"영주2동","총인구","2023.12 월","3521","6769","3254","3515",
"영주2동","총인구","2024.01 월","3518","6745","3240","3505",
"영주2동","총인구","2024.02 월","3510","6705","3224","3481",
"영주2동","총인구","2024.03 월","3504","6691","3214","3477",
"영주2동","총인구","2024.04 월","3489","6668","3205","3463",
"영주2동","총인구","2024.05 월","3483","6641","3194","3447",
"영주2동","총인구","2024.06 월","3471","6621","3189","3432",
"영주2동","총인구","2024.07 월","3460","6604","3182","3422",
"영주2동","총인구","2024.08 월","3460","6577","3175","3402",
"영주2동","총인구","2024.09 월","3456","6559","3169","3390",
"영주2동","총인구","2024.10 월","3453","6536","3158","3378",
"영주2동","총인구","2024.11 월","3444","6523","3146","3377",
"영주2동","총인구","2024.12 월","3445","6531","3156","3375",
"서구","총인구","2020.01 월","52735","110097","53795","56302",
"서구","총인구","2020.02 월","52806","109971","53679","56292",
"서구","총인구","2020.03 월","52792","109756","53507","56249",
"서구","총인구","2020.04 월","52884","109730","53489","56241",
"서구","총인구","2020.05 월","53072","109820","53529","56291",
"서구","총인구","2020.06 월","53248","109885","53544","56341",
"서구","총인구","2020.07 월","53340","109870","53519","56351",
"서구","총인구","2020.08 월","53342","109691","53411","56280",
"서구","총인구","2020.09 월","53359","109614","53381","56233",
"서구","총인구","2020.10 월","53576","109911","53498","56413",
"서구","총인구","2020.11 월","53724","110027","53535","56492",
"서구","총인구","2020.12 월","53853","110051","53521","56530",
"서구","총인구","2021.01 월","53881","109876","53464","56412",
"서구","총인구","2021.02 월","53962","109759","53367","56392",
"서구","총인구","2021.03 월","52876","108375","52726","55649",
"서구","총인구","2021.04 월","53018","108453","52738","55715",
"서구","총인구","2021.05 월","53115","108450","52686","55764",
"서구","총인구","2021.06 월","53133","108383","52665","55718",
"서구","총인구","2021.07 월","53159","108279","52647","55632",
"서구","총인구","2021.08 월","53095","107976","52498","55478",
"서구","총인구","2021.09 월","53097","107787","52395","55392",
"서구","총인구","2021.10 월","53038","107536","52275","55261",
"서구","총인구","2021.11 월","53019","107381","52178","55203",
"서구","총인구","2021.12 월","52960","107143","52051","55092",
"서구","총인구","2022.01 월","52853","106863","51951","54912",
"서구","총인구","2022.02 월","52900","106634","51836","54798",
"서구","총인구","2022.03 월","52895","106334","51687","54647",
"서구","총인구","2022.04 월","52822","105963","51487","54476",
"서구","총인구","2022.05 월","52852","105851","51389","54462",
"서구","총인구","2022.06 월","53109","106397","51630","54767",
"서구","총인구","2022.07 월","53342","106818","51834","54984",
"서구","총인구","2022.08 월","53667","107522","52184","55338",
"서구","총인구","2022.09 월","53621","107514","52202","55312",
"서구","총인구","2022.10 월","53657","107490","52192","55298",
"서구","총인구","2022.11 월","53648","107476","52170","55306",
"서구","총인구","2022.12 월","53626","107402","52118","55284",
"서구","총인구","2023.01 월","53592","107255","52035","55220",
"서구","총인구","2023.02 월","53689","107209","51973","55236",
"서구","총인구","2023.03 월","53670","107035","51815","55220",
"서구","총인구","2023.04 월","53640","106977","51760","55217",
"서구","총인구","2023.05 월","53593","106877","51671","55206",
"서구","총인구","2023.06 월","53542","106761","51601","55160",
"서구","총인구","2023.07 월","53519","106660","51545","55115",
"서구","총인구","2023.08 월","53521","106737","51540","55197",
"서구","총인구","2023.09 월","53510","106722","51513","55209",
"서구","총인구","2023.10 월","53590","106725","51490","55235",
"서구","총인구","2023.11 월","53657","106793","51514","55279",
"서구","총인구","2023.12 월","53630","106708","51477","55231",
"서구","총인구","2024.01 월","53521","106500","51402","55098",
"서구","총인구","2024.02 월","53551","106446","51349","55097",
"서구","총인구","2024.03 월","53534","106265","51264","55001",
"서구","총인구","2024.04 월","53458","106019","51142","54877",
"서구","총인구","2024.05 월","53394","105988","51082","54906",
"서구","총인구","2024.06 월","53365","105861","51048","54813",
"서구","총인구","2024.07 월","53344","105747","50988","54759",
"서구","총인구","2024.08 월","53397","105822","51023","54799",
"서구","총인구","2024.09 월","53580","106120","51169","54951",
"서구","총인구","2024.10 월","53673","106268","51210","55058",
"서구","총인구","2024.11 월","53622","106206","51164","55042",
"서구","총인구","2024.12 월","53648","106194","51106","55088",
"동대신1동","총인구","2020.01 월","2282","4683","2252","2431",
"동대신1동","총인구","2020.02 월","2293","4686","2249","2437",
"동대신1동","총인구","2020.03 월","2304","4689","2247","2442",
"동대신1동","총인구","2020.04 월","2311","4686","2234","2452",
"동대신1동","총인구","2020.05 월","2313","4671","2224","2447",
"동대신1동","총인구","2020.06 월","2319","4674","2227","2447",
"동대신1동","총인구","2020.07 월","2322","4677","2228","2449",
"동대신1동","총인구","2020.08 월","2312","4645","2209","2436",
"동대신1동","총인구","2020.09 월","2314","4633","2198","2435",
"동대신1동","총인구","2020.10 월","2305","4606","2190","2416",
"동대신1동","총인구","2020.11 월","2306","4593","2180","2413",
"동대신1동","총인구","2020.12 월","2315","4597","2187","2410",
"동대신1동","총인구","2021.01 월","2314","4574","2174","2400",
"동대신1동","총인구","2021.02 월","2302","4542","2159","2383",
"동대신1동","총인구","2021.03 월","2264","4521","2157","2364",
"동대신1동","총인구","2021.04 월","2479","5060","2449","2611",
"동대신1동","총인구","2021.05 월","2606","5383","2593","2790",
"동대신1동","총인구","2021.06 월","2676","5531","2665","2866",
"동대신1동","총인구","2021.07 월","2715","5582","2695","2887",
"동대신1동","총인구","2021.08 월","2729","5614","2716","2898",
"동대신1동","총인구","2021.09 월","2734","5641","2728","2913",
"동대신1동","총인구","2021.10 월","2733","5636","2747","2889",
"동대신1동","총인구","2021.11 월","2743","5654","2754","2900",
"동대신1동","총인구","2021.12 월","2752","5655","2754","2901",
"동대신1동","총인구","2022.01 월","2753","5671","2764","2907",
"동대신1동","총인구","2022.02 월","2752","5655","2756","2899",
"동대신1동","총인구","2022.03 월","2760","5656","2763","2893",
"동대신1동","총인구","2022.04 월","2770","5651","2754","2897",
"동대신1동","총인구","2022.05 월","2770","5638","2750","2888",
"동대신1동","총인구","2022.06 월","2758","5627","2751","2876",
"동대신1동","총인구","2022.07 월","2761","5619","2748","2871",
"동대신1동","총인구","2022.08 월","2766","5614","2742","2872",
"동대신1동","총인구","2022.09 월","2764","5609","2738","2871",
"동대신1동","총인구","2022.10 월","2766","5604","2740","2864",
"동대신1동","총인구","2022.11 월","2763","5581","2725","2856",
"동대신1동","총인구","2022.12 월","2755","5560","2709","2851",
"동대신1동","총인구","2023.01 월","2750","5542","2706","2836",
"동대신1동","총인구","2023.02 월","2750","5524","2695","2829",
"동대신1동","총인구","2023.03 월","2748","5539","2698","2841",
"동대신1동","총인구","2023.04 월","2742","5521","2680","2841",
"동대신1동","총인구","2023.05 월","2737","5495","2665","2830",
"동대신1동","총인구","2023.06 월","2721","5454","2641","2813",
"동대신1동","총인구","2023.07 월","2718","5432","2625","2807",
"동대신1동","총인구","2023.08 월","2717","5421","2619","2802",
"동대신1동","총인구","2023.09 월","2706","5393","2603","2790",
"동대신1동","총인구","2023.10 월","2710","5402","2605","2797",
"동대신1동","총인구","2023.11 월","2703","5381","2596","2785",
"동대신1동","총인구","2023.12 월","2693","5360","2583","2777",
"동대신1동","총인구","2024.01 월","2682","5341","2577","2764",
"동대신1동","총인구","2024.02 월","2685","5344","2582","2762",
"동대신1동","총인구","2024.03 월","2678","5343","2583","2760",
"동대신1동","총인구","2024.04 월","2674","5340","2581","2759",
"동대신1동","총인구","2024.05 월","2676","5361","2583","2778",
"동대신1동","총인구","2024.06 월","2678","5352","2580","2772",
"동대신1동","총인구","2024.07 월","2675","5334","2572","2762",
"동대신1동","총인구","2024.08 월","2668","5331","2565","2766",
"동대신1동","총인구","2024.09 월","2665","5331","2560","2771",
"동대신1동","총인구","2024.10 월","2656","5307","2539","2768",
"동대신1동","총인구","2024.11 월","2650","5273","2521","2752",
"동대신1동","총인구","2024.12 월","2653","5272","2521","2751",
"동대신2동","총인구","2020.01 월","3677","7937","3864","4073",
"동대신2동","총인구","2020.02 월","3685","7953","3860","4093",
"동대신2동","총인구","2020.03 월","3682","7915","3850","4065",
"동대신2동","총인구","2020.04 월","3668","7849","3825","4024",
"동대신2동","총인구","2020.05 월","3673","7855","3823","4032",
"동대신2동","총인구","2020.06 월","3675","7811","3804","4007",
"동대신2동","총인구","2020.07 월","3683","7813","3807","4006",
"동대신2동","총인구","2020.08 월","3682","7792","3797","3995",
"동대신2동","총인구","2020.09 월","3686","7775","3792","3983",
"동대신2동","총인구","2020.10 월","3675","7741","3771","3970",
"동대신2동","총인구","2020.11 월","3663","7694","3746","3948",
"동대신2동","총인구","2020.12 월","3668","7683","3734","3949",
"동대신2동","총인구","2021.01 월","3667","7655","3724","3931",
"동대신2동","총인구","2021.02 월","3662","7628","3709","3919",
"동대신2동","총인구","2021.03 월","3591","7523","3667","3856",
"동대신2동","총인구","2021.04 월","3583","7476","3637","3839",
"동대신2동","총인구","2021.05 월","3567","7428","3621","3807",
"동대신2동","총인구","2021.06 월","3565","7412","3618","3794",
"동대신2동","총인구","2021.07 월","3579","7424","3622","3802",
"동대신2동","총인구","2021.08 월","3579","7404","3613","3791",
"동대신2동","총인구","2021.09 월","3586","7398","3606","3792",
"동대신2동","총인구","2021.10 월","3599","7411","3605","3806",
"동대신2동","총인구","2021.11 월","3606","7390","3586","3804",
"동대신2동","총인구","2021.12 월","3617","7383","3581","3802",
"동대신2동","총인구","2022.01 월","3621","7361","3573","3788",
"동대신2동","총인구","2022.02 월","3623","7316","3552","3764",
"동대신2동","총인구","2022.03 월","3623","7283","3532","3751",
"동대신2동","총인구","2022.04 월","3604","7228","3501","3727",
"동대신2동","총인구","2022.05 월","3608","7242","3505","3737",
"동대신2동","총인구","2022.06 월","3596","7215","3489","3726",
"동대신2동","총인구","2022.07 월","3592","7201","3482","3719",
"동대신2동","총인구","2022.08 월","3583","7156","3471","3685",
"동대신2동","총인구","2022.09 월","3565","7106","3451","3655",
"동대신2동","총인구","2022.10 월","3554","7078","3442","3636",
"동대신2동","총인구","2022.11 월","3543","7046","3426","3620",
"동대신2동","총인구","2022.12 월","3540","7029","3420","3609",
"동대신2동","총인구","2023.01 월","3526","6982","3393","3589",
"동대신2동","총인구","2023.02 월","3520","6971","3385","3586",
"동대신2동","총인구","2023.03 월","3521","6950","3368","3582",
"동대신2동","총인구","2023.04 월","3509","6936","3353","3583",
"동대신2동","총인구","2023.05 월","3509","6925","3355","3570",
"동대신2동","총인구","2023.06 월","3500","6899","3345","3554",
"동대신2동","총인구","2023.07 월","3499","6873","3338","3535",
"동대신2동","총인구","2023.08 월","3490","6868","3335","3533",
"동대신2동","총인구","2023.09 월","3479","6849","3324","3525",
"동대신2동","총인구","2023.10 월","3466","6830","3318","3512",
"동대신2동","총인구","2023.11 월","3455","6807","3297","3510",
"동대신2동","총인구","2023.12 월","3445","6795","3292","3503",
"동대신2동","총인구","2024.01 월","3439","6764","3281","3483",
"동대신2동","총인구","2024.02 월","3438","6747","3276","3471",
"동대신2동","총인구","2024.03 월","3426","6704","3255","3449",
"동대신2동","총인구","2024.04 월","3418","6677","3240","3437",
"동대신2동","총인구","2024.05 월","3413","6666","3233","3433",
"동대신2동","총인구","2024.06 월","3410","6653","3224","3429",
"동대신2동","총인구","2024.07 월","3409","6658","3229","3429",
"동대신2동","총인구","2024.08 월","3403","6644","3225","3419",
"동대신2동","총인구","2024.09 월","3396","6621","3214","3407",
"동대신2동","총인구","2024.10 월","3377","6577","3191","3386",
"동대신2동","총인구","2024.11 월","3359","6543","3170","3373",
"동대신2동","총인구","2024.12 월","3354","6521","3157","3364",
"동대신3동","총인구","2020.01 월","3344","6717","3125","3592",
"동대신3동","총인구","2020.02 월","3329","6669","3098","3571",
"동대신3동","총인구","2020.03 월","3341","6652","3078","3574",
"동대신3동","총인구","2020.04 월","3513","7078","3284","3794",
"동대신3동","총인구","2020.05 월","3647","7375","3437","3938",
"동대신3동","총인구","2020.06 월","3759","7617","3549","4068",
"동대신3동","총인구","2020.07 월","3824","7736","3603","4133",
"동대신3동","총인구","2020.08 월","3862","7813","3645","4168",
"동대신3동","총인구","2020.09 월","3887","7885","3686","4199",
"동대신3동","총인구","2020.10 월","3889","7846","3665","4181",
"동대신3동","총인구","2020.11 월","3878","7814","3648","4166",
"동대신3동","총인구","2020.12 월","3890","7834","3666","4168",
"동대신3동","총인구","2021.01 월","3913","7867","3687","4180",
"동대신3동","총인구","2021.02 월","3922","7837","3683","4154",
"동대신3동","총인구","2021.03 월","3849","7744","3647","4097",
"동대신3동","총인구","2021.04 월","3851","7727","3633","4094",
"동대신3동","총인구","2021.05 월","3864","7732","3635","4097",
"동대신3동","총인구","2021.06 월","3858","7708","3615","4093",
"동대신3동","총인구","2021.07 월","3882","7745","3624","4121",
"동대신3동","총인구","2021.08 월","3881","7736","3615","4121",
"동대신3동","총인구","2021.09 월","3910","7765","3626","4139",
"동대신3동","총인구","2021.10 월","3909","7764","3636","4128",
"동대신3동","총인구","2021.11 월","3906","7747","3629","4118",
"동대신3동","총인구","2021.12 월","3906","7758","3637","4121",
"동대신3동","총인구","2022.01 월","3899","7753","3636","4117",
"동대신3동","총인구","2022.02 월","3924","7793","3644","4149",
"동대신3동","총인구","2022.03 월","3932","7776","3638","4138",
"동대신3동","총인구","2022.04 월","3933","7763","3632","4131",
"동대신3동","총인구","2022.05 월","3927","7733","3620","4113",
"동대신3동","총인구","2022.06 월","3910","7672","3584","4088",
"동대신3동","총인구","2022.07 월","3904","7652","3585","4067",
"동대신3동","총인구","2022.08 월","3917","7635","3573","4062",
"동대신3동","총인구","2022.09 월","3898","7591","3563","4028",
"동대신3동","총인구","2022.10 월","3900","7580","3555","4025",
"동대신3동","총인구","2022.11 월","3891","7567","3554","4013",
"동대신3동","총인구","2022.12 월","3877","7553","3549","4004",
"동대신3동","총인구","2023.01 월","3881","7565","3550","4015",
"동대신3동","총인구","2023.02 월","3917","7595","3564","4031",
"동대신3동","총인구","2023.03 월","3927","7609","3563","4046",
"동대신3동","총인구","2023.04 월","3915","7580","3548","4032",
"동대신3동","총인구","2023.05 월","3911","7563","3533","4030",
"동대신3동","총인구","2023.06 월","3904","7545","3518","4027",
"동대신3동","총인구","2023.07 월","3886","7503","3489","4014",
"동대신3동","총인구","2023.08 월","3903","7490","3491","3999",
"동대신3동","총인구","2023.09 월","3896","7478","3477","4001",
"동대신3동","총인구","2023.10 월","3884","7464","3484","3980",
"동대신3동","총인구","2023.11 월","3881","7463","3481","3982",
"동대신3동","총인구","2023.12 월","3875","7458","3484","3974",
"동대신3동","총인구","2024.01 월","3866","7443","3493","3950",
"동대신3동","총인구","2024.02 월","3865","7416","3470","3946",
"동대신3동","총인구","2024.03 월","3858","7398","3460","3938",
"동대신3동","총인구","2024.04 월","3832","7342","3439","3903",
"동대신3동","총인구","2024.05 월","3829","7332","3433","3899",
"동대신3동","총인구","2024.06 월","3824","7304","3417","3887",
"동대신3동","총인구","2024.07 월","3822","7287","3413","3874",
"동대신3동","총인구","2024.08 월","3811","7280","3412","3868",
"동대신3동","총인구","2024.09 월","3791","7240","3402","3838",
"동대신3동","총인구","2024.10 월","3781","7208","3377","3831",
"동대신3동","총인구","2024.11 월","3768","7177","3372","3805",
"동대신3동","총인구","2024.12 월","3759","7153","3356","3797",
"서대신1동","총인구","2020.01 월","5520","12311","5839","6472",
"서대신1동","총인구","2020.02 월","5549","12352","5843","6509",
"서대신1동","총인구","2020.03 월","5532","12337","5821","6516",
"서대신1동","총인구","2020.04 월","5510","12276","5788","6488",
"서대신1동","총인구","2020.05 월","5506","12211","5759","6452",
"서대신1동","총인구","2020.06 월","5519","12211","5759","6452",
"서대신1동","총인구","2020.07 월","5511","12194","5742","6452",
"서대신1동","총인구","2020.08 월","5513","12168","5725","6443",
"서대신1동","총인구","2020.09 월","5536","12233","5753","6480",
"서대신1동","총인구","2020.10 월","5893","13100","6192","6908",
"서대신1동","총인구","2020.11 월","6053","13542","6392","7150",
"서대신1동","총인구","2020.12 월","6157","13771","6499","7272",
"서대신1동","총인구","2021.01 월","6167","13831","6522","7309",
"서대신1동","총인구","2021.02 월","6196","13889","6542","7347",
"서대신1동","총인구","2021.03 월","6158","13844","6522","7322",
"서대신1동","총인구","2021.04 월","6150","13818","6514","7304",
"서대신1동","총인구","2021.05 월","6135","13771","6488","7283",
"서대신1동","총인구","2021.06 월","6152","13782","6491","7291",
"서대신1동","총인구","2021.07 월","6156","13791","6499","7292",
"서대신1동","총인구","2021.08 월","6168","13821","6513","7308",
"서대신1동","총인구","2021.09 월","6186","13830","6516","7314",
"서대신1동","총인구","2021.10 월","6201","13825","6518","7307",
"서대신1동","총인구","2021.11 월","6193","13828","6515","7313",
"서대신1동","총인구","2021.12 월","6193","13811","6492","7319",
"서대신1동","총인구","2022.01 월","6187","13776","6484","7292",
"서대신1동","총인구","2022.02 월","6201","13755","6475","7280",
"서대신1동","총인구","2022.03 월","6207","13741","6460","7281",
"서대신1동","총인구","2022.04 월","6209","13718","6456","7262",
"서대신1동","총인구","2022.05 월","6225","13732","6461","7271",
"서대신1동","총인구","2022.06 월","6218","13692","6436","7256",
"서대신1동","총인구","2022.07 월","6212","13651","6415","7236",
"서대신1동","총인구","2022.08 월","6467","14319","6748","7571",
"서대신1동","총인구","2022.09 월","6602","14622","6895","7727",
"서대신1동","총인구","2022.10 월","6655","14733","6941","7792",
"서대신1동","총인구","2022.11 월","6711","14846","7008","7838",
"서대신1동","총인구","2022.12 월","6743","14926","7039","7887",
"서대신1동","총인구","2023.01 월","6755","14970","7061","7909",
"서대신1동","총인구","2023.02 월","6802","15032","7088","7944",
"서대신1동","총인구","2023.03 월","6794","15017","7091","7926",
"서대신1동","총인구","2023.04 월","6807","15054","7108","7946",
"서대신1동","총인구","2023.05 월","6812","15109","7136","7973",
"서대신1동","총인구","2023.06 월","6802","15104","7137","7967",
"서대신1동","총인구","2023.07 월","6813","15136","7144","7992",
"서대신1동","총인구","2023.08 월","6840","15229","7183","8046",
"서대신1동","총인구","2023.09 월","6845","15253","7188","8065",
"서대신1동","총인구","2023.10 월","6837","15214","7158","8056",
"서대신1동","총인구","2023.11 월","6829","15214","7157","8057",
"서대신1동","총인구","2023.12 월","6814","15158","7139","8019",
"서대신1동","총인구","2024.01 월","6780","15124","7123","8001",
"서대신1동","총인구","2024.02 월","6800","15152","7136","8016",
"서대신1동","총인구","2024.03 월","6818","15163","7150","8013",
"서대신1동","총인구","2024.04 월","6814","15135","7150","7985",
"서대신1동","총인구","2024.05 월","6818","15130","7141","7989",
"서대신1동","총인구","2024.06 월","6825","15136","7149","7987",
"서대신1동","총인구","2024.07 월","6831","15150","7142","8008",
"서대신1동","총인구","2024.08 월","6840","15154","7144","8010",
"서대신1동","총인구","2024.09 월","6846","15123","7133","7990",
"서대신1동","총인구","2024.10 월","6842","15114","7126","7988",
"서대신1동","총인구","2024.11 월","6839","15080","7108","7972",
"서대신1동","총인구","2024.12 월","6849","15062","7090","7972",
"서대신3동","총인구","2020.01 월","3573","8978","4174","4804",
"서대신3동","총인구","2020.02 월","3569","8979","4170","4809",
"서대신3동","총인구","2020.03 월","3567","8986","4169","4817",
"서대신3동","총인구","2020.04 월","3558","8939","4149","4790",
"서대신3동","총인구","2020.05 월","3566","8941","4149","4792",
"서대신3동","총인구","2020.06 월","3570","8906","4130","4776",
"서대신3동","총인구","2020.07 월","3572","8894","4125","4769",
"서대신3동","총인구","2020.08 월","3565","8886","4116","4770",
"서대신3동","총인구","2020.09 월","3563","8879","4113","4766",
"서대신3동","총인구","2020.10 월","3542","8772","4054","4718",
"서대신3동","총인구","2020.11 월","3534","8734","4037","4697",
"서대신3동","총인구","2020.12 월","3542","8703","4025","4678",
"서대신3동","총인구","2021.01 월","3551","8708","4027","4681",
"서대신3동","총인구","2021.02 월","3555","8690","4016","4674",
"서대신3동","총인구","2021.03 월","3536","8680","3999","4681",
"서대신3동","총인구","2021.04 월","3526","8633","3972","4661",
"서대신3동","총인구","2021.05 월","3519","8602","3949","4653",
"서대신3동","총인구","2021.06 월","3494","8545","3914","4631",
"서대신3동","총인구","2021.07 월","3464","8488","3895","4593",
"서대신3동","총인구","2021.08 월","3444","8405","3863","4542",
"서대신3동","총인구","2021.09 월","3427","8370","3844","4526",
"서대신3동","총인구","2021.10 월","3398","8320","3818","4502",
"서대신3동","총인구","2021.11 월","3362","8244","3784","4460",
"서대신3동","총인구","2021.12 월","3329","8180","3752","4428",
"서대신3동","총인구","2022.01 월","3306","8117","3713","4404",
"서대신3동","총인구","2022.02 월","3305","8070","3696","4374",
"서대신3동","총인구","2022.03 월","3289","8036","3692","4344",
"서대신3동","총인구","2022.04 월","3276","7999","3680","4319",
"서대신3동","총인구","2022.05 월","3270","7967","3655","4312",
"서대신3동","총인구","2022.06 월","3269","7936","3632","4304",
"서대신3동","총인구","2022.07 월","3270","7906","3621","4285",
"서대신3동","총인구","2022.08 월","3243","7808","3569","4239",
"서대신3동","총인구","2022.09 월","3236","7799","3556","4243",
"서대신3동","총인구","2022.10 월","3218","7733","3528","4205",
"서대신3동","총인구","2022.11 월","3215","7722","3524","4198",
"서대신3동","총인구","2022.12 월","3223","7707","3513","4194",
"서대신3동","총인구","2023.01 월","3217","7679","3499","4180",
"서대신3동","총인구","2023.02 월","3212","7644","3481","4163",
"서대신3동","총인구","2023.03 월","3209","7631","3473","4158",
"서대신3동","총인구","2023.04 월","3213","7631","3474","4157",
"서대신3동","총인구","2023.05 월","3202","7607","3467","4140",
"서대신3동","총인구","2023.06 월","3196","7603","3469","4134",
"서대신3동","총인구","2023.07 월","3193","7582","3462","4120",
"서대신3동","총인구","2023.08 월","3191","7591","3462","4129",
"서대신3동","총인구","2023.09 월","3199","7600","3468","4132",
"서대신3동","총인구","2023.10 월","3192","7591","3456","4135",
"서대신3동","총인구","2023.11 월","3190","7591","3454","4137",
"서대신3동","총인구","2023.12 월","3172","7559","3437","4122",
"서대신3동","총인구","2024.01 월","3171","7539","3430","4109",
"서대신3동","총인구","2024.02 월","3162","7504","3410","4094",
"서대신3동","총인구","2024.03 월","3156","7491","3416","4075",
"서대신3동","총인구","2024.04 월","3153","7479","3410","4069",
"서대신3동","총인구","2024.05 월","3144","7457","3397","4060",
"서대신3동","총인구","2024.06 월","3144","7458","3399","4059",
"서대신3동","총인구","2024.07 월","3144","7445","3403","4042",
"서대신3동","총인구","2024.08 월","3136","7424","3392","4032",
"서대신3동","총인구","2024.09 월","3144","7423","3390","4033",
"서대신3동","총인구","2024.10 월","3146","7406","3382","4024",
"서대신3동","총인구","2024.11 월","3150","7412","3389","4023",
"서대신3동","총인구","2024.12 월","3150","7406","3379","4027",
"서대신4동","총인구","2020.01 월","3124","8167","3959","4208",
"서대신4동","총인구","2020.02 월","3132","8162","3953","4209",
"서대신4동","총인구","2020.03 월","3140","8169","3961","4208",
"서대신4동","총인구","2020.04 월","3132","8115","3941","4174",
"서대신4동","총인구","2020.05 월","3128","8088","3930","4158",
"서대신4동","총인구","2020.06 월","3121","8063","3919","4144",
"서대신4동","총인구","2020.07 월","3124","8047","3912","4135",
"서대신4동","총인구","2020.08 월","3123","8026","3908","4118",
"서대신4동","총인구","2020.09 월","3126","7996","3890","4106",
"서대신4동","총인구","2020.10 월","3119","7972","3872","4100",
"서대신4동","총인구","2020.11 월","3126","7945","3859","4086",
"서대신4동","총인구","2020.12 월","3130","7935","3845","4090",
"서대신4동","총인구","2021.01 월","3121","7888","3829","4059",
"서대신4동","총인구","2021.02 월","3135","7885","3818","4067",
"서대신4동","총인구","2021.03 월","3143","7892","3813","4079",
"서대신4동","총인구","2021.04 월","3144","7858","3796","4062",
"서대신4동","총인구","2021.05 월","3147","7833","3773","4060",
"서대신4동","총인구","2021.06 월","3151","7845","3783","4062",
"서대신4동","총인구","2021.07 월","3154","7838","3774","4064",
"서대신4동","총인구","2021.08 월","3158","7839","3769","4070",
"서대신4동","총인구","2021.09 월","3161","7821","3760","4061",
"서대신4동","총인구","2021.10 월","3160","7795","3745","4050",
"서대신4동","총인구","2021.11 월","3168","7800","3748","4052",
"서대신4동","총인구","2021.12 월","3165","7790","3746","4044",
"서대신4동","총인구","2022.01 월","3157","7749","3737","4012",
"서대신4동","총인구","2022.02 월","3170","7751","3742","4009",
"서대신4동","총인구","2022.03 월","3161","7712","3717","3995",
"서대신4동","총인구","2022.04 월","3157","7700","3702","3998",
"서대신4동","총인구","2022.05 월","3166","7687","3691","3996",
"서대신4동","총인구","2022.06 월","3158","7683","3694","3989",
"서대신4동","총인구","2022.07 월","3149","7653","3668","3985",
"서대신4동","총인구","2022.08 월","3140","7602","3641","3961",
"서대신4동","총인구","2022.09 월","3111","7541","3619","3922",
"서대신4동","총인구","2022.10 월","3092","7505","3604","3901",
"서대신4동","총인구","2022.11 월","3077","7466","3591","3875",
"서대신4동","총인구","2022.12 월","3068","7432","3573","3859",
"서대신4동","총인구","2023.01 월","3061","7417","3565","3852",
"서대신4동","총인구","2023.02 월","3078","7441","3582","3859",
"서대신4동","총인구","2023.03 월","3070","7392","3549","3843",
"서대신4동","총인구","2023.04 월","3069","7395","3555","3840",
"서대신4동","총인구","2023.05 월","3064","7379","3552","3827",
"서대신4동","총인구","2023.06 월","3064","7378","3551","3827",
"서대신4동","총인구","2023.07 월","3064","7368","3550","3818",
"서대신4동","총인구","2023.08 월","3048","7353","3546","3807",
"서대신4동","총인구","2023.09 월","3037","7317","3533","3784",
"서대신4동","총인구","2023.10 월","3025","7291","3522","3769",
"서대신4동","총인구","2023.11 월","3014","7262","3519","3743",
"서대신4동","총인구","2023.12 월","3009","7250","3514","3736",
"서대신4동","총인구","2024.01 월","3010","7252","3514","3738",
"서대신4동","총인구","2024.02 월","3003","7223","3497","3726",
"서대신4동","총인구","2024.03 월","2998","7221","3492","3729",
"서대신4동","총인구","2024.04 월","3004","7232","3482","3750",
"서대신4동","총인구","2024.05 월","2992","7204","3468","3736",
"서대신4동","총인구","2024.06 월","2987","7197","3466","3731",
"서대신4동","총인구","2024.07 월","2981","7201","3469","3732",
"서대신4동","총인구","2024.08 월","2977","7181","3453","3728",
"서대신4동","총인구","2024.09 월","2972","7149","3436","3713",
"서대신4동","총인구","2024.10 월","2969","7113","3412","3701",
"서대신4동","총인구","2024.11 월","2962","7099","3402","3697",
"서대신4동","총인구","2024.12 월","2946","7058","3378","3680",
"부민동","총인구","2020.01 월","4132","8315","3973","4342",
"부민동","총인구","2020.02 월","4182","8382","3979","4403",
"부민동","총인구","2020.03 월","4190","8373","3971","4402",
"부민동","총인구","2020.04 월","4174","8308","3945","4363",
"부민동","총인구","2020.05 월","4176","8259","3921","4338",
"부민동","총인구","2020.06 월","4196","8263","3916","4347",
"부민동","총인구","2020.07 월","4191","8254","3909","4345",
"부민동","총인구","2020.08 월","4197","8252","3910","4342",
"부민동","총인구","2020.09 월","4203","8248","3911","4337",
"부민동","총인구","2020.10 월","4185","8207","3877","4330",
"부민동","총인구","2020.11 월","4174","8183","3866","4317",
"부민동","총인구","2020.12 월","4157","8122","3838","4284",
"부민동","총인구","2021.01 월","4152","8101","3849","4252",
"부민동","총인구","2021.02 월","4181","8164","3857","4307",
"부민동","총인구","2021.03 월","4164","8109","3814","4295",
"부민동","총인구","2021.04 월","4150","8065","3793","4272",
"부민동","총인구","2021.05 월","4139","8047","3769","4278",
"부민동","총인구","2021.06 월","4131","8010","3758","4252",
"부민동","총인구","2021.07 월","4130","7993","3754","4239",
"부민동","총인구","2021.08 월","4108","7946","3733","4213",
"부민동","총인구","2021.09 월","4098","7932","3716","4216",
"부민동","총인구","2021.10 월","4091","7910","3700","4210",
"부민동","총인구","2021.11 월","4094","7918","3706","4212",
"부민동","총인구","2021.12 월","4066","7863","3674","4189",
"부민동","총인구","2022.01 월","4064","7864","3688","4176",
"부민동","총인구","2022.02 월","4086","7886","3693","4193",
"부민동","총인구","2022.03 월","4103","7884","3682","4202",
"부민동","총인구","2022.04 월","4091","7851","3672","4179",
"부민동","총인구","2022.05 월","4105","7881","3679","4202",
"부민동","총인구","2022.06 월","4097","7851","3656","4195",
"부민동","총인구","2022.07 월","4104","7860","3658","4202",
"부민동","총인구","2022.08 월","4116","7913","3700","4213",
"부민동","총인구","2022.09 월","4121","7921","3711","4210",
"부민동","총인구","2022.10 월","4133","7929","3718","4211",
"부민동","총인구","2022.11 월","4122","7935","3723","4212",
"부민동","총인구","2022.12 월","4106","7915","3717","4198",
"부민동","총인구","2023.01 월","4103","7894","3708","4186",
"부민동","총인구","2023.02 월","4109","7869","3703","4166",
"부민동","총인구","2023.03 월","4113","7849","3685","4164",
"부민동","총인구","2023.04 월","4116","7856","3692","4164",
"부민동","총인구","2023.05 월","4128","7923","3708","4215",
"부민동","총인구","2023.06 월","4140","7943","3713","4230",
"부민동","총인구","2023.07 월","4155","7953","3713","4240",
"부민동","총인구","2023.08 월","4162","7968","3711","4257",
"부민동","총인구","2023.09 월","4169","7975","3722","4253",
"부민동","총인구","2023.10 월","4149","7934","3703","4231",
"부민동","총인구","2023.11 월","4152","7961","3712","4249",
"부민동","총인구","2023.12 월","4127","7923","3696","4227",
"부민동","총인구","2024.01 월","4092","7853","3662","4191",
"부민동","총인구","2024.02 월","4121","7960","3705","4255",
"부민동","총인구","2024.03 월","4160","7996","3717","4279",
"부민동","총인구","2024.04 월","4157","7969","3699","4270",
"부민동","총인구","2024.05 월","4151","8038","3723","4315",
"부민동","총인구","2024.06 월","4152","8028","3711","4317",
"부민동","총인구","2024.07 월","4135","8021","3715","4306",
"부민동","총인구","2024.08 월","4146","8023","3725","4298",
"부민동","총인구","2024.09 월","4152","8044","3727","4317",
"부민동","총인구","2024.10 월","4144","8018","3723","4295",
"부민동","총인구","2024.11 월","4137","8018","3721","4297",
"부민동","총인구","2024.12 월","4135","8024","3720","4304",
"아미동","총인구","2020.01 월","4143","7512","3818","3694",
"아미동","총인구","2020.02 월","4136","7480","3808","3672",
"아미동","총인구","2020.03 월","4116","7431","3773","3658",
"아미동","총인구","2020.04 월","4099","7379","3743","3636",
"아미동","총인구","2020.05 월","4112","7367","3730","3637",
"아미동","총인구","2020.06 월","4101","7313","3693","3620",
"아미동","총인구","2020.07 월","4093","7299","3682","3617",
"아미동","총인구","2020.08 월","4085","7268","3659","3609",
"아미동","총인구","2020.09 월","4068","7221","3629","3592",
"아미동","총인구","2020.10 월","4067","7183","3614","3569",
"아미동","총인구","2020.11 월","4073","7157","3598","3559",
"아미동","총인구","2020.12 월","4074","7137","3592","3545",
"아미동","총인구","2021.01 월","4071","7121","3592","3529",
"아미동","총인구","2021.02 월","4062","7084","3574","3510",
"아미동","총인구","2021.03 월","3925","6910","3505","3405",
"아미동","총인구","2021.04 월","3917","6883","3488","3395",
"아미동","총인구","2021.05 월","3917","6858","3472","3386",
"아미동","총인구","2021.06 월","3916","6826","3450","3376",
"아미동","총인구","2021.07 월","3912","6799","3441","3358",
"아미동","총인구","2021.08 월","3910","6786","3432","3354",
"아미동","총인구","2021.09 월","3890","6734","3407","3327",
"아미동","총인구","2021.10 월","3889","6713","3397","3316",
"아미동","총인구","2021.11 월","3903","6701","3392","3309",
"아미동","총인구","2021.12 월","3872","6653","3364","3289",
"아미동","총인구","2022.01 월","3855","6608","3337","3271",
"아미동","총인구","2022.02 월","3849","6570","3318","3252",
"아미동","총인구","2022.03 월","3847","6539","3305","3234",
"아미동","총인구","2022.04 월","3824","6471","3270","3201",
"아미동","총인구","2022.05 월","3811","6443","3257","3186",
"아미동","총인구","2022.06 월","3820","6443","3248","3195",
"아미동","총인구","2022.07 월","3822","6425","3241","3184",
"아미동","총인구","2022.08 월","3807","6401","3222","3179",
"아미동","총인구","2022.09 월","3771","6351","3198","3153",
"아미동","총인구","2022.10 월","3746","6315","3183","3132",
"아미동","총인구","2022.11 월","3732","6295","3163","3132",
"아미동","총인구","2022.12 월","3709","6258","3141","3117",
"아미동","총인구","2023.01 월","3717","6246","3131","3115",
"아미동","총인구","2023.02 월","3708","6231","3126","3105",
"아미동","총인구","2023.03 월","3692","6193","3102","3091",
"아미동","총인구","2023.04 월","3675","6156","3083","3073",
"아미동","총인구","2023.05 월","3654","6136","3068","3068",
"아미동","총인구","2023.06 월","3632","6091","3041","3050",
"아미동","총인구","2023.07 월","3623","6070","3036","3034",
"아미동","총인구","2023.08 월","3605","6050","3020","3030",
"아미동","총인구","2023.09 월","3613","6049","3018","3031",
"아미동","총인구","2023.10 월","3801","6269","3116","3153",
"아미동","총인구","2023.11 월","3943","6432","3177","3255",
"아미동","총인구","2023.12 월","4011","6503","3213","3290",
"아미동","총인구","2024.01 월","4022","6522","3221","3301",
"아미동","총인구","2024.02 월","4024","6529","3213","3316",
"아미동","총인구","2024.03 월","4024","6510","3200","3310",
"아미동","총인구","2024.04 월","4030","6522","3207","3315",
"아미동","총인구","2024.05 월","4021","6510","3201","3309",
"아미동","총인구","2024.06 월","4017","6477","3187","3290",
"아미동","총인구","2024.07 월","4010","6457","3174","3283",
"아미동","총인구","2024.08 월","4000","6446","3173","3273",
"아미동","총인구","2024.09 월","4039","6496","3200","3296",
"아미동","총인구","2024.10 월","4045","6495","3199","3296",
"아미동","총인구","2024.11 월","4026","6473","3177","3296",
"아미동","총인구","2024.12 월","4017","6462","3171","3291",
"초장동","총인구","2020.01 월","2756","4890","2445","2445",
"초장동","총인구","2020.02 월","2750","4863","2423","2440",
"초장동","총인구","2020.03 월","2750","4854","2418","2436",
"초장동","총인구","2020.04 월","2752","4848","2411","2437",
"초장동","총인구","2020.05 월","2754","4821","2397","2424",
"초장동","총인구","2020.06 월","2739","4803","2391","2412",
"초장동","총인구","2020.07 월","2741","4768","2375","2393",
"초장동","총인구","2020.08 월","2746","4766","2379","2387",
"초장동","총인구","2020.09 월","2742","4748","2380","2368",
"초장동","총인구","2020.10 월","2727","4703","2357","2346",
"초장동","총인구","2020.11 월","2727","4691","2354","2337",
"초장동","총인구","2020.12 월","2734","4689","2353","2336",
"초장동","총인구","2021.01 월","2735","4673","2343","2330",
"초장동","총인구","2021.02 월","2742","4671","2346","2325",
"초장동","총인구","2021.03 월","2638","4536","2297","2239",
"초장동","총인구","2021.04 월","2625","4498","2273","2225",
"초장동","총인구","2021.05 월","2623","4467","2253","2214",
"초장동","총인구","2021.06 월","2617","4438","2245","2193",
"초장동","총인구","2021.07 월","2611","4415","2232","2183",
"초장동","총인구","2021.08 월","2606","4397","2225","2172",
"초장동","총인구","2021.09 월","2605","4384","2217","2167",
"초장동","총인구","2021.10 월","2587","4351","2201","2150",
"초장동","총인구","2021.11 월","2577","4325","2189","2136",
"초장동","총인구","2021.12 월","2563","4308","2178","2130",
"초장동","총인구","2022.01 월","2557","4280","2169","2111",
"초장동","총인구","2022.02 월","2548","4252","2150","2102",
"초장동","총인구","2022.03 월","2551","4244","2152","2092",
"초장동","총인구","2022.04 월","2541","4219","2139","2080",
"초장동","총인구","2022.05 월","2531","4187","2122","2065",
"초장동","총인구","2022.06 월","2536","4177","2116","2061",
"초장동","총인구","2022.07 월","2541","4183","2119","2064",
"초장동","총인구","2022.08 월","2530","4173","2110","2063",
"초장동","총인구","2022.09 월","2497","4129","2083","2046",
"초장동","총인구","2022.10 월","2502","4121","2080","2041",
"초장동","총인구","2022.11 월","2503","4120","2076","2044",
"초장동","총인구","2022.12 월","2497","4099","2067","2032",
"초장동","총인구","2023.01 월","2482","4081","2054","2027",
"초장동","총인구","2023.02 월","2477","4066","2048","2018",
"초장동","총인구","2023.03 월","2481","4062","2042","2020",
"초장동","총인구","2023.04 월","2467","4036","2030","2006",
"초장동","총인구","2023.05 월","2461","4017","2020","1997",
"초장동","총인구","2023.06 월","2467","4015","2016","1999",
"초장동","총인구","2023.07 월","2454","3998","2007","1991",
"초장동","총인구","2023.08 월","2450","3997","2010","1987",
"초장동","총인구","2023.09 월","2446","3990","2002","1988",
"초장동","총인구","2023.10 월","2434","3971","1993","1978",
"초장동","총인구","2023.11 월","2426","3949","1977","1972",
"초장동","총인구","2023.12 월","2424","3944","1972","1972",
"초장동","총인구","2024.01 월","2413","3925","1961","1964",
"초장동","총인구","2024.02 월","2408","3896","1946","1950",
"초장동","총인구","2024.03 월","2405","3883","1945","1938",
"초장동","총인구","2024.04 월","2389","3854","1935","1919",
"초장동","총인구","2024.05 월","2380","3838","1919","1919",
"초장동","총인구","2024.06 월","2370","3821","1909","1912",
"초장동","총인구","2024.07 월","2365","3804","1899","1905",
"초장동","총인구","2024.08 월","2361","3806","1897","1909",
"초장동","총인구","2024.09 월","2360","3793","1888","1905",
"초장동","총인구","2024.10 월","2357","3783","1888","1895",
"초장동","총인구","2024.11 월","2347","3757","1873","1884",
"초장동","총인구","2024.12 월","2345","3747","1868","1879",
"충무동","총인구","2020.01 월","5499","10609","5199","5410",
"충무동","총인구","2020.02 월","5516","10583","5200","5383",
"충무동","총인구","2020.03 월","5531","10607","5197","5410",
"충무동","총인구","2020.04 월","5520","10546","5172","5374",
"충무동","총인구","2020.05 월","5525","10534","5158","5376",
"충무동","총인구","2020.06 월","5535","10525","5143","5382",
"충무동","총인구","2020.07 월","5546","10534","5152","5382",
"충무동","총인구","2020.08 월","5532","10504","5133","5371",
"충무동","총인구","2020.09 월","5535","10505","5136","5369",
"충무동","총인구","2020.10 월","5520","10461","5106","5355",
"충무동","총인구","2020.11 월","5546","10477","5117","5360",
"충무동","총인구","2020.12 월","5550","10464","5096","5368",
"충무동","총인구","2021.01 월","5570","10465","5089","5376",
"충무동","총인구","2021.02 월","5599","10485","5087","5398",
"충무동","총인구","2021.03 월","5467","10324","5029","5295",
"충무동","총인구","2021.04 월","5477","10286","4995","5291",
"충무동","총인구","2021.05 월","5486","10281","4991","5290",
"충무동","총인구","2021.06 월","5465","10265","5000","5265",
"충무동","총인구","2021.07 월","5468","10252","5002","5250",
"충무동","총인구","2021.08 월","5475","10228","4990","5238",
"충무동","총인구","2021.09 월","5491","10200","4974","5226",
"충무동","총인구","2021.10 월","5501","10191","4960","5231",
"충무동","총인구","2021.11 월","5545","10224","4968","5256",
"충무동","총인구","2021.12 월","5570","10257","4990","5267",
"충무동","총인구","2022.01 월","5563","10230","4980","5250",
"충무동","총인구","2022.02 월","5583","10244","4999","5245",
"충무동","총인구","2022.03 월","5566","10204","4970","5234",
"충무동","총인구","2022.04 월","5562","10175","4949","5226",
"충무동","총인구","2022.05 월","5568","10178","4945","5233",
"충무동","총인구","2022.06 월","5571","10169","4946","5223",
"충무동","총인구","2022.07 월","5557","10131","4922","5209",
"충무동","총인구","2022.08 월","5565","10120","4915","5205",
"충무동","총인구","2022.09 월","5544","10072","4900","5172",
"충무동","총인구","2022.10 월","5559","10084","4901","5183",
"충무동","총인구","2022.11 월","5558","10065","4888","5177",
"충무동","총인구","2022.12 월","5576","10095","4894","5201",
"충무동","총인구","2023.01 월","5587","10109","4903","5206",
"충무동","총인구","2023.02 월","5600","10114","4888","5226",
"충무동","총인구","2023.03 월","5598","10096","4880","5216",
"충무동","총인구","2023.04 월","5598","10096","4875","5221",
"충무동","총인구","2023.05 월","5587","10064","4851","5213",
"충무동","총인구","2023.06 월","5586","10078","4865","5213",
"충무동","총인구","2023.07 월","5589","10086","4883","5203",
"충무동","총인구","2023.08 월","5588","10077","4878","5199",
"충무동","총인구","2023.09 월","5582","10065","4864","5201",
"충무동","총인구","2023.10 월","5569","10025","4840","5185",
"충무동","총인구","2023.11 월","5558","10026","4863","5163",
"충무동","총인구","2023.12 월","5558","10038","4865","5173",
"충무동","총인구","2024.01 월","5550","10043","4871","5172",
"충무동","총인구","2024.02 월","5547","10003","4873","5130",
"충무동","총인구","2024.03 월","5530","9958","4845","5113",
"충무동","총인구","2024.04 월","5530","9975","4853","5122",
"충무동","총인구","2024.05 월","5528","9987","4859","5128",
"충무동","총인구","2024.06 월","5545","10029","4900","5129",
"충무동","총인구","2024.07 월","5566","10070","4904","5166",
"충무동","총인구","2024.08 월","5579","10096","4921","5175",
"충무동","총인구","2024.09 월","5574","10066","4904","5162",
"충무동","총인구","2024.10 월","5567","10056","4902","5154",
"충무동","총인구","2024.11 월","5544","10021","4903","5118",
"충무동","총인구","2024.12 월","5538","10024","4895","5129",
"남부민1동","총인구","2020.01 월","2666","5146","2730","2416",
"남부민1동","총인구","2020.02 월","2661","5125","2710","2415",
"남부민1동","총인구","2020.03 월","2664","5085","2684","2401",
"남부민1동","총인구","2020.04 월","2691","5144","2719","2425",
"남부민1동","총인구","2020.05 월","2747","5251","2766","2485",
"남부민1동","총인구","2020.06 월","2804","5360","2815","2545",
"남부민1동","총인구","2020.07 월","2836","5417","2849","2568",
"남부민1동","총인구","2020.08 월","2850","5432","2852","2580",
"남부민1동","총인구","2020.09 월","2840","5418","2848","2570",
"남부민1동","총인구","2020.10 월","2833","5379","2825","2554",
"남부민1동","총인구","2020.11 월","2829","5368","2821","2547",
"남부민1동","총인구","2020.12 월","2833","5359","2824","2535",
"남부민1동","총인구","2021.01 월","2838","5331","2814","2517",
"남부민1동","총인구","2021.02 월","2842","5334","2813","2521",
"남부민1동","총인구","2021.03 월","2752","5232","2766","2466",
"남부민1동","총인구","2021.04 월","2757","5214","2745","2469",
"남부민1동","총인구","2021.05 월","2757","5174","2722","2452",
"남부민1동","총인구","2021.06 월","2759","5178","2722","2456",
"남부민1동","총인구","2021.07 월","2756","5169","2723","2446",
"남부민1동","총인구","2021.08 월","2756","5153","2706","2447",
"남부민1동","총인구","2021.09 월","2749","5155","2709","2446",
"남부민1동","총인구","2021.10 월","2749","5144","2700","2444",
"남부민1동","총인구","2021.11 월","2742","5138","2693","2445",
"남부민1동","총인구","2021.12 월","2745","5126","2687","2439",
"남부민1동","총인구","2022.01 월","2730","5104","2686","2418",
"남부민1동","총인구","2022.02 월","2724","5091","2677","2414",
"남부민1동","총인구","2022.03 월","2721","5083","2672","2411",
"남부민1동","총인구","2022.04 월","2722","5074","2669","2405",
"남부민1동","총인구","2022.05 월","2721","5064","2660","2404",
"남부민1동","총인구","2022.06 월","2723","5056","2660","2396",
"남부민1동","총인구","2022.07 월","2714","5058","2658","2400",
"남부민1동","총인구","2022.08 월","2691","4997","2639","2358",
"남부민1동","총인구","2022.09 월","2695","4994","2635","2359",
"남부민1동","총인구","2022.10 월","2692","4973","2624","2349",
"남부민1동","총인구","2022.11 월","2684","4970","2627","2343",
"남부민1동","총인구","2022.12 월","2677","4969","2633","2336",
"남부민1동","총인구","2023.01 월","2667","4958","2637","2321",
"남부민1동","총인구","2023.02 월","2669","4947","2625","2322",
"남부민1동","총인구","2023.03 월","2661","4928","2608","2320",
"남부민1동","총인구","2023.04 월","2657","4907","2591","2316",
"남부민1동","총인구","2023.05 월","2656","4891","2575","2316",
"남부민1동","총인구","2023.06 월","2654","4866","2556","2310",
"남부민1동","총인구","2023.07 월","2645","4836","2533","2303",
"남부민1동","총인구","2023.08 월","2633","4817","2516","2301",
"남부민1동","총인구","2023.09 월","2625","4801","2503","2298",
"남부민1동","총인구","2023.10 월","2615","4777","2488","2289",
"남부민1동","총인구","2023.11 월","2599","4765","2488","2277",
"남부민1동","총인구","2023.12 월","2591","4749","2477","2272",
"남부민1동","총인구","2024.01 월","2589","4734","2471","2263",
"남부민1동","총인구","2024.02 월","2586","4720","2461","2259",
"남부민1동","총인구","2024.03 월","2582","4709","2454","2255",
"남부민1동","총인구","2024.04 월","2574","4676","2434","2242",
"남부민1동","총인구","2024.05 월","2573","4670","2429","2241",
"남부민1동","총인구","2024.06 월","2563","4652","2424","2228",
"남부민1동","총인구","2024.07 월","2564","4638","2419","2219",
"남부민1동","총인구","2024.08 월","2558","4625","2407","2218",
"남부민1동","총인구","2024.09 월","2557","4618","2397","2221",
"남부민1동","총인구","2024.10 월","2552","4601","2385","2216",
"남부민1동","총인구","2024.11 월","2541","4592","2374","2218",
"남부민1동","총인구","2024.12 월","2540","4570","2361","2209",
"남부민2동","총인구","2020.01 월","5134","10174","5107","5067",
"남부민2동","총인구","2020.02 월","5126","10134","5090","5044",
"남부민2동","총인구","2020.03 월","5114","10110","5075","5035",
"남부민2동","총인구","2020.04 월","5128","10110","5078","5032",
"남부민2동","총인구","2020.05 월","5115","10048","5059","4989",
"남부민2동","총인구","2020.06 월","5106","9994","5035","4959",
"남부민2동","총인구","2020.07 월","5096","9946","5008","4938",
"남부민2동","총인구","2020.08 월","5086","9897","4990","4907",
"남부민2동","총인구","2020.09 월","5090","9878","4983","4895",
"남부민2동","총인구","2020.10 월","5073","9822","4946","4876",
"남부민2동","총인구","2020.11 월","5081","9797","4937","4860",
"남부민2동","총인구","2020.12 월","5063","9741","4903","4838",
"남부민2동","총인구","2021.01 월","5063","9731","4892","4839",
"남부민2동","총인구","2021.02 월","5070","9709","4891","4818",
"남부민2동","총인구","2021.03 월","4951","9568","4830","4738",
"남부민2동","총인구","2021.04 월","4946","9537","4812","4725",
"남부민2동","총인구","2021.05 월","4948","9515","4802","4713",
"남부민2동","총인구","2021.06 월","4957","9492","4791","4701",
"남부민2동","총인구","2021.07 월","4944","9453","4775","4678",
"남부민2동","총인구","2021.08 월","4909","9354","4719","4635",
"남부민2동","총인구","2021.09 월","4887","9291","4686","4605",
"남부민2동","총인구","2021.10 월","4873","9246","4666","4580",
"남부민2동","총인구","2021.11 월","4847","9210","4647","4563",
"남부민2동","총인구","2021.12 월","4840","9173","4623","4550",
"남부민2동","총인구","2022.01 월","4844","9191","4632","4559",
"남부민2동","총인구","2022.02 월","4831","9160","4632","4528",
"남부민2동","총인구","2022.03 월","4830","9114","4614","4500",
"남부민2동","총인구","2022.04 월","4840","9084","4595","4489",
"남부민2동","총인구","2022.05 월","4846","9073","4588","4485",
"남부민2동","총인구","2022.06 월","4834","9028","4571","4457",
"남부민2동","총인구","2022.07 월","4824","8990","4548","4442",
"남부민2동","총인구","2022.08 월","4775","8915","4505","4410",
"남부민2동","총인구","2022.09 월","4764","8863","4483","4380",
"남부민2동","총인구","2022.10 월","4739","8821","4468","4353",
"남부민2동","총인구","2022.11 월","4730","8778","4441","4337",
"남부민2동","총인구","2022.12 월","4731","8762","4432","4330",
"남부민2동","총인구","2023.01 월","4727","8724","4404","4320",
"남부민2동","총인구","2023.02 월","4703","8662","4372","4290",
"남부민2동","총인구","2023.03 월","4686","8621","4347","4274",
"남부민2동","총인구","2023.04 월","4677","8607","4338","4269",
"남부민2동","총인구","2023.05 월","4669","8578","4318","4260",
"남부민2동","총인구","2023.06 월","4653","8535","4293","4242",
"남부민2동","총인구","2023.07 월","4637","8501","4277","4224",
"남부민2동","총인구","2023.08 월","4613","8459","4253","4206",
"남부민2동","총인구","2023.09 월","4594","8427","4232","4195",
"남부민2동","총인구","2023.10 월","4567","8375","4203","4172",
"남부민2동","총인구","2023.11 월","4539","8288","4159","4129",
"남부민2동","총인구","2023.12 월","4512","8246","4135","4111",
"남부민2동","총인구","2024.01 월","4511","8226","4123","4103",
"남부민2동","총인구","2024.02 월","4505","8211","4107","4104",
"남부민2동","총인구","2024.03 월","4494","8169","4081","4088",
"남부민2동","총인구","2024.04 월","4487","8135","4065","4070",
"남부민2동","총인구","2024.05 월","4468","8095","4046","4049",
"남부민2동","총인구","2024.06 월","4456","8062","4024","4038",
"남부민2동","총인구","2024.07 월","4448","8041","4012","4029",
"남부민2동","총인구","2024.08 월","4442","8003","3988","4015",
"남부민2동","총인구","2024.09 월","4421","7959","3966","3993",
"남부민2동","총인구","2024.10 월","4400","7908","3930","3978",
"남부민2동","총인구","2024.11 월","4383","7867","3910","3957",
"남부민2동","총인구","2024.12 월","4369","7843","3901","3942",
"암남동","총인구","2020.01 월","6885","14658","7310","7348",
"암남동","총인구","2020.02 월","6878","14603","7296","7307",
"암남동","총인구","2020.03 월","6861","14548","7263","7285",
"암남동","총인구","2020.04 월","6828","14452","7200","7252",
"암남동","총인구","2020.05 월","6810","14399","7176","7223",
"암남동","총인구","2020.06 월","6804","14345","7163","7182",
"암남동","총인구","2020.07 월","6801","14291","7127","7164",
"암남동","총인구","2020.08 월","6789","14242","7088","7154",
"암남동","총인구","2020.09 월","6769","14195","7062","7133",
"암남동","총인구","2020.10 월","6748","14119","7029","7090",
"암남동","총인구","2020.11 월","6734","14032","6980","7052",
"암남동","총인구","2020.12 월","6740","14016","6959","7057",
"암남동","총인구","2021.01 월","6719","13931","6922","7009",
"암남동","총인구","2021.02 월","6694","13841","6872","6969",
"암남동","총인구","2021.03 월","6438","13492","6680","6812",
"암남동","총인구","2021.04 월","6413","13398","6631","6767",
"암남동","총인구","2021.05 월","6407","13359","6618","6741",
"암남동","총인구","2021.06 월","6392","13351","6613","6738",
"암남동","총인구","2021.07 월","6388","13330","6611","6719",
"암남동","총인구","2021.08 월","6372","13293","6604","6689",
"암남동","총인구","2021.09 월","6373","13266","6606","6660",
"암남동","총인구","2021.10 월","6348","13230","6582","6648",
"암남동","총인구","2021.11 월","6333","13202","6567","6635",
"암남동","총인구","2021.12 월","6342","13186","6573","6613",
"암남동","총인구","2022.01 월","6317","13159","6552","6607",
"암남동","총인구","2022.02 월","6304","13091","6502","6589",
"암남동","총인구","2022.03 월","6305","13062","6490","6572",
"암남동","총인구","2022.04 월","6293","13030","6468","6562",
"암남동","총인구","2022.05 월","6304","13026","6456","6570",
"암남동","총인구","2022.06 월","6619","13848","6847","7001",
"암남동","총인구","2022.07 월","6892","14489","7169","7320",
"암남동","총인구","2022.08 월","7067","14869","7349","7520",
"암남동","총인구","2022.09 월","7053","14916","7370","7546",
"암남동","총인구","2022.10 월","7101","15014","7408","7606",
"암남동","총인구","2022.11 월","7119","15085","7424","7661",
"암남동","총인구","2022.12 월","7124","15097","7431","7666",
"암남동","총인구","2023.01 월","7119","15088","7424","7664",
"암남동","총인구","2023.02 월","7144","15113","7416","7697",
"암남동","총인구","2023.03 월","7170","15148","7409","7739",
"암남동","총인구","2023.04 월","7195","15202","7433","7769",
"암남동","총인구","2023.05 월","7203","15190","7423","7767",
"암남동","총인구","2023.06 월","7223","15250","7456","7794",
"암남동","총인구","2023.07 월","7243","15322","7488","7834",
"암남동","총인구","2023.08 월","7281","15417","7516","7901",
"암남동","총인구","2023.09 월","7319","15525","7579","7946",
"암남동","총인구","2023.10 월","7341","15582","7604","7978",
"암남동","총인구","2023.11 월","7368","15654","7634","8020",
"암남동","총인구","2023.12 월","7399","15725","7670","8055",
"암남동","총인구","2024.01 월","7396","15734","7675","8059",
"암남동","총인구","2024.02 월","7407","15741","7673","8068",
"암남동","총인구","2024.03 월","7405","15720","7666","8054",
"암남동","총인구","2024.04 월","7396","15683","7647","8036",
"암남동","총인구","2024.05 월","7401","15700","7650","8050",
"암남동","총인구","2024.06 월","7394","15692","7658","8034",
"암남동","총인구","2024.07 월","7394","15641","7637","8004",
"암남동","총인구","2024.08 월","7476","15809","7721","8088",
"암남동","총인구","2024.09 월","7663","16257","7952","8305",
"암남동","총인구","2024.10 월","7837","16682","8156","8526",
"암남동","총인구","2024.11 월","7916","16894","8244","8650",
"암남동","총인구","2024.12 월","7993","17052","8309","8743",
"동구","총인구","2020.01 월","44734","90632","44480","46152",
"동구","총인구","2020.02 월","44894","90778","44557","46221",
"동구","총인구","2020.03 월","45356","91585","44918","46667",
"동구","총인구","2020.04 월","45578","91994","45109","46885",
"동구","총인구","2020.05 월","45755","91996","45089","46907",
"동구","총인구","2020.06 월","45873","91975","45080","46895",
"동구","총인구","2020.07 월","45954","91979","45092","46887",
"동구","총인구","2020.08 월","45994","91907","45015","46892",
"동구","총인구","2020.09 월","45985","91639","44889","46750",
"동구","총인구","2020.10 월","45994","91401","44730","46671",
"동구","총인구","2020.11 월","46003","91194","44619","46575",
"동구","총인구","2020.12 월","46003","91061","44528","46533",
"동구","총인구","2021.01 월","46081","90905","44464","46441",
"동구","총인구","2021.02 월","46128","90744","44354","46390",
"동구","총인구","2021.03 월","45786","90330","44204","46126",
"동구","총인구","2021.04 월","45865","90257","44159","46098",
"동구","총인구","2021.05 월","45918","90136","44063","46073",
"동구","총인구","2021.06 월","45911","89982","43987","45995",
"동구","총인구","2021.07 월","45930","89813","43881","45932",
"동구","총인구","2021.08 월","45914","89602","43777","45825",
"동구","총인구","2021.09 월","46046","89617","43822","45795",
"동구","총인구","2021.10 월","46123","89731","43886","45845",
"동구","총인구","2021.11 월","46243","89798","43923","45875",
"동구","총인구","2021.12 월","46362","89712","43851","45861",
"동구","총인구","2022.01 월","46597","89950","43953","45997",
"동구","총인구","2022.02 월","46829","90283","44108","46175",
"동구","총인구","2022.03 월","46938","90335","44135","46200",
"동구","총인구","2022.04 월","46970","90308","44092","46216",
"동구","총인구","2022.05 월","47024","90296","44068","46228",
"동구","총인구","2022.06 월","47052","90186","44022","46164",
"동구","총인구","2022.07 월","46982","89944","43898","46046",
"동구","총인구","2022.08 월","47011","89800","43830","45970",
"동구","총인구","2022.09 월","46553","89213","43618","45595",
"동구","총인구","2022.10 월","46535","89030","43518","45512",
"동구","총인구","2022.11 월","46402","88773","43399","45374",
"동구","총인구","2022.12 월","46349","88601","43284","45317",
"동구","총인구","2023.01 월","46322","88513","43250","45263",
"동구","총인구","2023.02 월","46224","88151","43021","45130",
"동구","총인구","2023.03 월","46196","88013","42926","45087",
"동구","총인구","2023.04 월","46162","87818","42819","44999",
"동구","총인구","2023.05 월","46152","87744","42757","44987",
"동구","총인구","2023.06 월","46797","89082","43427","45655",
"동구","총인구","2023.07 월","47279","90044","43882","46162",
"동구","총인구","2023.08 월","47445","90418","44075","46343",
"동구","총인구","2023.09 월","47503","90458","44076","46382",
"동구","총인구","2023.10 월","47466","90387","44049","46338",
"동구","총인구","2023.11 월","47471","90325","44001","46324",
"동구","총인구","2023.12 월","47428","90190","43889","46301",
"동구","총인구","2024.01 월","47383","90028","43753","46275",
"동구","총인구","2024.02 월","47413","89848","43682","46166",
"동구","총인구","2024.03 월","47389","89644","43577","46067",
"동구","총인구","2024.04 월","47375","89572","43510","46062",
"동구","총인구","2024.05 월","47354","89380","43397","45983",
"동구","총인구","2024.06 월","47311","89226","43304","45922",
"동구","총인구","2024.07 월","47275","89152","43285","45867",
"동구","총인구","2024.08 월","47210","88930","43154","45776",
"동구","총인구","2024.09 월","47120","88758","43095","45663",
"동구","총인구","2024.10 월","47064","88631","43022","45609",
"동구","총인구","2024.11 월","47057","88579","42991","45588",
"동구","총인구","2024.12 월","47048","88412","42887","45525",
"초량1동","총인구","2020.01 월","2757","5881","2951","2930",
"초량1동","총인구","2020.02 월","2767","5893","2960","2933",
"초량1동","총인구","2020.03 월","2748","5836","2927","2909",
"초량1동","총인구","2020.04 월","2747","5881","2966","2915",
"초량1동","총인구","2020.05 월","2740","5843","2935","2908",
"초량1동","총인구","2020.06 월","2746","5837","2931","2906",
"초량1동","총인구","2020.07 월","2761","5833","2934","2899",
"초량1동","총인구","2020.08 월","2777","5860","2947","2913",
"초량1동","총인구","2020.09 월","2776","5861","2951","2910",
"초량1동","총인구","2020.10 월","2782","5837","2933","2904",
"초량1동","총인구","2020.11 월","2781","5802","2911","2891",
"초량1동","총인구","2020.12 월","2780","5799","2918","2881",
"초량1동","총인구","2021.01 월","2787","5772","2907","2865",
"초량1동","총인구","2021.02 월","2800","5756","2905","2851",
"초량1동","총인구","2021.03 월","2806","5743","2906","2837",
"초량1동","총인구","2021.04 월","2822","5755","2922","2833",
"초량1동","총인구","2021.05 월","2845","5756","2923","2833",
"초량1동","총인구","2021.06 월","2836","5725","2908","2817",
"초량1동","총인구","2021.07 월","2834","5691","2888","2803",
"초량1동","총인구","2021.08 월","2820","5641","2849","2792",
"초량1동","총인구","2021.09 월","2879","5722","2899","2823",
"초량1동","총인구","2021.10 월","2939","5807","2943","2864",
"초량1동","총인구","2021.11 월","2969","5848","2962","2886",
"초량1동","총인구","2021.12 월","2996","5888","2983","2905",
"초량1동","총인구","2022.01 월","2996","5855","2969","2886",
"초량1동","총인구","2022.02 월","3011","5858","2967","2891",
"초량1동","총인구","2022.03 월","3013","5879","2964","2915",
"초량1동","총인구","2022.04 월","3011","5848","2939","2909",
"초량1동","총인구","2022.05 월","3032","5868","2952","2916",
"초량1동","총인구","2022.06 월","3012","5866","2958","2908",
"초량1동","총인구","2022.07 월","3021","5869","2952","2917",
"초량1동","총인구","2022.08 월","3037","5888","2955","2933",
"초량1동","총인구","2022.09 월","3013","5867","2958","2909",
"초량1동","총인구","2022.10 월","3018","5856","2947","2909",
"초량1동","총인구","2022.11 월","2993","5793","2926","2867",
"초량1동","총인구","2022.12 월","2988","5780","2916","2864",
"초량1동","총인구","2023.01 월","2994","5784","2920","2864",
"초량1동","총인구","2023.02 월","2977","5755","2908","2847",
"초량1동","총인구","2023.03 월","2981","5751","2904","2847",
"초량1동","총인구","2023.04 월","2986","5754","2910","2844",
"초량1동","총인구","2023.05 월","2990","5730","2902","2828",
"초량1동","총인구","2023.06 월","3001","5736","2902","2834",
"초량1동","총인구","2023.07 월","2989","5720","2883","2837",
"초량1동","총인구","2023.08 월","2993","5728","2891","2837",
"초량1동","총인구","2023.09 월","2996","5731","2888","2843",
"초량1동","총인구","2023.10 월","2998","5715","2876","2839",
"초량1동","총인구","2023.11 월","2999","5711","2876","2835",
"초량1동","총인구","2023.12 월","2994","5709","2871","2838",
"초량1동","총인구","2024.01 월","2994","5712","2880","2832",
"초량1동","총인구","2024.02 월","3015","5736","2901","2835",
"초량1동","총인구","2024.03 월","3020","5717","2888","2829",
"초량1동","총인구","2024.04 월","3038","5749","2894","2855",
"초량1동","총인구","2024.05 월","3056","5756","2902","2854",
"초량1동","총인구","2024.06 월","3053","5745","2894","2851",
"초량1동","총인구","2024.07 월","3037","5719","2888","2831",
"초량1동","총인구","2024.08 월","3051","5698","2878","2820",
"초량1동","총인구","2024.09 월","3070","5707","2886","2821",
"초량1동","총인구","2024.10 월","3078","5708","2873","2835",
"초량1동","총인구","2024.11 월","3077","5695","2863","2832",
"초량1동","총인구","2024.12 월","3082","5694","2867","2827",
"초량2동","총인구","2020.01 월","3299","6295","3007","3288",
"초량2동","총인구","2020.02 월","3322","6319","3018","3301",
"초량2동","총인구","2020.03 월","3324","6285","3002","3283",
"초량2동","총인구","2020.04 월","3327","6289","3019","3270",
"초량2동","총인구","2020.05 월","3341","6291","3024","3267",
"초량2동","총인구","2020.06 월","3340","6248","3006","3242",
"초량2동","총인구","2020.07 월","3338","6239","3007","3232",
"초량2동","총인구","2020.08 월","3343","6215","2992","3223",
"초량2동","총인구","2020.09 월","3357","6204","2992","3212",
"초량2동","총인구","2020.10 월","3377","6203","2989","3214",
"초량2동","총인구","2020.11 월","3362","6173","2966","3207",
"초량2동","총인구","2020.12 월","3368","6172","2966","3206",
"초량2동","총인구","2021.01 월","3363","6169","2962","3207",
"초량2동","총인구","2021.02 월","3367","6149","2954","3195",
"초량2동","총인구","2021.03 월","3359","6123","2941","3182",
"초량2동","총인구","2021.04 월","3368","6110","2938","3172",
"초량2동","총인구","2021.05 월","3370","6093","2925","3168",
"초량2동","총인구","2021.06 월","3376","6084","2924","3160",
"초량2동","총인구","2021.07 월","3369","6073","2916","3157",
"초량2동","총인구","2021.08 월","3373","6071","2923","3148",
"초량2동","총인구","2021.09 월","3382","6070","2927","3143",
"초량2동","총인구","2021.10 월","3380","6054","2922","3132",
"초량2동","총인구","2021.11 월","3383","6049","2920","3129",
"초량2동","총인구","2021.12 월","3371","6024","2913","3111",
"초량2동","총인구","2022.01 월","3376","6024","2915","3109",
"초량2동","총인구","2022.02 월","3380","6020","2905","3115",
"초량2동","총인구","2022.03 월","3392","6029","2922","3107",
"초량2동","총인구","2022.04 월","3395","6026","2918","3108",
"초량2동","총인구","2022.05 월","3400","6026","2907","3119",
"초량2동","총인구","2022.06 월","3403","6015","2908","3107",
"초량2동","총인구","2022.07 월","3388","5980","2885","3095",
"초량2동","총인구","2022.08 월","3404","5984","2892","3092",
"초량2동","총인구","2022.09 월","3322","5873","2858","3015",
"초량2동","총인구","2022.10 월","3312","5850","2847","3003",
"초량2동","총인구","2022.11 월","3308","5833","2844","2989",
"초량2동","총인구","2022.12 월","3302","5830","2841","2989",
"초량2동","총인구","2023.01 월","3294","5801","2818","2983",
"초량2동","총인구","2023.02 월","3297","5788","2811","2977",
"초량2동","총인구","2023.03 월","3287","5776","2795","2981",
"초량2동","총인구","2023.04 월","3278","5728","2776","2952",
"초량2동","총인구","2023.05 월","3273","5736","2770","2966",
"초량2동","총인구","2023.06 월","3263","5737","2769","2968",
"초량2동","총인구","2023.07 월","3273","5772","2787","2985",
"초량2동","총인구","2023.08 월","3268","5777","2786","2991",
"초량2동","총인구","2023.09 월","3258","5756","2764","2992",
"초량2동","총인구","2023.10 월","3219","5704","2744","2960",
"초량2동","총인구","2023.11 월","3222","5720","2754","2966",
"초량2동","총인구","2023.12 월","3221","5705","2742","2963",
"초량2동","총인구","2024.01 월","3216","5696","2733","2963",
"초량2동","총인구","2024.02 월","3218","5691","2721","2970",
"초량2동","총인구","2024.03 월","3204","5665","2706","2959",
"초량2동","총인구","2024.04 월","3207","5667","2715","2952",
"초량2동","총인구","2024.05 월","3211","5655","2703","2952",
"초량2동","총인구","2024.06 월","3211","5665","2698","2967",
"초량2동","총인구","2024.07 월","3214","5660","2703","2957",
"초량2동","총인구","2024.08 월","3202","5628","2682","2946",
"초량2동","총인구","2024.09 월","3179","5588","2662","2926",
"초량2동","총인구","2024.10 월","3159","5571","2651","2920",
"초량2동","총인구","2024.11 월","3151","5550","2642","2908",
"초량2동","총인구","2024.12 월","3153","5524","2616","2908",
"초량3동","총인구","2020.01 월","4479","9117","4592","4525",
"초량3동","총인구","2020.02 월","4576","9310","4699","4611",
"초량3동","총인구","2020.03 월","5060","10406","5222","5184",
"초량3동","총인구","2020.04 월","5317","11027","5515","5512",
"초량3동","총인구","2020.05 월","5470","11313","5637","5676",
"초량3동","총인구","2020.06 월","5558","11523","5743","5780",
"초량3동","총인구","2020.07 월","5611","11660","5815","5845",
"초량3동","총인구","2020.08 월","5636","11729","5835","5894",
"초량3동","총인구","2020.09 월","5665","11755","5841","5914",
"초량3동","총인구","2020.10 월","5675","11778","5842","5936",
"초량3동","총인구","2020.11 월","5713","11823","5866","5957",
"초량3동","총인구","2020.12 월","5738","11869","5892","5977",
"초량3동","총인구","2021.01 월","5762","11879","5893","5986",
"초량3동","총인구","2021.02 월","5775","11891","5887","6004",
"초량3동","총인구","2021.03 월","5898","12289","6082","6207",
"초량3동","총인구","2021.04 월","6004","12521","6182","6339",
"초량3동","총인구","2021.05 월","6127","12749","6280","6469",
"초량3동","총인구","2021.06 월","6212","12972","6394","6578",
"초량3동","총인구","2021.07 월","6305","13115","6464","6651",
"초량3동","총인구","2021.08 월","6351","13205","6502","6703",
"초량3동","총인구","2021.09 월","6421","13304","6556","6748",
"초량3동","총인구","2021.10 월","6450","13402","6608","6794",
"초량3동","총인구","2021.11 월","6479","13473","6639","6834",
"초량3동","총인구","2021.12 월","6489","13449","6611","6838",
"초량3동","총인구","2022.01 월","6508","13506","6635","6871",
"초량3동","총인구","2022.02 월","6535","13543","6653","6890",
"초량3동","총인구","2022.03 월","6522","13520","6651","6869",
"초량3동","총인구","2022.04 월","6516","13502","6633","6869",
"초량3동","총인구","2022.05 월","6524","13516","6638","6878",
"초량3동","총인구","2022.06 월","6538","13508","6621","6887",
"초량3동","총인구","2022.07 월","6541","13514","6626","6888",
"초량3동","총인구","2022.08 월","6567","13528","6626","6902",
"초량3동","총인구","2022.09 월","6554","13505","6619","6886",
"초량3동","총인구","2022.10 월","6562","13522","6626","6896",
"초량3동","총인구","2022.11 월","6531","13506","6607","6899",
"초량3동","총인구","2022.12 월","6514","13510","6606","6904",
"초량3동","총인구","2023.01 월","6512","13528","6616","6912",
"초량3동","총인구","2023.02 월","6499","13472","6584","6888",
"초량3동","총인구","2023.03 월","6490","13451","6566","6885",
"초량3동","총인구","2023.04 월","6475","13423","6551","6872",
"초량3동","총인구","2023.05 월","6449","13417","6552","6865",
"초량3동","총인구","2023.06 월","6399","13310","6506","6804",
"초량3동","총인구","2023.07 월","6373","13270","6494","6776",
"초량3동","총인구","2023.08 월","6316","13219","6497","6722",
"초량3동","총인구","2023.09 월","6319","13198","6487","6711",
"초량3동","총인구","2023.10 월","6269","13128","6469","6659",
"초량3동","총인구","2023.11 월","6258","13099","6449","6650",
"초량3동","총인구","2023.12 월","6263","13079","6432","6647",
"초량3동","총인구","2024.01 월","6267","13065","6405","6660",
"초량3동","총인구","2024.02 월","6271","13013","6382","6631",
"초량3동","총인구","2024.03 월","6289","13001","6372","6629",
"초량3동","총인구","2024.04 월","6295","13026","6382","6644",
"초량3동","총인구","2024.05 월","6301","13020","6376","6644",
"초량3동","총인구","2024.06 월","6316","13037","6370","6667",
"초량3동","총인구","2024.07 월","6336","13076","6388","6688",
"초량3동","총인구","2024.08 월","6352","13093","6393","6700",
"초량3동","총인구","2024.09 월","6354","13115","6419","6696",
"초량3동","총인구","2024.10 월","6339","13097","6408","6689",
"초량3동","총인구","2024.11 월","6363","13128","6430","6698",
"초량3동","총인구","2024.12 월","6373","13142","6431","6711",
"초량6동","총인구","2020.01 월","3291","6683","3256","3427",
"초량6동","총인구","2020.02 월","3291","6668","3249","3419",
"초량6동","총인구","2020.03 월","3284","6624","3223","3401",
"초량6동","총인구","2020.04 월","3279","6598","3208","3390",
"초량6동","총인구","2020.05 월","3277","6564","3198","3366",
"초량6동","총인구","2020.06 월","3274","6538","3182","3356",
"초량6동","총인구","2020.07 월","3273","6512","3165","3347",
"초량6동","총인구","2020.08 월","3274","6485","3148","3337",
"초량6동","총인구","2020.09 월","3261","6440","3119","3321",
"초량6동","총인구","2020.10 월","3264","6434","3115","3319",
"초량6동","총인구","2020.11 월","3268","6429","3116","3313",
"초량6동","총인구","2020.12 월","3275","6415","3099","3316",
"초량6동","총인구","2021.01 월","3271","6384","3088","3296",
"초량6동","총인구","2021.02 월","3259","6318","3071","3247",
"초량6동","총인구","2021.03 월","3216","6233","3035","3198",
"초량6동","총인구","2021.04 월","3214","6188","3008","3180",
"초량6동","총인구","2021.05 월","3211","6168","2997","3171",
"초량6동","총인구","2021.06 월","3207","6131","2984","3147",
"초량6동","총인구","2021.07 월","3202","6109","2981","3128",
"초량6동","총인구","2021.08 월","3189","6082","2973","3109",
"초량6동","총인구","2021.09 월","3187","6052","2952","3100",
"초량6동","총인구","2021.10 월","3194","6052","2952","3100",
"초량6동","총인구","2021.11 월","3188","6042","2948","3094",
"초량6동","총인구","2021.12 월","3175","6007","2931","3076",
"초량6동","총인구","2022.01 월","3172","5991","2926","3065",
"초량6동","총인구","2022.02 월","3154","5952","2902","3050",
"초량6동","총인구","2022.03 월","3146","5921","2887","3034",
"초량6동","총인구","2022.04 월","3138","5901","2873","3028",
"초량6동","총인구","2022.05 월","3133","5873","2858","3015",
"초량6동","총인구","2022.06 월","3131","5860","2851","3009",
"초량6동","총인구","2022.07 월","3123","5826","2835","2991",
"초량6동","총인구","2022.08 월","3107","5778","2825","2953",
"초량6동","총인구","2022.09 월","3085","5738","2806","2932",
"초량6동","총인구","2022.10 월","3065","5697","2788","2909",
"초량6동","총인구","2022.11 월","3054","5674","2774","2900",
"초량6동","총인구","2022.12 월","3053","5659","2764","2895",
"초량6동","총인구","2023.01 월","3054","5650","2754","2896",
"초량6동","총인구","2023.02 월","3037","5623","2734","2889",
"초량6동","총인구","2023.03 월","3029","5602","2719","2883",
"초량6동","총인구","2023.04 월","3030","5607","2720","2887",
"초량6동","총인구","2023.05 월","3022","5591","2713","2878",
"초량6동","총인구","2023.06 월","3028","5590","2718","2872",
"초량6동","총인구","2023.07 월","3019","5554","2711","2843",
"초량6동","총인구","2023.08 월","3026","5552","2703","2849",
"초량6동","총인구","2023.09 월","3017","5535","2693","2842",
"초량6동","총인구","2023.10 월","3015","5519","2678","2841",
"초량6동","총인구","2023.11 월","3014","5507","2674","2833",
"초량6동","총인구","2023.12 월","3001","5466","2655","2811",
"초량6동","총인구","2024.01 월","3000","5450","2641","2809",
"초량6동","총인구","2024.02 월","2994","5423","2633","2790",
"초량6동","총인구","2024.03 월","2984","5402","2623","2779",
"초량6동","총인구","2024.04 월","2974","5364","2605","2759",
"초량6동","총인구","2024.05 월","2965","5335","2588","2747",
"초량6동","총인구","2024.06 월","2960","5310","2581","2729",
"초량6동","총인구","2024.07 월","2951","5298","2573","2725",
"초량6동","총인구","2024.08 월","2938","5274","2558","2716",
"초량6동","총인구","2024.09 월","2937","5256","2546","2710",
"초량6동","총인구","2024.10 월","2926","5244","2540","2704",
"초량6동","총인구","2024.11 월","2932","5261","2550","2711",
"초량6동","총인구","2024.12 월","2924","5246","2538","2708",
"수정1동","총인구","2020.01 월","2050","4429","2156","2273",
"수정1동","총인구","2020.02 월","2046","4418","2146","2272",
"수정1동","총인구","2020.03 월","2040","4383","2126","2257",
"수정1동","총인구","2020.04 월","2045","4351","2105","2246",
"수정1동","총인구","2020.05 월","2045","4328","2096","2232",
"수정1동","총인구","2020.06 월","2043","4320","2096","2224",
"수정1동","총인구","2020.07 월","2047","4315","2093","2222",
"수정1동","총인구","2020.08 월","2051","4331","2104","2227",
"수정1동","총인구","2020.09 월","2042","4290","2086","2204",
"수정1동","총인구","2020.10 월","2040","4288","2085","2203",
"수정1동","총인구","2020.11 월","2040","4278","2077","2201",
"수정1동","총인구","2020.12 월","2051","4288","2081","2207",
"수정1동","총인구","2021.01 월","2055","4288","2068","2220",
"수정1동","총인구","2021.02 월","2054","4274","2064","2210",
"수정1동","총인구","2021.03 월","2026","4216","2034","2182",
"수정1동","총인구","2021.04 월","2013","4187","2023","2164",
"수정1동","총인구","2021.05 월","2019","4193","2035","2158",
"수정1동","총인구","2021.06 월","2020","4194","2036","2158",
"수정1동","총인구","2021.07 월","2031","4208","2042","2166",
"수정1동","총인구","2021.08 월","2026","4204","2043","2161",
"수정1동","총인구","2021.09 월","2030","4197","2035","2162",
"수정1동","총인구","2021.10 월","2028","4199","2038","2161",
"수정1동","총인구","2021.11 월","2039","4209","2047","2162",
"수정1동","총인구","2021.12 월","2037","4194","2035","2159",
"수정1동","총인구","2022.01 월","2042","4183","2029","2154",
"수정1동","총인구","2022.02 월","2041","4163","2017","2146",
"수정1동","총인구","2022.03 월","2046","4162","2022","2140",
"수정1동","총인구","2022.04 월","2053","4161","2029","2132",
"수정1동","총인구","2022.05 월","2046","4156","2028","2128",
"수정1동","총인구","2022.06 월","2048","4138","2013","2125",
"수정1동","총인구","2022.07 월","2042","4103","1997","2106",
"수정1동","총인구","2022.08 월","2018","4072","1990","2082",
"수정1동","총인구","2022.09 월","2018","4064","1982","2082",
"수정1동","총인구","2022.10 월","2027","4082","1987","2095",
"수정1동","총인구","2022.11 월","2023","4072","1980","2092",
"수정1동","총인구","2022.12 월","2025","4068","1980","2088",
"수정1동","총인구","2023.01 월","2020","4062","1975","2087",
"수정1동","총인구","2023.02 월","2019","4049","1965","2084",
"수정1동","총인구","2023.03 월","2013","4040","1962","2078",
"수정1동","총인구","2023.04 월","2006","4029","1955","2074",
"수정1동","총인구","2023.05 월","2016","4022","1941","2081",
"수정1동","총인구","2023.06 월","2019","4035","1942","2093",
"수정1동","총인구","2023.07 월","2012","4021","1930","2091",
"수정1동","총인구","2023.08 월","2004","4002","1918","2084",
"수정1동","총인구","2023.09 월","2008","4005","1915","2090",
"수정1동","총인구","2023.10 월","2002","3993","1902","2091",
"수정1동","총인구","2023.11 월","2007","3989","1896","2093",
"수정1동","총인구","2023.12 월","2009","3992","1894","2098",
"수정1동","총인구","2024.01 월","2018","4005","1901","2104",
"수정1동","총인구","2024.02 월","2026","4014","1904","2110",
"수정1동","총인구","2024.03 월","2027","3993","1896","2097",
"수정1동","총인구","2024.04 월","2045","4007","1907","2100",
"수정1동","총인구","2024.05 월","2047","4005","1902","2103",
"수정1동","총인구","2024.06 월","2050","3988","1895","2093",
"수정1동","총인구","2024.07 월","2056","3997","1905","2092",
"수정1동","총인구","2024.08 월","2052","3988","1894","2094",
"수정1동","총인구","2024.09 월","2049","3980","1895","2085",
"수정1동","총인구","2024.10 월","2045","3980","1898","2082",
"수정1동","총인구","2024.11 월","2048","3981","1905","2076",
"수정1동","총인구","2024.12 월","2056","3980","1905","2075",
"수정2동","총인구","2020.01 월","5085","10218","4916","5302",
"수정2동","총인구","2020.02 월","5099","10247","4926","5321",
"수정2동","총인구","2020.03 월","5110","10254","4926","5328",
"수정2동","총인구","2020.04 월","5121","10251","4918","5333",
"수정2동","총인구","2020.05 월","5134","10233","4910","5323",
"수정2동","총인구","2020.06 월","5153","10232","4901","5331",
"수정2동","총인구","2020.07 월","5169","10239","4907","5332",
"수정2동","총인구","2020.08 월","5186","10253","4901","5352",
"수정2동","총인구","2020.09 월","5183","10217","4883","5334",
"수정2동","총인구","2020.10 월","5173","10172","4859","5313",
"수정2동","총인구","2020.11 월","5162","10169","4850","5319",
"수정2동","총인구","2020.12 월","5145","10148","4839","5309",
"수정2동","총인구","2021.01 월","5148","10112","4820","5292",
"수정2동","총인구","2021.02 월","5173","10152","4839","5313",
"수정2동","총인구","2021.03 월","5175","10126","4825","5301",
"수정2동","총인구","2021.04 월","5180","10101","4810","5291",
"수정2동","총인구","2021.05 월","5182","10079","4787","5292",
"수정2동","총인구","2021.06 월","5183","10042","4771","5271",
"수정2동","총인구","2021.07 월","5164","10003","4759","5244",
"수정2동","총인구","2021.08 월","5160","9968","4740","5228",
"수정2동","총인구","2021.09 월","5172","9974","4742","5232",
"수정2동","총인구","2021.10 월","5171","9974","4739","5235",
"수정2동","총인구","2021.11 월","5153","9915","4702","5213",
"수정2동","총인구","2021.12 월","5151","9889","4681","5208",
"수정2동","총인구","2022.01 월","5175","9894","4689","5205",
"수정2동","총인구","2022.02 월","5181","9890","4696","5194",
"수정2동","총인구","2022.03 월","5169","9843","4673","5170",
"수정2동","총인구","2022.04 월","5173","9847","4669","5178",
"수정2동","총인구","2022.05 월","5174","9851","4676","5175",
"수정2동","총인구","2022.06 월","5177","9848","4674","5174",
"수정2동","총인구","2022.07 월","5172","9819","4660","5159",
"수정2동","총인구","2022.08 월","5168","9791","4641","5150",
"수정2동","총인구","2022.09 월","5019","9639","4584","5055",
"수정2동","총인구","2022.10 월","5001","9609","4573","5036",
"수정2동","총인구","2022.11 월","4987","9580","4560","5020",
"수정2동","총인구","2022.12 월","4992","9578","4552","5026",
"수정2동","총인구","2023.01 월","4985","9570","4554","5016",
"수정2동","총인구","2023.02 월","4982","9556","4537","5019",
"수정2동","총인구","2023.03 월","4980","9541","4532","5009",
"수정2동","총인구","2023.04 월","4981","9530","4533","4997",
"수정2동","총인구","2023.05 월","4970","9508","4521","4987",
"수정2동","총인구","2023.06 월","4952","9464","4498","4966",
"수정2동","총인구","2023.07 월","4950","9432","4480","4952",
"수정2동","총인구","2023.08 월","4941","9393","4462","4931",
"수정2동","총인구","2023.09 월","4909","9329","4439","4890",
"수정2동","총인구","2023.10 월","4903","9289","4413","4876",
"수정2동","총인구","2023.11 월","4879","9227","4381","4846",
"수정2동","총인구","2023.12 월","4872","9216","4367","4849",
"수정2동","총인구","2024.01 월","4849","9173","4347","4826",
"수정2동","총인구","2024.02 월","4824","9109","4314","4795",
"수정2동","총인구","2024.03 월","4821","9088","4294","4794",
"수정2동","총인구","2024.04 월","4810","9055","4272","4783",
"수정2동","총인구","2024.05 월","4807","9032","4266","4766",
"수정2동","총인구","2024.06 월","4817","9053","4288","4765",
"수정2동","총인구","2024.07 월","4795","9016","4267","4749",
"수정2동","총인구","2024.08 월","4785","9007","4266","4741",
"수정2동","총인구","2024.09 월","4789","9014","4264","4750",
"수정2동","총인구","2024.10 월","4793","9005","4257","4748",
"수정2동","총인구","2024.11 월","4791","8994","4252","4742",
"수정2동","총인구","2024.12 월","4795","8994","4260","4734",
"수정4동","총인구","2020.01 월","2349","4375","2182","2193",
"수정4동","총인구","2020.02 월","2359","4380","2181","2199",
"수정4동","총인구","2020.03 월","2349","4364","2170","2194",
"수정4동","총인구","2020.04 월","2345","4341","2160","2181",
"수정4동","총인구","2020.05 월","2336","4318","2147","2171",
"수정4동","총인구","2020.06 월","2330","4290","2138","2152",
"수정4동","총인구","2020.07 월","2331","4282","2141","2141",
"수정4동","총인구","2020.08 월","2322","4256","2128","2128",
"수정4동","총인구","2020.09 월","2321","4242","2112","2130",
"수정4동","총인구","2020.10 월","2315","4216","2103","2113",
"수정4동","총인구","2020.11 월","2321","4203","2096","2107",
"수정4동","총인구","2020.12 월","2302","4156","2064","2092",
"수정4동","총인구","2021.01 월","2313","4158","2065","2093",
"수정4동","총인구","2021.02 월","2306","4123","2038","2085",
"수정4동","총인구","2021.03 월","2289","4082","2016","2066",
"수정4동","총인구","2021.04 월","2267","4032","1989","2043",
"수정4동","총인구","2021.05 월","2261","3999","1972","2027",
"수정4동","총인구","2021.06 월","2274","4000","1968","2032",
"수정4동","총인구","2021.07 월","2271","3995","1960","2035",
"수정4동","총인구","2021.08 월","2262","3969","1941","2028",
"수정4동","총인구","2021.09 월","2262","3963","1944","2019",
"수정4동","총인구","2021.10 월","2255","3953","1938","2015",
"수정4동","총인구","2021.11 월","2250","3933","1930","2003",
"수정4동","총인구","2021.12 월","2239","3926","1927","1999",
"수정4동","총인구","2022.01 월","2235","3908","1913","1995",
"수정4동","총인구","2022.02 월","2221","3875","1897","1978",
"수정4동","총인구","2022.03 월","2215","3852","1878","1974",
"수정4동","총인구","2022.04 월","2208","3838","1872","1966",
"수정4동","총인구","2022.05 월","2208","3824","1873","1951",
"수정4동","총인구","2022.06 월","2206","3807","1865","1942",
"수정4동","총인구","2022.07 월","2204","3795","1861","1934",
"수정4동","총인구","2022.08 월","2202","3779","1858","1921",
"수정4동","총인구","2022.09 월","2179","3754","1850","1904",
"수정4동","총인구","2022.10 월","2174","3744","1843","1901",
"수정4동","총인구","2022.11 월","2173","3734","1841","1893",
"수정4동","총인구","2022.12 월","2169","3721","1835","1886",
"수정4동","총인구","2023.01 월","2162","3706","1827","1879",
"수정4동","총인구","2023.02 월","2157","3696","1818","1878",
"수정4동","총인구","2023.03 월","2153","3677","1804","1873",
"수정4동","총인구","2023.04 월","2144","3662","1800","1862",
"수정4동","총인구","2023.05 월","2137","3651","1793","1858",
"수정4동","총인구","2023.06 월","2124","3625","1776","1849",
"수정4동","총인구","2023.07 월","2126","3614","1768","1846",
"수정4동","총인구","2023.08 월","2121","3603","1760","1843",
"수정4동","총인구","2023.09 월","2116","3586","1748","1838",
"수정4동","총인구","2023.10 월","2119","3583","1745","1838",
"수정4동","총인구","2023.11 월","2115","3578","1743","1835",
"수정4동","총인구","2023.12 월","2109","3572","1746","1826",
"수정4동","총인구","2024.01 월","2104","3560","1739","1821",
"수정4동","총인구","2024.02 월","2100","3561","1735","1826",
"수정4동","총인구","2024.03 월","2100","3554","1729","1825",
"수정4동","총인구","2024.04 월","2092","3534","1719","1815",
"수정4동","총인구","2024.05 월","2083","3503","1705","1798",
"수정4동","총인구","2024.06 월","2076","3495","1702","1793",
"수정4동","총인구","2024.07 월","2072","3486","1702","1784",
"수정4동","총인구","2024.08 월","2065","3473","1695","1778",
"수정4동","총인구","2024.09 월","2059","3461","1688","1773",
"수정4동","총인구","2024.10 월","2053","3457","1691","1766",
"수정4동","총인구","2024.11 월","2037","3442","1685","1757",
"수정4동","총인구","2024.12 월","2024","3414","1670","1744",
"수정5동","총인구","2020.01 월","2851","5871","2824","3047",
"수정5동","총인구","2020.02 월","2843","5824","2798","3026",
"수정5동","총인구","2020.03 월","2840","5802","2787","3015",
"수정5동","총인구","2020.04 월","2829","5761","2765","2996",
"수정5동","총인구","2020.05 월","2827","5752","2755","2997",
"수정5동","총인구","2020.06 월","2821","5726","2748","2978",
"수정5동","총인구","2020.07 월","2818","5703","2727","2976",
"수정5동","총인구","2020.08 월","2829","5702","2722","2980",
"수정5동","총인구","2020.09 월","2812","5665","2707","2958",
"수정5동","총인구","2020.10 월","2811","5649","2695","2954",
"수정5동","총인구","2020.11 월","2819","5631","2684","2947",
"수정5동","총인구","2020.12 월","2809","5585","2653","2932",
"수정5동","총인구","2021.01 월","2807","5566","2643","2923",
"수정5동","총인구","2021.02 월","2800","5537","2624","2913",
"수정5동","총인구","2021.03 월","2748","5457","2594","2863",
"수정5동","총인구","2021.04 월","2746","5449","2587","2862",
"수정5동","총인구","2021.05 월","2740","5435","2578","2857",
"수정5동","총인구","2021.06 월","2735","5417","2572","2845",
"수정5동","총인구","2021.07 월","2742","5409","2569","2840",
"수정5동","총인구","2021.08 월","2736","5387","2555","2832",
"수정5동","총인구","2021.09 월","2726","5366","2549","2817",
"수정5동","총인구","2021.10 월","2728","5372","2552","2820",
"수정5동","총인구","2021.11 월","2738","5374","2559","2815",
"수정5동","총인구","2021.12 월","2725","5327","2541","2786",
"수정5동","총인구","2022.01 월","2720","5319","2538","2781",
"수정5동","총인구","2022.02 월","2722","5314","2533","2781",
"수정5동","총인구","2022.03 월","2718","5301","2527","2774",
"수정5동","총인구","2022.04 월","2712","5268","2514","2754",
"수정5동","총인구","2022.05 월","2712","5241","2499","2742",
"수정5동","총인구","2022.06 월","2709","5229","2495","2734",
"수정5동","총인구","2022.07 월","2701","5184","2471","2713",
"수정5동","총인구","2022.08 월","2705","5163","2461","2702",
"수정5동","총인구","2022.09 월","2681","5130","2446","2684",
"수정5동","총인구","2022.10 월","2674","5104","2435","2669",
"수정5동","총인구","2022.11 월","2668","5091","2436","2655",
"수정5동","총인구","2022.12 월","2667","5080","2429","2651",
"수정5동","총인구","2023.01 월","2664","5056","2421","2635",
"수정5동","총인구","2023.02 월","2659","5023","2404","2619",
"수정5동","총인구","2023.03 월","2654","5005","2390","2615",
"수정5동","총인구","2023.04 월","2658","4995","2380","2615",
"수정5동","총인구","2023.05 월","2653","4990","2379","2611",
"수정5동","총인구","2023.06 월","2656","4971","2367","2604",
"수정5동","총인구","2023.07 월","2650","4947","2357","2590",
"수정5동","총인구","2023.08 월","2631","4903","2334","2569",
"수정5동","총인구","2023.09 월","2630","4895","2328","2567",
"수정5동","총인구","2023.10 월","2629","4883","2334","2549",
"수정5동","총인구","2023.11 월","2631","4869","2327","2542",
"수정5동","총인구","2023.12 월","2622","4843","2316","2527",
"수정5동","총인구","2024.01 월","2618","4822","2299","2523",
"수정5동","총인구","2024.02 월","2612","4805","2287","2518",
"수정5동","총인구","2024.03 월","2601","4782","2276","2506",
"수정5동","총인구","2024.04 월","2603","4766","2267","2499",
"수정5동","총인구","2024.05 월","2595","4760","2256","2504",
"수정5동","총인구","2024.06 월","2587","4740","2247","2493",
"수정5동","총인구","2024.07 월","2591","4749","2250","2499",
"수정5동","총인구","2024.08 월","2587","4723","2243","2480",
"수정5동","총인구","2024.09 월","2585","4708","2236","2472",
"수정5동","총인구","2024.10 월","2579","4696","2234","2462",
"수정5동","총인구","2024.11 월","2579","4686","2233","2453",
"수정5동","총인구","2024.12 월","2574","4658","2222","2436",
"좌천동","총인구","2020.01 월","5496","11539","5576","5963",
"좌천동","총인구","2020.02 월","5488","11504","5579","5925",
"좌천동","총인구","2020.03 월","5479","11432","5543","5889",
"좌천동","총인구","2020.04 월","5457","11375","5505","5870",
"좌천동","총인구","2020.05 월","5457","11321","5480","5841",
"좌천동","총인구","2020.06 월","5462","11299","5478","5821",
"좌천동","총인구","2020.07 월","5461","11294","5478","5816",
"좌천동","총인구","2020.08 월","5454","11253","5452","5801",
"좌천동","총인구","2020.09 월","5447","11199","5417","5782",
"좌천동","총인구","2020.10 월","5445","11184","5401","5783",
"좌천동","총인구","2020.11 월","5437","11138","5387","5751",
"좌천동","총인구","2020.12 월","5441","11150","5399","5751",
"좌천동","총인구","2021.01 월","5447","11123","5399","5724",
"좌천동","총인구","2021.02 월","5463","11129","5394","5735",
"좌천동","총인구","2021.03 월","5412","11031","5350","5681",
"좌천동","총인구","2021.04 월","5409","11004","5337","5667",
"좌천동","총인구","2021.05 월","5389","10965","5310","5655",
"좌천동","총인구","2021.06 월","5394","10954","5310","5644",
"좌천동","총인구","2021.07 월","5374","10910","5282","5628",
"좌천동","총인구","2021.08 월","5385","10925","5294","5631",
"좌천동","총인구","2021.09 월","5388","10887","5277","5610",
"좌천동","총인구","2021.10 월","5392","10877","5273","5604",
"좌천동","총인구","2021.11 월","5392","10866","5261","5605",
"좌천동","총인구","2021.12 월","5398","10846","5250","5596",
"좌천동","총인구","2022.01 월","5499","11076","5360","5716",
"좌천동","총인구","2022.02 월","5679","11510","5584","5926",
"좌천동","총인구","2022.03 월","5789","11691","5677","6014",
"좌천동","총인구","2022.04 월","5835","11801","5723","6078",
"좌천동","총인구","2022.05 월","5871","11851","5743","6108",
"좌천동","총인구","2022.06 월","5897","11871","5755","6116",
"좌천동","총인구","2022.07 월","5900","11867","5752","6115",
"좌천동","총인구","2022.08 월","5920","11886","5756","6130",
"좌천동","총인구","2022.09 월","5877","11813","5731","6082",
"좌천동","총인구","2022.10 월","5876","11781","5713","6068",
"좌천동","총인구","2022.11 월","5870","11773","5702","6071",
"좌천동","총인구","2022.12 월","5861","11734","5686","6048",
"좌천동","총인구","2023.01 월","5865","11742","5696","6046",
"좌천동","총인구","2023.02 월","5855","11689","5669","6020",
"좌천동","총인구","2023.03 월","5858","11677","5662","6015",
"좌천동","총인구","2023.04 월","5848","11642","5639","6003",
"좌천동","총인구","2023.05 월","5849","11632","5632","6000",
"좌천동","총인구","2023.06 월","5844","11607","5614","5993",
"좌천동","총인구","2023.07 월","5837","11575","5589","5986",
"좌천동","총인구","2023.08 월","5824","11546","5574","5972",
"좌천동","총인구","2023.09 월","5812","11503","5551","5952",
"좌천동","총인구","2023.10 월","5800","11473","5525","5948",
"좌천동","총인구","2023.11 월","5790","11447","5513","5934",
"좌천동","총인구","2023.12 월","5780","11418","5493","5925",
"좌천동","총인구","2024.01 월","5778","11380","5472","5908",
"좌천동","총인구","2024.02 월","5771","11323","5444","5879",
"좌천동","총인구","2024.03 월","5763","11296","5433","5863",
"좌천동","총인구","2024.04 월","5761","11314","5439","5875",
"좌천동","총인구","2024.05 월","5763","11317","5450","5867",
"좌천동","총인구","2024.06 월","5757","11292","5433","5859",
"좌천동","총인구","2024.07 월","5756","11281","5435","5846",
"좌천동","총인구","2024.08 월","5752","11263","5423","5840",
"좌천동","총인구","2024.09 월","5749","11249","5421","5828",
"좌천동","총인구","2024.10 월","5734","11221","5404","5817",
"좌천동","총인구","2024.11 월","5715","11167","5371","5796",
"좌천동","총인구","2024.12 월","5706","11139","5354","5785",
"범일1동","총인구","2020.01 월","6252","12476","6152","6324",
"범일1동","총인구","2020.02 월","6256","12451","6131","6320",
"범일1동","총인구","2020.03 월","6269","12424","6098","6326",
"범일1동","총인구","2020.04 월","6261","12370","6076","6294",
"범일1동","총인구","2020.05 월","6265","12326","6065","6261",
"범일1동","총인구","2020.06 월","6270","12295","6034","6261",
"범일1동","총인구","2020.07 월","6269","12266","6012","6254",
"범일1동","총인구","2020.08 월","6277","12246","6000","6246",
"범일1동","총인구","2020.09 월","6276","12219","6005","6214",
"범일1동","총인구","2020.10 월","6273","12155","5979","6176",
"범일1동","총인구","2020.11 월","6259","12127","5972","6155",
"범일1동","총인구","2020.12 월","6243","12074","5934","6140",
"범일1동","총인구","2021.01 월","6250","12042","5920","6122",
"범일1동","총인구","2021.02 월","6256","12019","5901","6118",
"범일1동","총인구","2021.03 월","6126","11840","5820","6020",
"범일1동","총인구","2021.04 월","6127","11811","5806","6005",
"범일1동","총인구","2021.05 월","6118","11782","5795","5987",
"범일1동","총인구","2021.06 월","6118","11771","5781","5990",
"범일1동","총인구","2021.07 월","6165","11808","5792","6016",
"범일1동","총인구","2021.08 월","6229","11860","5822","6038",
"범일1동","총인구","2021.09 월","6249","11881","5834","6047",
"범일1동","총인구","2021.10 월","6258","11877","5842","6035",
"범일1동","총인구","2021.11 월","6286","11903","5852","6051",
"범일1동","총인구","2021.12 월","6278","11862","5841","6021",
"범일1동","총인구","2022.01 월","6282","11835","5816","6019",
"범일1동","총인구","2022.02 월","6295","11810","5797","6013",
"범일1동","총인구","2022.03 월","6302","11778","5777","6001",
"범일1동","총인구","2022.04 월","6308","11774","5776","5998",
"범일1동","총인구","2022.05 월","6299","11754","5769","5985",
"범일1동","총인구","2022.06 월","6298","11720","5752","5968",
"범일1동","총인구","2022.07 월","6284","11699","5745","5954",
"범일1동","총인구","2022.08 월","6279","11678","5736","5942",
"범일1동","총인구","2022.09 월","6251","11616","5712","5904",
"범일1동","총인구","2022.10 월","6258","11583","5695","5888",
"범일1동","총인구","2022.11 월","6242","11537","5671","5866",
"범일1동","총인구","2022.12 월","6226","11487","5632","5855",
"범일1동","총인구","2023.01 월","6221","11470","5624","5846",
"범일1동","총인구","2023.02 월","6220","11429","5594","5835",
"범일1동","총인구","2023.03 월","6211","11408","5590","5818",
"범일1동","총인구","2023.04 월","6207","11369","5561","5808",
"범일1동","총인구","2023.05 월","6227","11376","5556","5820",
"범일1동","총인구","2023.06 월","6225","11332","5532","5800",
"범일1동","총인구","2023.07 월","6205","11266","5494","5772",
"범일1동","총인구","2023.08 월","6191","11202","5462","5740",
"범일1동","총인구","2023.09 월","6173","11162","5432","5730",
"범일1동","총인구","2023.10 월","6157","11115","5408","5707",
"범일1동","총인구","2023.11 월","6150","11090","5392","5698",
"범일1동","총인구","2023.12 월","6138","11057","5368","5689",
"범일1동","총인구","2024.01 월","6117","10990","5331","5659",
"범일1동","총인구","2024.02 월","6105","10947","5321","5626",
"범일1동","총인구","2024.03 월","6088","10880","5292","5588",
"범일1동","총인구","2024.04 월","6062","10839","5260","5579",
"범일1동","총인구","2024.05 월","6064","10790","5239","5551",
"범일1동","총인구","2024.06 월","6047","10752","5220","5532",
"범일1동","총인구","2024.07 월","6044","10726","5203","5523",
"범일1동","총인구","2024.08 월","6042","10696","5178","5518",
"범일1동","총인구","2024.09 월","6026","10685","5173","5512",
"범일1동","총인구","2024.10 월","6007","10637","5145","5492",
"범일1동","총인구","2024.11 월","5994","10599","5118","5481",
"범일1동","총인구","2024.12 월","5986","10558","5089","5469",
"범일2동","총인구","2020.01 월","4576","9092","4575","4517",
"범일2동","총인구","2020.02 월","4599","9112","4578","4534",
"범일2동","총인구","2020.03 월","4613","9128","4601","4527",
"범일2동","총인구","2020.04 월","4617","9107","4589","4518",
"범일2동","총인구","2020.05 월","4624","9075","4563","4512",
"범일2동","총인구","2020.06 월","4631","9036","4543","4493",
"범일2동","총인구","2020.07 월","4630","9001","4529","4472",
"범일2동","총인구","2020.08 월","4601","8962","4519","4443",
"범일2동","총인구","2020.09 월","4602","8937","4514","4423",
"범일2동","총인구","2020.10 월","4607","8905","4487","4418",
"범일2동","총인구","2020.11 월","4611","8848","4464","4384",
"범일2동","총인구","2020.12 월","4613","8819","4446","4373",
"범일2동","총인구","2021.01 월","4619","8805","4452","4353",
"범일2동","총인구","2021.02 월","4612","8780","4434","4346",
"범일2동","총인구","2021.03 월","4576","8701","4400","4301",
"범일2동","총인구","2021.04 월","4558","8628","4355","4273",
"범일2동","총인구","2021.05 월","4499","8482","4278","4204",
"범일2동","총인구","2021.06 월","4398","8265","4164","4101",
"범일2동","총인구","2021.07 월","4314","8079","4064","4015",
"범일2동","총인구","2021.08 월","4235","7894","3976","3918",
"범일2동","총인구","2021.09 월","4202","7816","3948","3868",
"범일2동","총인구","2021.10 월","4181","7771","3919","3852",
"범일2동","총인구","2021.11 월","4219","7802","3941","3861",
"범일2동","총인구","2021.12 월","4361","7939","3987","3952",
"범일2동","총인구","2022.01 월","4452","8017","4021","3996",
"범일2동","총인구","2022.02 월","4479","8026","4023","4003",
"범일2동","총인구","2022.03 월","4499","8051","4027","4024",
"범일2동","총인구","2022.04 월","4496","8036","4020","4016",
"범일2동","총인구","2022.05 월","4504","8040","4009","4031",
"범일2동","총인구","2022.06 월","4511","8046","4023","4023",
"범일2동","총인구","2022.07 월","4492","8013","4010","4003",
"범일2동","총인구","2022.08 월","4495","7995","3996","3999",
"범일2동","총인구","2022.09 월","4463","7970","3989","3981",
"범일2동","총인구","2022.10 월","4471","7955","3987","3968",
"범일2동","총인구","2022.11 월","4467","7941","3984","3957",
"범일2동","총인구","2022.12 월","4465","7918","3967","3951",
"범일2동","총인구","2023.01 월","4464","7906","3966","3940",
"범일2동","총인구","2023.02 월","4441","7846","3926","3920",
"범일2동","총인구","2023.03 월","4456","7868","3933","3935",
"범일2동","총인구","2023.04 월","4462","7859","3927","3932",
"범일2동","총인구","2023.05 월","4462","7851","3922","3929",
"범일2동","총인구","2023.06 월","4431","7777","3889","3888",
"범일2동","총인구","2023.07 월","4415","7734","3868","3866",
"범일2동","총인구","2023.08 월","4405","7727","3862","3865",
"범일2동","총인구","2023.09 월","4396","7711","3867","3844",
"범일2동","총인구","2023.10 월","4396","7680","3855","3825",
"범일2동","총인구","2023.11 월","4392","7667","3847","3820",
"범일2동","총인구","2023.12 월","4376","7614","3810","3804",
"범일2동","총인구","2024.01 월","4364","7588","3774","3814",
"범일2동","총인구","2024.02 월","4390","7590","3780","3810",
"범일2동","총인구","2024.03 월","4396","7589","3785","3804",
"범일2동","총인구","2024.04 월","4373","7524","3747","3777",
"범일2동","총인구","2024.05 월","4344","7453","3711","3742",
"범일2동","총인구","2024.06 월","4315","7373","3659","3714",
"범일2동","총인구","2024.07 월","4293","7340","3650","3690",
"범일2동","총인구","2024.08 월","4280","7304","3630","3674",
"범일2동","총인구","2024.09 월","4259","7274","3623","3651",
"범일2동","총인구","2024.10 월","4239","7217","3606","3611",
"범일2동","총인구","2024.11 월","4226","7211","3597","3614",
"범일2동","총인구","2024.12 월","4216","7180","3573","3607",
"범일5동","총인구","2020.01 월","2249","4656","2293","2363",
"범일5동","총인구","2020.02 월","2248","4652","2292","2360",
"범일5동","총인구","2020.03 월","2240","4647","2293","2354",
"범일5동","총인구","2020.04 월","2233","4643","2283","2360",
"범일5동","총인구","2020.05 월","2239","4632","2279","2353",
"범일5동","총인구","2020.06 월","2245","4631","2280","2351",
"범일5동","총인구","2020.07 월","2246","4635","2284","2351",
"범일5동","총인구","2020.08 월","2244","4615","2267","2348",
"범일5동","총인구","2020.09 월","2243","4610","2262","2348",
"범일5동","총인구","2020.10 월","2232","4580","2242","2338",
"범일5동","총인구","2020.11 월","2230","4573","2230","2343",
"범일5동","총인구","2020.12 월","2238","4586","2237","2349",
"범일5동","총인구","2021.01 월","2259","4607","2247","2360",
"범일5동","총인구","2021.02 월","2263","4616","2243","2373",
"범일5동","총인구","2021.03 월","2155","4489","2201","2288",
"범일5동","총인구","2021.04 월","2157","4471","2202","2269",
"범일5동","총인구","2021.05 월","2157","4435","2183","2252",
"범일5동","총인구","2021.06 월","2158","4427","2175","2252",
"범일5동","총인구","2021.07 월","2159","4413","2164","2249",
"범일5동","총인구","2021.08 월","2148","4396","2159","2237",
"범일5동","총인구","2021.09 월","2148","4385","2159","2226",
"범일5동","총인구","2021.10 월","2147","4393","2160","2233",
"범일5동","총인구","2021.11 월","2147","4384","2162","2222",
"범일5동","총인구","2021.12 월","2142","4361","2151","2210",
"범일5동","총인구","2022.01 월","2140","4342","2142","2200",
"범일5동","총인구","2022.02 월","2131","4322","2134","2188",
"범일5동","총인구","2022.03 월","2127","4308","2130","2178",
"범일5동","총인구","2022.04 월","2125","4306","2126","2180",
"범일5동","총인구","2022.05 월","2121","4296","2116","2180",
"범일5동","총인구","2022.06 월","2122","4278","2107","2171",
"범일5동","총인구","2022.07 월","2114","4275","2104","2171",
"범일5동","총인구","2022.08 월","2109","4258","2094","2164",
"범일5동","총인구","2022.09 월","2091","4244","2083","2161",
"범일5동","총인구","2022.10 월","2097","4247","2077","2170",
"범일5동","총인구","2022.11 월","2086","4239","2074","2165",
"범일5동","총인구","2022.12 월","2087","4236","2076","2160",
"범일5동","총인구","2023.01 월","2087","4238","2079","2159",
"범일5동","총인구","2023.02 월","2081","4225","2071","2154",
"범일5동","총인구","2023.03 월","2084","4217","2069","2148",
"범일5동","총인구","2023.04 월","2087","4220","2067","2153",
"범일5동","총인구","2023.05 월","2104","4240","2076","2164",
"범일5동","총인구","2023.06 월","2855","5898","2914","2984",
"범일5동","총인구","2023.07 월","3430","7139","3521","3618",
"범일5동","총인구","2023.08 월","3725","7766","3826","3940",
"범일5동","총인구","2023.09 월","3869","8047","3964","4083",
"범일5동","총인구","2023.10 월","3959","8305","4100","4205",
"범일5동","총인구","2023.11 월","4014","8421","4149","4272",
"범일5동","총인구","2023.12 월","4043","8519","4195","4324",
"범일5동","총인구","2024.01 월","4058","8587","4231","4356",
"범일5동","총인구","2024.02 월","4087","8636","4260","4376",
"범일5동","총인구","2024.03 월","4096","8677","4283","4394",
"범일5동","총인구","2024.04 월","4115","8727","4303","4424",
"범일5동","총인구","2024.05 월","4118","8754","4299","4455",
"범일5동","총인구","2024.06 월","4122","8776","4317","4459",
"범일5동","총인구","2024.07 월","4130","8804","4321","4483",
"범일5동","총인구","2024.08 월","4104","8783","4314","4469",
"범일5동","총인구","2024.09 월","4064","8721","4282","4439",
"범일5동","총인구","2024.10 월","4112","8798","4315","4483",
"범일5동","총인구","2024.11 월","4144","8865","4345","4520",
"범일5동","총인구","2024.12 월","4159","8883","4362","4521",
"영도구","총인구","2020.01 월","54852","118353","58647","59706",
"영도구","총인구","2020.02 월","54824","118055","58463","59592",
"영도구","총인구","2020.03 월","54837","117765","58299","59466",
"영도구","총인구","2020.04 월","54812","117469","58138","59331",
"영도구","총인구","2020.05 월","54884","117176","57970","59206",
"영도구","총인구","2020.06 월","54866","116896","57795","59101",
"영도구","총인구","2020.07 월","54914","116752","57748","59004",
"영도구","총인구","2020.08 월","54870","116477","57634","58843",
"영도구","총인구","2020.09 월","54896","116212","57502","58710",
"영도구","총인구","2020.10 월","54876","115850","57320","58530",
"영도구","총인구","2020.11 월","54896","115513","57142","58371",
"영도구","총인구","2020.12 월","54903","115144","56953","58191",
"영도구","총인구","2021.01 월","54905","114844","56803","58041",
"영도구","총인구","2021.02 월","54936","114636","56704","57932",
"영도구","총인구","2021.03 월","54048","113332","56124","57208",
"영도구","총인구","2021.04 월","54141","113204","56078","57126",
"영도구","총인구","2021.05 월","54388","113378","56123","57255",
"영도구","총인구","2021.06 월","54568","113510","56185","57325",
"영도구","총인구","2021.07 월","54643","113411","56127","57284",
"영도구","총인구","2021.08 월","54681","113193","55995","57198",
"영도구","총인구","2021.09 월","54701","113026","55895","57131",
"영도구","총인구","2021.10 월","54721","112928","55813","57115",
"영도구","총인구","2021.11 월","54721","112715","55720","56995",
"영도구","총인구","2021.12 월","54659","112451","55576","56875",
"영도구","총인구","2022.01 월","54609","112237","55482","56755",
"영도구","총인구","2022.02 월","54560","111807","55305","56502",
"영도구","총인구","2022.03 월","54518","111479","55151","56328",
"영도구","총인구","2022.04 월","54478","111254","55011","56243",
"영도구","총인구","2022.05 월","54650","111321","55051","56270",
"영도구","총인구","2022.06 월","54700","111307","55055","56252",
"영도구","총인구","2022.07 월","54725","111271","55039","56232",
"영도구","총인구","2022.08 월","54711","111100","54973","56127",
"영도구","총인구","2022.09 월","54474","110813","54787","56026",
"영도구","총인구","2022.10 월","54440","110574","54641","55933",
"영도구","총인구","2022.11 월","54362","110386","54570","55816",
"영도구","총인구","2022.12 월","54342","110254","54498","55756",
"영도구","총인구","2023.01 월","54304","110063","54398","55665",
"영도구","총인구","2023.02 월","54322","109865","54304","55561",
"영도구","총인구","2023.03 월","54335","109774","54241","55533",
"영도구","총인구","2023.04 월","54299","109553","54131","55422",
"영도구","총인구","2023.05 월","54248","109412","54070","55342",
"영도구","총인구","2023.06 월","54218","109255","54008","55247",
"영도구","총인구","2023.07 월","54342","109483","54109","55374",
"영도구","총인구","2023.08 월","54409","109437","54102","55335",
"영도구","총인구","2023.09 월","54425","109350","54024","55326",
"영도구","총인구","2023.10 월","54373","109329","54036","55293",
"영도구","총인구","2023.11 월","54325","109301","54045","55256",
"영도구","총인구","2023.12 월","54293","109151","53978","55173",
"영도구","총인구","2024.01 월","54249","108959","53885","55074",
"영도구","총인구","2024.02 월","54309","108852","53832","55020",
"영도구","총인구","2024.03 월","54364","108766","53811","54955",
"영도구","총인구","2024.04 월","54312","108529","53665","54864",
"영도구","총인구","2024.05 월","54267","108336","53555","54781",
"영도구","총인구","2024.06 월","54167","108128","53468","54660",
"영도구","총인구","2024.07 월","54105","107824","53330","54494",
"영도구","총인구","2024.08 월","54052","107603","53246","54357",
"영도구","총인구","2024.09 월","53973","107397","53162","54235",
"영도구","총인구","2024.10 월","53837","107057","52990","54067",
"영도구","총인구","2024.11 월","53721","106744","52839","53905",
"영도구","총인구","2024.12 월","53659","106515","52704","53811",
"남항동","총인구","2020.01 월","5432","11294","5803","5491",
"남항동","총인구","2020.02 월","5448","11307","5810","5497",
"남항동","총인구","2020.03 월","5454","11306","5792","5514",
"남항동","총인구","2020.04 월","5461","11275","5768","5507",
"남항동","총인구","2020.05 월","5472","11252","5748","5504",
"남항동","총인구","2020.06 월","5485","11272","5758","5514",
"남항동","총인구","2020.07 월","5496","11265","5772","5493",
"남항동","총인구","2020.08 월","5516","11288","5791","5497",
"남항동","총인구","2020.09 월","5541","11320","5809","5511",
"남항동","총인구","2020.10 월","5575","11373","5832","5541",
"남항동","총인구","2020.11 월","5600","11398","5837","5561",
"남항동","총인구","2020.12 월","5625","11424","5841","5583",
"남항동","총인구","2021.01 월","5652","11446","5849","5597",
"남항동","총인구","2021.02 월","5678","11462","5853","5609",
"남항동","총인구","2021.03 월","5582","11359","5801","5558",
"남항동","총인구","2021.04 월","5640","11390","5815","5575",
"남항동","총인구","2021.05 월","5643","11290","5770","5520",
"남항동","총인구","2021.06 월","5647","11281","5773","5508",
"남항동","총인구","2021.07 월","5651","11259","5769","5490",
"남항동","총인구","2021.08 월","5660","11263","5772","5491",
"남항동","총인구","2021.09 월","5663","11270","5773","5497",
"남항동","총인구","2021.10 월","5684","11291","5783","5508",
"남항동","총인구","2021.11 월","5701","11293","5786","5507",
"남항동","총인구","2021.12 월","5706","11294","5790","5504",
"남항동","총인구","2022.01 월","5719","11307","5793","5514",
"남항동","총인구","2022.02 월","5730","11312","5808","5504",
"남항동","총인구","2022.03 월","5737","11300","5807","5493",
"남항동","총인구","2022.04 월","5749","11330","5828","5502",
"남항동","총인구","2022.05 월","5778","11323","5837","5486",
"남항동","총인구","2022.06 월","5774","11312","5833","5479",
"남항동","총인구","2022.07 월","5770","11284","5816","5468",
"남항동","총인구","2022.08 월","5778","11277","5818","5459",
"남항동","총인구","2022.09 월","5738","11223","5798","5425",
"남항동","총인구","2022.10 월","5719","11179","5773","5406",
"남항동","총인구","2022.11 월","5706","11149","5773","5376",
"남항동","총인구","2022.12 월","5697","11156","5768","5388",
"남항동","총인구","2023.01 월","5704","11171","5785","5386",
"남항동","총인구","2023.02 월","5696","11114","5754","5360",
"남항동","총인구","2023.03 월","5685","11096","5742","5354",
"남항동","총인구","2023.04 월","5677","11070","5722","5348",
"남항동","총인구","2023.05 월","5677","11030","5692","5338",
"남항동","총인구","2023.06 월","5660","11002","5677","5325",
"남항동","총인구","2023.07 월","5661","11007","5675","5332",
"남항동","총인구","2023.08 월","5655","10998","5674","5324",
"남항동","총인구","2023.09 월","5632","10942","5637","5305",
"남항동","총인구","2023.10 월","5630","10908","5618","5290",
"남항동","총인구","2023.11 월","5623","10886","5615","5271",
"남항동","총인구","2023.12 월","5636","10881","5608","5273",
"남항동","총인구","2024.01 월","5630","10840","5600","5240",
"남항동","총인구","2024.02 월","5627","10810","5585","5225",
"남항동","총인구","2024.03 월","5621","10788","5575","5213",
"남항동","총인구","2024.04 월","5623","10769","5565","5204",
"남항동","총인구","2024.05 월","5602","10741","5553","5188",
"남항동","총인구","2024.06 월","5585","10750","5551","5199",
"남항동","총인구","2024.07 월","5588","10738","5540","5198",
"남항동","총인구","2024.08 월","5577","10699","5526","5173",
"남항동","총인구","2024.09 월","5563","10657","5513","5144",
"남항동","총인구","2024.10 월","5533","10626","5494","5132",
"남항동","총인구","2024.11 월","5526","10594","5475","5119",
"남항동","총인구","2024.12 월","5521","10564","5448","5116",
"영선1동","총인구","2020.01 월","1876","4295","2109","2186",
"영선1동","총인구","2020.02 월","1890","4305","2111","2194",
"영선1동","총인구","2020.03 월","1881","4290","2107","2183",
"영선1동","총인구","2020.04 월","1882","4272","2091","2181",
"영선1동","총인구","2020.05 월","1899","4280","2099","2181",
"영선1동","총인구","2020.06 월","1911","4272","2095","2177",
"영선1동","총인구","2020.07 월","1911","4261","2093","2168",
"영선1동","총인구","2020.08 월","1909","4256","2098","2158",
"영선1동","총인구","2020.09 월","1926","4280","2110","2170",
"영선1동","총인구","2020.10 월","1926","4268","2100","2168",
"영선1동","총인구","2020.11 월","1927","4256","2092","2164",
"영선1동","총인구","2020.12 월","1937","4263","2092","2171",
"영선1동","총인구","2021.01 월","1949","4273","2092","2181",
"영선1동","총인구","2021.02 월","1960","4262","2088","2174",
"영선1동","총인구","2021.03 월","1910","4185","2046","2139",
"영선1동","총인구","2021.04 월","1902","4170","2037","2133",
"영선1동","총인구","2021.05 월","1894","4125","2015","2110",
"영선1동","총인구","2021.06 월","1885","4071","1984","2087",
"영선1동","총인구","2021.07 월","1898","4084","1993","2091",
"영선1동","총인구","2021.08 월","1895","4067","1976","2091",
"영선1동","총인구","2021.09 월","1901","4068","1974","2094",
"영선1동","총인구","2021.10 월","1898","4071","1978","2093",
"영선1동","총인구","2021.11 월","1909","4071","1987","2084",
"영선1동","총인구","2021.12 월","1916","4084","1991","2093",
"영선1동","총인구","2022.01 월","1916","4078","1994","2084",
"영선1동","총인구","2022.02 월","1917","4064","1983","2081",
"영선1동","총인구","2022.03 월","1917","4058","1980","2078",
"영선1동","총인구","2022.04 월","1912","4033","1965","2068",
"영선1동","총인구","2022.05 월","1916","4034","1965","2069",
"영선1동","총인구","2022.06 월","1906","4007","1951","2056",
"영선1동","총인구","2022.07 월","1906","4005","1952","2053",
"영선1동","총인구","2022.08 월","1896","3986","1943","2043",
"영선1동","총인구","2022.09 월","1885","3958","1927","2031",
"영선1동","총인구","2022.10 월","1881","3955","1925","2030",
"영선1동","총인구","2022.11 월","1882","3951","1920","2031",
"영선1동","총인구","2022.12 월","1884","3967","1933","2034",
"영선1동","총인구","2023.01 월","1885","3944","1923","2021",
"영선1동","총인구","2023.02 월","1887","3938","1918","2020",
"영선1동","총인구","2023.03 월","1889","3917","1904","2013",
"영선1동","총인구","2023.04 월","1887","3913","1902","2011",
"영선1동","총인구","2023.05 월","1893","3933","1914","2019",
"영선1동","총인구","2023.06 월","1886","3916","1909","2007",
"영선1동","총인구","2023.07 월","1872","3889","1886","2003",
"영선1동","총인구","2023.08 월","1867","3856","1876","1980",
"영선1동","총인구","2023.09 월","1855","3836","1860","1976",
"영선1동","총인구","2023.10 월","1843","3818","1847","1971",
"영선1동","총인구","2023.11 월","1845","3823","1858","1965",
"영선1동","총인구","2023.12 월","1835","3809","1859","1950",
"영선1동","총인구","2024.01 월","1835","3807","1855","1952",
"영선1동","총인구","2024.02 월","1840","3809","1852","1957",
"영선1동","총인구","2024.03 월","1832","3782","1841","1941",
"영선1동","총인구","2024.04 월","1821","3770","1824","1946",
"영선1동","총인구","2024.05 월","1829","3767","1824","1943",
"영선1동","총인구","2024.06 월","1829","3779","1838","1941",
"영선1동","총인구","2024.07 월","1824","3764","1827","1937",
"영선1동","총인구","2024.08 월","1825","3755","1821","1934",
"영선1동","총인구","2024.09 월","1824","3745","1818","1927",
"영선1동","총인구","2024.10 월","1819","3730","1818","1912",
"영선1동","총인구","2024.11 월","1821","3737","1823","1914",
"영선1동","총인구","2024.12 월","1822","3743","1820","1923",
"영선2동","총인구","2020.01 월","4043","9216","4520","4696",
"영선2동","총인구","2020.02 월","4047","9200","4501","4699",
"영선2동","총인구","2020.03 월","4040","9153","4472","4681",
"영선2동","총인구","2020.04 월","4034","9135","4460","4675",
"영선2동","총인구","2020.05 월","4035","9142","4464","4678",
"영선2동","총인구","2020.06 월","4034","9129","4446","4683",
"영선2동","총인구","2020.07 월","4044","9117","4442","4675",
"영선2동","총인구","2020.08 월","4038","9083","4425","4658",
"영선2동","총인구","2020.09 월","4037","9050","4406","4644",
"영선2동","총인구","2020.10 월","4023","8996","4378","4618",
"영선2동","총인구","2020.11 월","4027","8960","4360","4600",
"영선2동","총인구","2020.12 월","4011","8897","4328","4569",
"영선2동","총인구","2021.01 월","4001","8863","4302","4561",
"영선2동","총인구","2021.02 월","4008","8856","4304","4552",
"영선2동","총인구","2021.03 월","3907","8719","4237","4482",
"영선2동","총인구","2021.04 월","3919","8708","4232","4476",
"영선2동","총인구","2021.05 월","3907","8613","4185","4428",
"영선2동","총인구","2021.06 월","3900","8570","4175","4395",
"영선2동","총인구","2021.07 월","3895","8544","4157","4387",
"영선2동","총인구","2021.08 월","3880","8512","4135","4377",
"영선2동","총인구","2021.09 월","3879","8497","4133","4364",
"영선2동","총인구","2021.10 월","3863","8454","4104","4350",
"영선2동","총인구","2021.11 월","3859","8436","4099","4337",
"영선2동","총인구","2021.12 월","3848","8401","4083","4318",
"영선2동","총인구","2022.01 월","3835","8376","4075","4301",
"영선2동","총인구","2022.02 월","3827","8332","4059","4273",
"영선2동","총인구","2022.03 월","3820","8285","4039","4246",
"영선2동","총인구","2022.04 월","3808","8237","4012","4225",
"영선2동","총인구","2022.05 월","3800","8210","4003","4207",
"영선2동","총인구","2022.06 월","3784","8189","3991","4198",
"영선2동","총인구","2022.07 월","3787","8184","3993","4191",
"영선2동","총인구","2022.08 월","3746","8098","3955","4143",
"영선2동","총인구","2022.09 월","3740","8062","3938","4124",
"영선2동","총인구","2022.10 월","3736","8034","3915","4119",
"영선2동","총인구","2022.11 월","3713","7993","3897","4096",
"영선2동","총인구","2022.12 월","3713","7964","3890","4074",
"영선2동","총인구","2023.01 월","3706","7947","3874","4073",
"영선2동","총인구","2023.02 월","3695","7935","3864","4071",
"영선2동","총인구","2023.03 월","3687","7912","3852","4060",
"영선2동","총인구","2023.04 월","3671","7885","3840","4045",
"영선2동","총인구","2023.05 월","3657","7852","3821","4031",
"영선2동","총인구","2023.06 월","3657","7844","3816","4028",
"영선2동","총인구","2023.07 월","3644","7817","3808","4009",
"영선2동","총인구","2023.08 월","3636","7778","3792","3986",
"영선2동","총인구","2023.09 월","3626","7758","3774","3984",
"영선2동","총인구","2023.10 월","3605","7703","3751","3952",
"영선2동","총인구","2023.11 월","3600","7677","3732","3945",
"영선2동","총인구","2023.12 월","3589","7635","3709","3926",
"영선2동","총인구","2024.01 월","3592","7642","3712","3930",
"영선2동","총인구","2024.02 월","3575","7581","3691","3890",
"영선2동","총인구","2024.03 월","3583","7587","3697","3890",
"영선2동","총인구","2024.04 월","3573","7548","3671","3877",
"영선2동","총인구","2024.05 월","3574","7541","3673","3868",
"영선2동","총인구","2024.06 월","3553","7490","3646","3844",
"영선2동","총인구","2024.07 월","3540","7469","3631","3838",
"영선2동","총인구","2024.08 월","3524","7426","3607","3819",
"영선2동","총인구","2024.09 월","3513","7408","3601","3807",
"영선2동","총인구","2024.10 월","3503","7386","3590","3796",
"영선2동","총인구","2024.11 월","3492","7367","3574","3793",
"영선2동","총인구","2024.12 월","3494","7349","3558","3791",
"신선동","총인구","2020.01 월","5026","9606","4823","4783",
"신선동","총인구","2020.02 월","5014","9558","4796","4762",
"신선동","총인구","2020.03 월","5014","9532","4770","4762",
"신선동","총인구","2020.04 월","5007","9518","4758","4760",
"신선동","총인구","2020.05 월","5007","9478","4744","4734",
"신선동","총인구","2020.06 월","4987","9434","4717","4717",
"신선동","총인구","2020.07 월","4975","9378","4697","4681",
"신선동","총인구","2020.08 월","4972","9341","4681","4660",
"신선동","총인구","2020.09 월","4973","9312","4672","4640",
"신선동","총인구","2020.10 월","4958","9257","4641","4616",
"신선동","총인구","2020.11 월","4943","9197","4611","4586",
"신선동","총인구","2020.12 월","4930","9135","4576","4559",
"신선동","총인구","2021.01 월","4921","9100","4557","4543",
"신선동","총인구","2021.02 월","4916","9063","4537","4526",
"신선동","총인구","2021.03 월","4738","8823","4433","4390",
"신선동","총인구","2021.04 월","4732","8768","4406","4362",
"신선동","총인구","2021.05 월","4701","8697","4365","4332",
"신선동","총인구","2021.06 월","4688","8637","4337","4300",
"신선동","총인구","2021.07 월","4663","8563","4305","4258",
"신선동","총인구","2021.08 월","4649","8527","4283","4244",
"신선동","총인구","2021.09 월","4628","8486","4256","4230",
"신선동","총인구","2021.10 월","4629","8455","4246","4209",
"신선동","총인구","2021.11 월","4624","8427","4230","4197",
"신선동","총인구","2021.12 월","4605","8368","4203","4165",
"신선동","총인구","2022.01 월","4589","8326","4181","4145",
"신선동","총인구","2022.02 월","4566","8258","4146","4112",
"신선동","총인구","2022.03 월","4558","8229","4129","4100",
"신선동","총인구","2022.04 월","4549","8199","4105","4094",
"신선동","총인구","2022.05 월","4552","8172","4100","4072",
"신선동","총인구","2022.06 월","4533","8130","4075","4055",
"신선동","총인구","2022.07 월","4534","8101","4061","4040",
"신선동","총인구","2022.08 월","4512","8050","4040","4010",
"신선동","총인구","2022.09 월","4479","7999","4012","3987",
"신선동","총인구","2022.10 월","4474","7958","3988","3970",
"신선동","총인구","2022.11 월","4449","7907","3954","3953",
"신선동","총인구","2022.12 월","4430","7863","3928","3935",
"신선동","총인구","2023.01 월","4420","7838","3920","3918",
"신선동","총인구","2023.02 월","4412","7809","3904","3905",
"신선동","총인구","2023.03 월","4402","7776","3878","3898",
"신선동","총인구","2023.04 월","4376","7720","3854","3866",
"신선동","총인구","2023.05 월","4353","7680","3828","3852",
"신선동","총인구","2023.06 월","4340","7643","3808","3835",
"신선동","총인구","2023.07 월","4325","7603","3786","3817",
"신선동","총인구","2023.08 월","4317","7567","3767","3800",
"신선동","총인구","2023.09 월","4312","7537","3755","3782",
"신선동","총인구","2023.10 월","4294","7499","3733","3766",
"신선동","총인구","2023.11 월","4266","7462","3717","3745",
"신선동","총인구","2023.12 월","4248","7420","3694","3726",
"신선동","총인구","2024.01 월","4231","7379","3667","3712",
"신선동","총인구","2024.02 월","4211","7333","3643","3690",
"신선동","총인구","2024.03 월","4211","7305","3626","3679",
"신선동","총인구","2024.04 월","4196","7269","3607","3662",
"신선동","총인구","2024.05 월","4194","7251","3597","3654",
"신선동","총인구","2024.06 월","4185","7216","3580","3636",
"신선동","총인구","2024.07 월","4169","7161","3562","3599",
"신선동","총인구","2024.08 월","4164","7140","3550","3590",
"신선동","총인구","2024.09 월","4140","7099","3528","3571",
"신선동","총인구","2024.10 월","4119","7043","3494","3549",
"신선동","총인구","2024.11 월","4094","6992","3468","3524",
"신선동","총인구","2024.12 월","4067","6929","3431","3498",
"봉래1동","총인구","2020.01 월","3527","7559","3745","3814",
"봉래1동","총인구","2020.02 월","3524","7535","3734","3801",
"봉래1동","총인구","2020.03 월","3522","7506","3726","3780",
"봉래1동","총인구","2020.04 월","3523","7511","3727","3784",
"봉래1동","총인구","2020.05 월","3532","7493","3707","3786",
"봉래1동","총인구","2020.06 월","3531","7493","3702","3791",
"봉래1동","총인구","2020.07 월","3542","7510","3707","3803",
"봉래1동","총인구","2020.08 월","3538","7496","3696","3800",
"봉래1동","총인구","2020.09 월","3538","7462","3684","3778",
"봉래1동","총인구","2020.10 월","3545","7454","3683","3771",
"봉래1동","총인구","2020.11 월","3533","7423","3672","3751",
"봉래1동","총인구","2020.12 월","3527","7401","3664","3737",
"봉래1동","총인구","2021.01 월","3518","7376","3649","3727",
"봉래1동","총인구","2021.02 월","3510","7348","3638","3710",
"봉래1동","총인구","2021.03 월","3412","7221","3579","3642",
"봉래1동","총인구","2021.04 월","3415","7207","3568","3639",
"봉래1동","총인구","2021.05 월","3378","7047","3492","3555",
"봉래1동","총인구","2021.06 월","3366","6984","3461","3523",
"봉래1동","총인구","2021.07 월","3365","6964","3452","3512",
"봉래1동","총인구","2021.08 월","3369","6958","3461","3497",
"봉래1동","총인구","2021.09 월","3370","6918","3440","3478",
"봉래1동","총인구","2021.10 월","3351","6889","3427","3462",
"봉래1동","총인구","2021.11 월","3348","6871","3413","3458",
"봉래1동","총인구","2021.12 월","3337","6856","3413","3443",
"봉래1동","총인구","2022.01 월","3341","6853","3414","3439",
"봉래1동","총인구","2022.02 월","3338","6830","3409","3421",
"봉래1동","총인구","2022.03 월","3342","6817","3409","3408",
"봉래1동","총인구","2022.04 월","3333","6791","3399","3392",
"봉래1동","총인구","2022.05 월","3326","6764","3383","3381",
"봉래1동","총인구","2022.06 월","3325","6740","3376","3364",
"봉래1동","총인구","2022.07 월","3314","6716","3360","3356",
"봉래1동","총인구","2022.08 월","3305","6680","3347","3333",
"봉래1동","총인구","2022.09 월","3291","6659","3328","3331",
"봉래1동","총인구","2022.10 월","3290","6662","3334","3328",
"봉래1동","총인구","2022.11 월","3288","6659","3334","3325",
"봉래1동","총인구","2022.12 월","3286","6654","3331","3323",
"봉래1동","총인구","2023.01 월","3288","6644","3318","3326",
"봉래1동","총인구","2023.02 월","3287","6611","3307","3304",
"봉래1동","총인구","2023.03 월","3280","6579","3292","3287",
"봉래1동","총인구","2023.04 월","3265","6542","3273","3269",
"봉래1동","총인구","2023.05 월","3268","6533","3268","3265",
"봉래1동","총인구","2023.06 월","3277","6568","3284","3284",
"봉래1동","총인구","2023.07 월","3270","6530","3260","3270",
"봉래1동","총인구","2023.08 월","3259","6515","3251","3264",
"봉래1동","총인구","2023.09 월","3249","6492","3242","3250",
"봉래1동","총인구","2023.10 월","3235","6468","3238","3230",
"봉래1동","총인구","2023.11 월","3223","6438","3223","3215",
"봉래1동","총인구","2023.12 월","3221","6433","3224","3209",
"봉래1동","총인구","2024.01 월","3217","6433","3217","3216",
"봉래1동","총인구","2024.02 월","3214","6440","3226","3214",
"봉래1동","총인구","2024.03 월","3213","6424","3215","3209",
"봉래1동","총인구","2024.04 월","3207","6425","3222","3203",
"봉래1동","총인구","2024.05 월","3195","6412","3218","3194",
"봉래1동","총인구","2024.06 월","3197","6423","3225","3198",
"봉래1동","총인구","2024.07 월","3190","6400","3216","3184",
"봉래1동","총인구","2024.08 월","3198","6406","3221","3185",
"봉래1동","총인구","2024.09 월","3194","6394","3207","3187",
"봉래1동","총인구","2024.10 월","3189","6370","3189","3181",
"봉래1동","총인구","2024.11 월","3190","6367","3195","3172",
"봉래1동","총인구","2024.12 월","3183","6342","3180","3162",
"봉래2동","총인구","2020.01 월","2738","5502","2750","2752",
"봉래2동","총인구","2020.02 월","2747","5508","2743","2765",
"봉래2동","총인구","2020.03 월","2734","5473","2726","2747",
"봉래2동","총인구","2020.04 월","2728","5447","2718","2729",
"봉래2동","총인구","2020.05 월","2717","5412","2698","2714",
"봉래2동","총인구","2020.06 월","2712","5381","2676","2705",
"봉래2동","총인구","2020.07 월","2709","5378","2675","2703",
"봉래2동","총인구","2020.08 월","2712","5356","2662","2694",
"봉래2동","총인구","2020.09 월","2714","5329","2646","2683",
"봉래2동","총인구","2020.10 월","2704","5308","2635","2673",
"봉래2동","총인구","2020.11 월","2695","5289","2619","2670",
"봉래2동","총인구","2020.12 월","2703","5269","2606","2663",
"봉래2동","총인구","2021.01 월","2692","5232","2592","2640",
"봉래2동","총인구","2021.02 월","2697","5221","2586","2635",
"봉래2동","총인구","2021.03 월","2616","5123","2532","2591",
"봉래2동","총인구","2021.04 월","2651","5208","2574","2634",
"봉래2동","총인구","2021.05 월","3141","6588","3216","3372",
"봉래2동","총인구","2021.06 월","3429","7347","3581","3766",
"봉래2동","총인구","2021.07 월","3551","7644","3722","3922",
"봉래2동","총인구","2021.08 월","3596","7730","3758","3972",
"봉래2동","총인구","2021.09 월","3637","7811","3795","4016",
"봉래2동","총인구","2021.10 월","3677","7902","3844","4058",
"봉래2동","총인구","2021.11 월","3702","7935","3863","4072",
"봉래2동","총인구","2021.12 월","3711","7950","3867","4083",
"봉래2동","총인구","2022.01 월","3711","7945","3867","4078",
"봉래2동","총인구","2022.02 월","3700","7926","3856","4070",
"봉래2동","총인구","2022.03 월","3699","7919","3847","4072",
"봉래2동","총인구","2022.04 월","3703","7928","3853","4075",
"봉래2동","총인구","2022.05 월","3703","7888","3835","4053",
"봉래2동","총인구","2022.06 월","3686","7857","3823","4034",
"봉래2동","총인구","2022.07 월","3683","7838","3816","4022",
"봉래2동","총인구","2022.08 월","3666","7805","3800","4005",
"봉래2동","총인구","2022.09 월","3645","7785","3783","4002",
"봉래2동","총인구","2022.10 월","3634","7756","3772","3984",
"봉래2동","총인구","2022.11 월","3617","7707","3744","3963",
"봉래2동","총인구","2022.12 월","3600","7660","3729","3931",
"봉래2동","총인구","2023.01 월","3594","7649","3723","3926",
"봉래2동","총인구","2023.02 월","3584","7618","3706","3912",
"봉래2동","총인구","2023.03 월","3591","7629","3710","3919",
"봉래2동","총인구","2023.04 월","3594","7625","3707","3918",
"봉래2동","총인구","2023.05 월","3584","7597","3691","3906",
"봉래2동","총인구","2023.06 월","3574","7582","3678","3904",
"봉래2동","총인구","2023.07 월","3564","7550","3665","3885",
"봉래2동","총인구","2023.08 월","3547","7466","3628","3838",
"봉래2동","총인구","2023.09 월","3532","7429","3605","3824",
"봉래2동","총인구","2023.10 월","3533","7435","3610","3825",
"봉래2동","총인구","2023.11 월","3535","7438","3618","3820",
"봉래2동","총인구","2023.12 월","3525","7427","3613","3814",
"봉래2동","총인구","2024.01 월","3526","7424","3618","3806",
"봉래2동","총인구","2024.02 월","3517","7409","3612","3797",
"봉래2동","총인구","2024.03 월","3507","7380","3596","3784",
"봉래2동","총인구","2024.04 월","3504","7360","3585","3775",
"봉래2동","총인구","2024.05 월","3497","7357","3580","3777",
"봉래2동","총인구","2024.06 월","3477","7318","3560","3758",
"봉래2동","총인구","2024.07 월","3473","7297","3543","3754",
"봉래2동","총인구","2024.08 월","3468","7284","3540","3744",
"봉래2동","총인구","2024.09 월","3457","7255","3524","3731",
"봉래2동","총인구","2024.10 월","3459","7237","3518","3719",
"봉래2동","총인구","2024.11 월","3462","7230","3511","3719",
"봉래2동","총인구","2024.12 월","3452","7221","3506","3715",
"청학1동","총인구","2020.01 월","3339","7141","3510","3631",
"청학1동","총인구","2020.02 월","3319","7097","3487","3610",
"청학1동","총인구","2020.03 월","3305","7050","3452","3598",
"청학1동","총인구","2020.04 월","3292","7018","3435","3583",
"청학1동","총인구","2020.05 월","3290","6982","3414","3568",
"청학1동","총인구","2020.06 월","3287","6962","3401","3561",
"청학1동","총인구","2020.07 월","3290","6927","3391","3536",
"청학1동","총인구","2020.08 월","3274","6898","3370","3528",
"청학1동","총인구","2020.09 월","3263","6856","3348","3508",
"청학1동","총인구","2020.10 월","3260","6808","3319","3489",
"청학1동","총인구","2020.11 월","3254","6783","3308","3475",
"청학1동","총인구","2020.12 월","3263","6779","3305","3474",
"청학1동","총인구","2021.01 월","3258","6762","3302","3460",
"청학1동","총인구","2021.02 월","3248","6734","3290","3444",
"청학1동","총인구","2021.03 월","3106","6549","3223","3326",
"청학1동","총인구","2021.04 월","3119","6539","3224","3315",
"청학1동","총인구","2021.05 월","3093","6443","3176","3267",
"청학1동","총인구","2021.06 월","3081","6391","3145","3246",
"청학1동","총인구","2021.07 월","3052","6311","3109","3202",
"청학1동","총인구","2021.08 월","3046","6299","3103","3196",
"청학1동","총인구","2021.09 월","3039","6268","3086","3182",
"청학1동","총인구","2021.10 월","3031","6244","3073","3171",
"청학1동","총인구","2021.11 월","3019","6215","3056","3159",
"청학1동","총인구","2021.12 월","3014","6187","3043","3144",
"청학1동","총인구","2022.01 월","3009","6174","3039","3135",
"청학1동","총인구","2022.02 월","2995","6134","3010","3124",
"청학1동","총인구","2022.03 월","2995","6098","2996","3102",
"청학1동","총인구","2022.04 월","2994","6096","2994","3102",
"청학1동","총인구","2022.05 월","2981","6061","2978","3083",
"청학1동","총인구","2022.06 월","2975","6028","2969","3059",
"청학1동","총인구","2022.07 월","2964","6009","2957","3052",
"청학1동","총인구","2022.08 월","2935","5963","2928","3035",
"청학1동","총인구","2022.09 월","2929","5938","2918","3020",
"청학1동","총인구","2022.10 월","2912","5904","2899","3005",
"청학1동","총인구","2022.11 월","2904","5883","2898","2985",
"청학1동","총인구","2022.12 월","2897","5859","2877","2982",
"청학1동","총인구","2023.01 월","2892","5821","2853","2968",
"청학1동","총인구","2023.02 월","2881","5798","2845","2953",
"청학1동","총인구","2023.03 월","2879","5792","2839","2953",
"청학1동","총인구","2023.04 월","2872","5774","2829","2945",
"청학1동","총인구","2023.05 월","2871","5760","2826","2934",
"청학1동","총인구","2023.06 월","2865","5750","2826","2924",
"청학1동","총인구","2023.07 월","2855","5718","2807","2911",
"청학1동","총인구","2023.08 월","2849","5686","2793","2893",
"청학1동","총인구","2023.09 월","2842","5659","2775","2884",
"청학1동","총인구","2023.10 월","2826","5631","2760","2871",
"청학1동","총인구","2023.11 월","2809","5595","2742","2853",
"청학1동","총인구","2023.12 월","2796","5559","2720","2839",
"청학1동","총인구","2024.01 월","2787","5541","2709","2832",
"청학1동","총인구","2024.02 월","2778","5523","2699","2824",
"청학1동","총인구","2024.03 월","2755","5485","2680","2805",
"청학1동","총인구","2024.04 월","2759","5487","2688","2799",
"청학1동","총인구","2024.05 월","2742","5461","2670","2791",
"청학1동","총인구","2024.06 월","2741","5452","2670","2782",
"청학1동","총인구","2024.07 월","2741","5447","2672","2775",
"청학1동","총인구","2024.08 월","2740","5452","2679","2773",
"청학1동","총인구","2024.09 월","2720","5421","2665","2756",
"청학1동","총인구","2024.10 월","2708","5396","2652","2744",
"청학1동","총인구","2024.11 월","2691","5367","2626","2741",
"청학1동","총인구","2024.12 월","2687","5370","2628","2742",
"청학2동","총인구","2020.01 월","8032","19103","9464","9639",
"청학2동","총인구","2020.02 월","8024","19021","9431","9590",
"청학2동","총인구","2020.03 월","8026","18964","9416","9548",
"청학2동","총인구","2020.04 월","8031","18954","9412","9542",
"청학2동","총인구","2020.05 월","8029","18894","9382","9512",
"청학2동","총인구","2020.06 월","8028","18847","9357","9490",
"청학2동","총인구","2020.07 월","8031","18811","9332","9479",
"청학2동","총인구","2020.08 월","8028","18740","9301","9439",
"청학2동","총인구","2020.09 월","8034","18706","9285","9421",
"청학2동","총인구","2020.10 월","8039","18679","9275","9404",
"청학2동","총인구","2020.11 월","8033","18626","9253","9373",
"청학2동","총인구","2020.12 월","8035","18580","9241","9339",
"청학2동","총인구","2021.01 월","8031","18527","9231","9296",
"청학2동","총인구","2021.02 월","8040","18513","9216","9297",
"청학2동","총인구","2021.03 월","7956","18364","9148","9216",
"청학2동","총인구","2021.04 월","7954","18340","9142","9198",
"청학2동","총인구","2021.05 월","7905","18116","9020","9096",
"청학2동","총인구","2021.06 월","7899","18065","8999","9066",
"청학2동","총인구","2021.07 월","7879","17955","8925","9030",
"청학2동","총인구","2021.08 월","7897","17942","8908","9034",
"청학2동","총인구","2021.09 월","7906","17906","8890","9016",
"청학2동","총인구","2021.10 월","7901","17880","8861","9019",
"청학2동","총인구","2021.11 월","7894","17825","8828","8997",
"청학2동","총인구","2021.12 월","7886","17797","8800","8997",
"청학2동","총인구","2022.01 월","7885","17771","8780","8991",
"청학2동","총인구","2022.02 월","7868","17671","8737","8934",
"청학2동","총인구","2022.03 월","7842","17578","8691","8887",
"청학2동","총인구","2022.04 월","7835","17512","8659","8853",
"청학2동","총인구","2022.05 월","7837","17461","8624","8837",
"청학2동","총인구","2022.06 월","7874","17456","8635","8821",
"청학2동","총인구","2022.07 월","7898","17505","8657","8848",
"청학2동","총인구","2022.08 월","7938","17543","8677","8866",
"청학2동","총인구","2022.09 월","7916","17472","8623","8849",
"청학2동","총인구","2022.10 월","7946","17501","8628","8873",
"청학2동","총인구","2022.11 월","7944","17503","8633","8870",
"청학2동","총인구","2022.12 월","7952","17500","8628","8872",
"청학2동","총인구","2023.01 월","7955","17492","8623","8869",
"청학2동","총인구","2023.02 월","7961","17467","8610","8857",
"청학2동","총인구","2023.03 월","7963","17450","8592","8858",
"청학2동","총인구","2023.04 월","7958","17440","8591","8849",
"청학2동","총인구","2023.05 월","7948","17400","8567","8833",
"청학2동","총인구","2023.06 월","7936","17361","8548","8813",
"청학2동","총인구","2023.07 월","7901","17266","8507","8759",
"청학2동","총인구","2023.08 월","7875","17177","8460","8717",
"청학2동","총인구","2023.09 월","7867","17119","8432","8687",
"청학2동","총인구","2023.10 월","7853","17064","8406","8658",
"청학2동","총인구","2023.11 월","7834","17016","8383","8633",
"청학2동","총인구","2023.12 월","7830","16967","8361","8606",
"청학2동","총인구","2024.01 월","7799","16890","8327","8563",
"청학2동","총인구","2024.02 월","7789","16834","8291","8543",
"청학2동","총인구","2024.03 월","7779","16800","8278","8522",
"청학2동","총인구","2024.04 월","7767","16737","8240","8497",
"청학2동","총인구","2024.05 월","7754","16696","8216","8480",
"청학2동","총인구","2024.06 월","7730","16626","8188","8438",
"청학2동","총인구","2024.07 월","7720","16601","8184","8417",
"청학2동","총인구","2024.08 월","7714","16563","8156","8407",
"청학2동","총인구","2024.09 월","7698","16519","8137","8382",
"청학2동","총인구","2024.10 월","7664","16423","8090","8333",
"청학2동","총인구","2024.11 월","7645","16390","8072","8318",
"청학2동","총인구","2024.12 월","7644","16359","8078","8281",
"동삼1동","총인구","2020.01 월","13006","29935","14628","15307",
"동삼1동","총인구","2020.02 월","12993","29869","14585","15284",
"동삼1동","총인구","2020.03 월","13010","29831","14564","15267",
"동삼1동","총인구","2020.04 월","13017","29729","14519","15210",
"동삼1동","총인구","2020.05 월","13051","29711","14500","15211",
"동삼1동","총인구","2020.06 월","13034","29623","14458","15165",
"동삼1동","총인구","2020.07 월","13051","29668","14477","15191",
"동삼1동","총인구","2020.08 월","13035","29648","14477","15171",
"동삼1동","총인구","2020.09 월","13048","29600","14442","15158",
"동삼1동","총인구","2020.10 월","13012","29429","14351","15078",
"동삼1동","총인구","2020.11 월","13048","29373","14323","15050",
"동삼1동","총인구","2020.12 월","13025","29212","14233","14979",
"동삼1동","총인구","2021.01 월","13030","29118","14186","14932",
"동삼1동","총인구","2021.02 월","13029","29063","14174","14889",
"동삼1동","총인구","2021.03 월","12977","28913","14110","14803",
"동삼1동","총인구","2021.04 월","12962","28837","14081","14756",
"동삼1동","총인구","2021.05 월","12913","28537","13935","14602",
"동삼1동","총인구","2021.06 월","12872","28320","13823","14497",
"동삼1동","총인구","2021.07 월","12901","28293","13812","14481",
"동삼1동","총인구","2021.08 월","12909","28164","13748","14416",
"동삼1동","총인구","2021.09 월","12904","28098","13721","14377",
"동삼1동","총인구","2021.10 월","12936","28097","13702","14395",
"동삼1동","총인구","2021.11 월","12942","28062","13695","14367",
"동삼1동","총인구","2021.12 월","12938","27998","13661","14337",
"동삼1동","총인구","2022.01 월","12922","27923","13630","14293",
"동삼1동","총인구","2022.02 월","12948","27853","13595","14258",
"동삼1동","총인구","2022.03 월","12940","27784","13559","14225",
"동삼1동","총인구","2022.04 월","12923","27726","13515","14211",
"동삼1동","총인구","2022.05 월","12947","27676","13489","14187",
"동삼1동","총인구","2022.06 월","12905","27508","13411","14097",
"동삼1동","총인구","2022.07 월","12871","27393","13352","14041",
"동삼1동","총인구","2022.08 월","12889","27356","13340","14016",
"동삼1동","총인구","2022.09 월","12833","27265","13283","13982",
"동삼1동","총인구","2022.10 월","12807","27182","13234","13948",
"동삼1동","총인구","2022.11 월","12821","27181","13243","13938",
"동삼1동","총인구","2022.12 월","12856","27185","13231","13954",
"동삼1동","총인구","2023.01 월","12832","27102","13194","13908",
"동삼1동","총인구","2023.02 월","12835","27046","13162","13884",
"동삼1동","총인구","2023.03 월","12847","26994","13135","13859",
"동삼1동","총인구","2023.04 월","12859","26950","13116","13834",
"동삼1동","총인구","2023.05 월","12850","26911","13092","13819",
"동삼1동","총인구","2023.06 월","12861","26876","13088","13788",
"동삼1동","총인구","2023.07 월","13126","27398","13346","14052",
"동삼1동","총인구","2023.08 월","13314","27807","13542","14265",
"동삼1동","총인구","2023.09 월","13442","28036","13638","14398",
"동삼1동","총인구","2023.10 월","13497","28140","13679","14461",
"동삼1동","총인구","2023.11 월","13555","28265","13717","14548",
"동삼1동","총인구","2023.12 월","13594","28336","13754","14582",
"동삼1동","총인구","2024.01 월","13625","28383","13768","14615",
"동삼1동","총인구","2024.02 월","13709","28460","13810","14650",
"동삼1동","총인구","2024.03 월","13757","28486","13821","14665",
"동삼1동","총인구","2024.04 월","13777","28482","13813","14669",
"동삼1동","총인구","2024.05 월","13784","28448","13775","14673",
"동삼1동","총인구","2024.06 월","13789","28469","13791","14678",
"동삼1동","총인구","2024.07 월","13780","28398","13756","14642",
"동삼1동","총인구","2024.08 월","13756","28346","13743","14603",
"동삼1동","총인구","2024.09 월","13770","28341","13741","14600",
"동삼1동","총인구","2024.10 월","13774","28310","13717","14593",
"동삼1동","총인구","2024.11 월","13746","28217","13692","14525",
"동삼1동","총인구","2024.12 월","13751","28204","13683","14521",
"동삼2동","총인구","2020.01 월","1855","3818","2009","1809",
"동삼2동","총인구","2020.02 월","1853","3807","2003","1804",
"동삼2동","총인구","2020.03 월","1875","3828","2021","1807",
"동삼2동","총인구","2020.04 월","1875","3822","2025","1797",
"동삼2동","총인구","2020.05 월","1892","3802","2014","1788",
"동삼2동","총인구","2020.06 월","1887","3775","2004","1771",
"동삼2동","총인구","2020.07 월","1894","3764","2002","1762",
"동삼2동","총인구","2020.08 월","1880","3733","1983","1750",
"동삼2동","총인구","2020.09 월","1873","3721","1978","1743",
"동삼2동","총인구","2020.10 월","1885","3734","1992","1742",
"동삼2동","총인구","2020.11 월","1879","3705","1973","1732",
"동삼2동","총인구","2020.12 월","1878","3705","1980","1725",
"동삼2동","총인구","2021.01 월","1885","3707","1976","1731",
"동삼2동","총인구","2021.02 월","1886","3694","1966","1728",
"동삼2동","총인구","2021.03 월","1882","3700","1972","1728",
"동삼2동","총인구","2021.04 월","1875","3684","1967","1717",
"동삼2동","총인구","2021.05 월","1862","3648","1946","1702",
"동삼2동","총인구","2021.06 월","1873","3646","1945","1701",
"동삼2동","총인구","2021.07 월","1867","3633","1940","1693",
"동삼2동","총인구","2021.08 월","1863","3593","1918","1675",
"동삼2동","총인구","2021.09 월","1862","3590","1913","1677",
"동삼2동","총인구","2021.10 월","1855","3567","1906","1661",
"동삼2동","총인구","2021.11 월","1850","3549","1894","1655",
"동삼2동","총인구","2021.12 월","1840","3528","1880","1648",
"동삼2동","총인구","2022.01 월","1843","3537","1887","1650",
"동삼2동","총인구","2022.02 월","1857","3538","1895","1643",
"동삼2동","총인구","2022.03 월","1864","3563","1909","1654",
"동삼2동","총인구","2022.04 월","1879","3591","1922","1669",
"동삼2동","총인구","2022.05 월","2044","4000","2125","1875",
"동삼2동","총인구","2022.06 월","2183","4413","2313","2100",
"동삼2동","총인구","2022.07 월","2253","4590","2401","2189",
"동삼2동","총인구","2022.08 월","2310","4719","2467","2252",
"동삼2동","총인구","2022.09 월","2334","4904","2556","2348",
"동삼2동","총인구","2022.10 월","2364","4935","2571","2364",
"동삼2동","총인구","2022.11 월","2387","5002","2601","2401",
"동삼2동","총인구","2022.12 월","2399","5036","2627","2409",
"동삼2동","총인구","2023.01 월","2405","5088","2650","2438",
"동삼2동","총인구","2023.02 월","2452","5172","2696","2476",
"동삼2동","총인구","2023.03 월","2483","5269","2733","2536",
"동삼2동","총인구","2023.04 월","2505","5281","2736","2545",
"동삼2동","총인구","2023.05 월","2525","5315","2750","2565",
"동삼2동","총인구","2023.06 월","2536","5327","2750","2577",
"동삼2동","총인구","2023.07 월","2526","5371","2771","2600",
"동삼2동","총인구","2023.08 월","2521","5342","2761","2581",
"동삼2동","총인구","2023.09 월","2521","5359","2773","2586",
"동삼2동","총인구","2023.10 월","2521","5475","2834","2641",
"동삼2동","총인구","2023.11 월","2509","5478","2836","2642",
"동삼2동","총인구","2023.12 월","2513","5488","2845","2643",
"동삼2동","총인구","2024.01 월","2507","5449","2828","2621",
"동삼2동","총인구","2024.02 월","2536","5495","2848","2647",
"동삼2동","총인구","2024.03 월","2587","5582","2911","2671",
"동삼2동","총인구","2024.04 월","2582","5575","2911","2664",
"동삼2동","총인구","2024.05 월","2597","5589","2924","2665",
"동삼2동","총인구","2024.06 월","2585","5551","2910","2641",
"동삼2동","총인구","2024.07 월","2581","5517","2896","2621",
"동삼2동","총인구","2024.08 월","2592","5514","2909","2605",
"동삼2동","총인구","2024.09 월","2614","5565","2942","2623",
"동삼2동","총인구","2024.10 월","2615","5583","2962","2621",
"동삼2동","총인구","2024.11 월","2622","5588","2969","2619",
"동삼2동","총인구","2024.12 월","2612","5569","2960","2609",
"동삼3동","총인구","2020.01 월","5978","10884","5286","5598",
"동삼3동","총인구","2020.02 월","5965","10848","5262","5586",
"동삼3동","총인구","2020.03 월","5976","10832","5253","5579",
"동삼3동","총인구","2020.04 월","5962","10788","5225","5563",
"동삼3동","총인구","2020.05 월","5960","10730","5200","5530",
"동삼3동","총인구","2020.06 월","5970","10708","5181","5527",
"동삼3동","총인구","2020.07 월","5971","10673","5160","5513",
"동삼3동","총인구","2020.08 월","5968","10638","5150","5488",
"동삼3동","총인구","2020.09 월","5949","10576","5122","5454",
"동삼3동","총인구","2020.10 월","5949","10544","5114","5430",
"동삼3동","총인구","2020.11 월","5957","10503","5094","5409",
"동삼3동","총인구","2020.12 월","5969","10479","5087","5392",
"동삼3동","총인구","2021.01 월","5968","10440","5067","5373",
"동삼3동","총인구","2021.02 월","5964","10420","5052","5368",
"동삼3동","총인구","2021.03 월","5962","10376","5043","5333",
"동삼3동","총인구","2021.04 월","5972","10353","5032","5321",
"동삼3동","총인구","2021.05 월","5951","10274","5003","5271",
"동삼3동","총인구","2021.06 월","5928","10198","4962","5236",
"동삼3동","총인구","2021.07 월","5921","10161","4943","5218",
"동삼3동","총인구","2021.08 월","5917","10138","4933","5205",
"동삼3동","총인구","2021.09 월","5912","10114","4914","5200",
"동삼3동","총인구","2021.10 월","5896","10078","4889","5189",
"동삼3동","총인구","2021.11 월","5873","10031","4869","5162",
"동삼3동","총인구","2021.12 월","5858","9988","4845","5143",
"동삼3동","총인구","2022.01 월","5839","9947","4822","5125",
"동삼3동","총인구","2022.02 월","5814","9889","4807","5082",
"동삼3동","총인구","2022.03 월","5804","9848","4785","5063",
"동삼3동","총인구","2022.04 월","5793","9811","4759","5052",
"동삼3동","총인구","2022.05 월","5766","9732","4712","5020",
"동삼3동","총인구","2022.06 월","5755","9667","4678","4989",
"동삼3동","총인구","2022.07 월","5745","9646","4674","4972",
"동삼3동","총인구","2022.08 월","5736","9623","4658","4965",
"동삼3동","총인구","2022.09 월","5684","9548","4621","4927",
"동삼3동","총인구","2022.10 월","5677","9508","4602","4906",
"동삼3동","총인구","2022.11 월","5651","9451","4573","4878",
"동삼3동","총인구","2022.12 월","5628","9410","4556","4854",
"동삼3동","총인구","2023.01 월","5623","9367","4535","4832",
"동삼3동","총인구","2023.02 월","5632","9357","4538","4819",
"동삼3동","총인구","2023.03 월","5629","9360","4564","4796",
"동삼3동","총인구","2023.04 월","5635","9353","4561","4792",
"동삼3동","총인구","2023.05 월","5622","9401","4621","4780",
"동삼3동","총인구","2023.06 월","5626","9386","4624","4762",
"동삼3동","총인구","2023.07 월","5598","9334","4598","4736",
"동삼3동","총인구","2023.08 월","5569","9245","4558","4687",
"동삼3동","총인구","2023.09 월","5547","9183","4533","4650",
"동삼3동","총인구","2023.10 월","5536","9188","4560","4628",
"동삼3동","총인구","2023.11 월","5526","9223","4604","4619",
"동삼3동","총인구","2023.12 월","5506","9196","4591","4605",
"동삼3동","총인구","2024.01 월","5500","9171","4584","4587",
"동삼3동","총인구","2024.02 월","5513","9158","4575","4583",
"동삼3동","총인구","2024.03 월","5519","9147","4571","4576",
"동삼3동","총인구","2024.04 월","5503","9107","4539","4568",
"동삼3동","총인구","2024.05 월","5499","9073","4525","4548",
"동삼3동","총인구","2024.06 월","5496","9054","4509","4545",
"동삼3동","총인구","2024.07 월","5499","9032","4503","4529",
"동삼3동","총인구","2024.08 월","5494","9018","4494","4524",
"동삼3동","총인구","2024.09 월","5480","8993","4486","4507",
"동삼3동","총인구","2024.10 월","5454","8953","4466","4487",
"동삼3동","총인구","2024.11 월","5432","8895","4434","4461",
"동삼3동","총인구","2024.12 월","5426","8865","4412","4453",
"부산진구","총인구","2020.01 월","166981","360439","174373","186066",
"부산진구","총인구","2020.02 월","167266","359945","174090","185855",
"부산진구","총인구","2020.03 월","167761","359790","173899","185891",
"부산진구","총인구","2020.04 월","168189","359968","173926","186042",
"부산진구","총인구","2020.05 월","168789","360102","173984","186118",
"부산진구","총인구","2020.06 월","169203","360176","173950","186226",
"부산진구","총인구","2020.07 월","169952","360582","174125","186457",
"부산진구","총인구","2020.08 월","170624","360634","174170","186464",
"부산진구","총인구","2020.09 월","171008","360431","173987","186444",
"부산진구","총인구","2020.10 월","171637","361166","174403","186763",
"부산진구","총인구","2020.11 월","172561","362213","174861","187352",
"부산진구","총인구","2020.12 월","173263","362701","175064","187637",
"부산진구","총인구","2021.01 월","173746","362772","174998","187774",
"부산진구","총인구","2021.02 월","174327","362796","174884","187912",
"부산진구","총인구","2021.03 월","172683","360491","173860","186631",
"부산진구","총인구","2021.04 월","172771","360021","173641","186380",
"부산진구","총인구","2021.05 월","172912","359504","173351","186153",
"부산진구","총인구","2021.06 월","172864","358896","173049","185847",
"부산진구","총인구","2021.07 월","172962","358333","172745","185588",
"부산진구","총인구","2021.08 월","173084","357872","172349","185523",
"부산진구","총인구","2021.09 월","173279","357670","172161","185509",
"부산진구","총인구","2021.10 월","173300","357200","171877","185323",
"부산진구","총인구","2021.11 월","173278","356546","171585","184961",
"부산진구","총인구","2021.12 월","173353","355902","171262","184640",
"부산진구","총인구","2022.01 월","173327","355187","170949","184238",
"부산진구","총인구","2022.02 월","173496","354445","170555","183890",
"부산진구","총인구","2022.03 월","173573","353840","170248","183592",
"부산진구","총인구","2022.04 월","173947","353687","170112","183575",
"부산진구","총인구","2022.05 월","174306","353659","169997","183662",
"부산진구","총인구","2022.06 월","174624","353674","169982","183692",
"부산진구","총인구","2022.07 월","175150","354120","170222","183898",
"부산진구","총인구","2022.08 월","175696","354367","170267","184100",
"부산진구","총인구","2022.09 월","175448","353819","169947","183872",
"부산진구","총인구","2022.10 월","176765","356251","171164","185087",
"부산진구","총인구","2022.11 월","177576","358021","171996","186025",
"부산진구","총인구","2022.12 월","178049","358644","172214","186430",
"부산진구","총인구","2023.01 월","178397","359061","172381","186680",
"부산진구","총인구","2023.02 월","179307","360045","172765","187280",
"부산진구","총인구","2023.03 월","179744","360354","172892","187462",
"부산진구","총인구","2023.04 월","179949","360365","172886","187479",
"부산진구","총인구","2023.05 월","180263","360565","172971","187594",
"부산진구","총인구","2023.06 월","180383","360309","172828","187481",
"부산진구","총인구","2023.07 월","180514","360153","172778","187375",
"부산진구","총인구","2023.08 월","180664","360119","172757","187362",
"부산진구","총인구","2023.09 월","181219","361250","173322","187928",
"부산진구","총인구","2023.10 월","181565","362282","173805","188477",
"부산진구","총인구","2023.11 월","181807","362675","173957","188718",
"부산진구","총인구","2023.12 월","181914","362505","173815","188690",
"부산진구","총인구","2024.01 월","182417","363092","174039","189053",
"부산진구","총인구","2024.02 월","183261","363965","174414","189551",
"부산진구","총인구","2024.03 월","183826","364357","174587","189770",
"부산진구","총인구","2024.04 월","183993","364499","174590","189909",
"부산진구","총인구","2024.05 월","184283","364666","174690","189976",
"부산진구","총인구","2024.06 월","184639","365193","174939","190254",
"부산진구","총인구","2024.07 월","184721","365057","174816","190241",
"부산진구","총인구","2024.08 월","184796","364908","174741","190167",
"부산진구","총인구","2024.09 월","184863","364873","174756","190117",
"부산진구","총인구","2024.10 월","184557","364256","174454","189802",
"부산진구","총인구","2024.11 월","184341","363394","173928","189466",
"부산진구","총인구","2024.12 월","184179","362839","173651","189188",
"부전1동","총인구","2020.01 월","9356","15499","7785","7714",
"부전1동","총인구","2020.02 월","9410","15559","7828","7731",
"부전1동","총인구","2020.03 월","9553","15705","7883","7822",
"부전1동","총인구","2020.04 월","9589","15728","7859","7869",
"부전1동","총인구","2020.05 월","9659","15767","7887","7880",
"부전1동","총인구","2020.06 월","9669","15791","7909","7882",
"부전1동","총인구","2020.07 월","9704","15784","7913","7871",
"부전1동","총인구","2020.08 월","9727","15760","7904","7856",
"부전1동","총인구","2020.09 월","9743","15732","7906","7826",
"부전1동","총인구","2020.10 월","9786","15733","7906","7827",
"부전1동","총인구","2020.11 월","9807","15733","7907","7826",
"부전1동","총인구","2020.12 월","9830","15711","7902","7809",
"부전1동","총인구","2021.01 월","9929","15794","7917","7877",
"부전1동","총인구","2021.02 월","10077","15922","7945","7977",
"부전1동","총인구","2021.03 월","9952","15803","7929","7874",
"부전1동","총인구","2021.04 월","10009","15854","7933","7921",
"부전1동","총인구","2021.05 월","10052","15889","7948","7941",
"부전1동","총인구","2021.06 월","10115","15967","7994","7973",
"부전1동","총인구","2021.07 월","10188","16085","8055","8030",
"부전1동","총인구","2021.08 월","10219","16133","8078","8055",
"부전1동","총인구","2021.09 월","10244","16153","8066","8087",
"부전1동","총인구","2021.10 월","10259","16131","8060","8071",
"부전1동","총인구","2021.11 월","10288","16111","8044","8067",
"부전1동","총인구","2021.12 월","10310","16084","8028","8056",
"부전1동","총인구","2022.01 월","10326","16107","8027","8080",
"부전1동","총인구","2022.02 월","10346","16077","8022","8055",
"부전1동","총인구","2022.03 월","10317","16026","7999","8027",
"부전1동","총인구","2022.04 월","10320","16000","7971","8029",
"부전1동","총인구","2022.05 월","10308","15952","7940","8012",
"부전1동","총인구","2022.06 월","10334","15971","7949","8022",
"부전1동","총인구","2022.07 월","10347","15964","7948","8016",
"부전1동","총인구","2022.08 월","10389","16002","7952","8050",
"부전1동","총인구","2022.09 월","10393","15989","7955","8034",
"부전1동","총인구","2022.10 월","10421","15955","7958","7997",
"부전1동","총인구","2022.11 월","10427","15928","7934","7994",
"부전1동","총인구","2022.12 월","10464","15942","7938","8004",
"부전1동","총인구","2023.01 월","10528","15977","7949","8028",
"부전1동","총인구","2023.02 월","10611","16050","7969","8081",
"부전1동","총인구","2023.03 월","10621","16054","7936","8118",
"부전1동","총인구","2023.04 월","10626","16069","7946","8123",
"부전1동","총인구","2023.05 월","10683","16112","7978","8134",
"부전1동","총인구","2023.06 월","10703","16106","7991","8115",
"부전1동","총인구","2023.07 월","10724","16111","7990","8121",
"부전1동","총인구","2023.08 월","10757","16131","7984","8147",
"부전1동","총인구","2023.09 월","10736","16116","7989","8127",
"부전1동","총인구","2023.10 월","10634","15979","7932","8047",
"부전1동","총인구","2023.11 월","10592","15912","7893","8019",
"부전1동","총인구","2023.12 월","10612","15914","7890","8024",
"부전1동","총인구","2024.01 월","10611","15871","7873","7998",
"부전1동","총인구","2024.02 월","10655","15862","7854","8008",
"부전1동","총인구","2024.03 월","10705","15903","7848","8055",
"부전1동","총인구","2024.04 월","10768","15968","7881","8087",
"부전1동","총인구","2024.05 월","10816","16018","7905","8113",
"부전1동","총인구","2024.06 월","10787","15920","7856","8064",
"부전1동","총인구","2024.07 월","10703","15775","7790","7985",
"부전1동","총인구","2024.08 월","10575","15537","7682","7855",
"부전1동","총인구","2024.09 월","10462","15294","7576","7718",
"부전1동","총인구","2024.10 월","10292","14974","7398","7576",
"부전1동","총인구","2024.11 월","10136","14682","7254","7428",
"부전1동","총인구","2024.12 월","10028","14484","7148","7336",
"부전2동","총인구","2020.01 월","5507","10421","5177","5244",
"부전2동","총인구","2020.02 월","5514","10410","5175","5235",
"부전2동","총인구","2020.03 월","5499","10357","5147","5210",
"부전2동","총인구","2020.04 월","5487","10346","5150","5196",
"부전2동","총인구","2020.05 월","5523","10367","5165","5202",
"부전2동","총인구","2020.06 월","5528","10332","5152","5180",
"부전2동","총인구","2020.07 월","5541","10333","5161","5172",
"부전2동","총인구","2020.08 월","5540","10286","5146","5140",
"부전2동","총인구","2020.09 월","5547","10249","5130","5119",
"부전2동","총인구","2020.10 월","5514","10158","5095","5063",
"부전2동","총인구","2020.11 월","5518","10118","5094","5024",
"부전2동","총인구","2020.12 월","5527","10085","5068","5017",
"부전2동","총인구","2021.01 월","5527","10075","5049","5026",
"부전2동","총인구","2021.02 월","5559","10094","5051","5043",
"부전2동","총인구","2021.03 월","5497","10054","5019","5035",
"부전2동","총인구","2021.04 월","5512","10044","5006","5038",
"부전2동","총인구","2021.05 월","5505","10021","4990","5031",
"부전2동","총인구","2021.06 월","5510","10027","4999","5028",
"부전2동","총인구","2021.07 월","5526","10039","5003","5036",
"부전2동","총인구","2021.08 월","5522","10044","4995","5049",
"부전2동","총인구","2021.09 월","5550","10073","5012","5061",
"부전2동","총인구","2021.10 월","5547","10057","5007","5050",
"부전2동","총인구","2021.11 월","5569","10065","5037","5028",
"부전2동","총인구","2021.12 월","5626","10098","5043","5055",
"부전2동","총인구","2022.01 월","5641","10106","5065","5041",
"부전2동","총인구","2022.02 월","5698","10117","5058","5059",
"부전2동","총인구","2022.03 월","5699","10109","5045","5064",
"부전2동","총인구","2022.04 월","6012","10428","5173","5255",
"부전2동","총인구","2022.05 월","6259","10702","5278","5424",
"부전2동","총인구","2022.06 월","6375","10830","5324","5506",
"부전2동","총인구","2022.07 월","6423","10860","5330","5530",
"부전2동","총인구","2022.08 월","6470","10902","5340","5562",
"부전2동","총인구","2022.09 월","6464","10868","5335","5533",
"부전2동","총인구","2022.10 월","6461","10842","5318","5524",
"부전2동","총인구","2022.11 월","6493","10872","5331","5541",
"부전2동","총인구","2022.12 월","6529","10900","5338","5562",
"부전2동","총인구","2023.01 월","6583","10945","5384","5561",
"부전2동","총인구","2023.02 월","6658","11013","5420","5593",
"부전2동","총인구","2023.03 월","6686","11043","5444","5599",
"부전2동","총인구","2023.04 월","6698","11054","5452","5602",
"부전2동","총인구","2023.05 월","6752","11100","5475","5625",
"부전2동","총인구","2023.06 월","6798","11137","5501","5636",
"부전2동","총인구","2023.07 월","6848","11195","5524","5671",
"부전2동","총인구","2023.08 월","6868","11233","5544","5689",
"부전2동","총인구","2023.09 월","6906","11283","5557","5726",
"부전2동","총인구","2023.10 월","7075","11699","5765","5934",
"부전2동","총인구","2023.11 월","7219","11956","5910","6046",
"부전2동","총인구","2023.12 월","7286","12098","5977","6121",
"부전2동","총인구","2024.01 월","7384","12202","6030","6172",
"부전2동","총인구","2024.02 월","7504","12372","6119","6253",
"부전2동","총인구","2024.03 월","7535","12409","6135","6274",
"부전2동","총인구","2024.04 월","7555","12447","6151","6296",
"부전2동","총인구","2024.05 월","7545","12432","6146","6286",
"부전2동","총인구","2024.06 월","7560","12455","6158","6297",
"부전2동","총인구","2024.07 월","7579","12494","6182","6312",
"부전2동","총인구","2024.08 월","7607","12534","6207","6327",
"부전2동","총인구","2024.09 월","7640","12588","6246","6342",
"부전2동","총인구","2024.10 월","7621","12554","6244","6310",
"부전2동","총인구","2024.11 월","7601","12521","6203","6318",
"부전2동","총인구","2024.12 월","7590","12470","6194","6276",
"연지동","총인구","2020.01 월","8336","20807","9857","10950",
"연지동","총인구","2020.02 월","8347","20804","9853","10951",
"연지동","총인구","2020.03 월","8354","20724","9815","10909",
"연지동","총인구","2020.04 월","8328","20569","9733","10836",
"연지동","총인구","2020.05 월","8325","20489","9696","10793",
"연지동","총인구","2020.06 월","8374","20513","9709","10804",
"연지동","총인구","2020.07 월","8493","20690","9787","10903",
"연지동","총인구","2020.08 월","8540","20734","9799","10935",
"연지동","총인구","2020.09 월","8578","20794","9810","10984",
"연지동","총인구","2020.10 월","8624","20885","9850","11035",
"연지동","총인구","2020.11 월","8670","20922","9867","11055",
"연지동","총인구","2020.12 월","8733","21021","9910","11111",
"연지동","총인구","2021.01 월","8763","21059","9939","11120",
"연지동","총인구","2021.02 월","8775","21099","9963","11136",
"연지동","총인구","2021.03 월","8708","20972","9933","11039",
"연지동","총인구","2021.04 월","8711","20947","9898","11049",
"연지동","총인구","2021.05 월","8721","20913","9880","11033",
"연지동","총인구","2021.06 월","8720","20875","9858","11017",
"연지동","총인구","2021.07 월","8729","20855","9849","11006",
"연지동","총인구","2021.08 월","8709","20782","9802","10980",
"연지동","총인구","2021.09 월","8687","20743","9784","10959",
"연지동","총인구","2021.10 월","8694","20750","9780","10970",
"연지동","총인구","2021.11 월","8697","20718","9767","10951",
"연지동","총인구","2021.12 월","8703","20683","9764","10919",
"연지동","총인구","2022.01 월","8696","20655","9743","10912",
"연지동","총인구","2022.02 월","8683","20587","9722","10865",
"연지동","총인구","2022.03 월","8669","20513","9690","10823",
"연지동","총인구","2022.04 월","8672","20519","9704","10815",
"연지동","총인구","2022.05 월","8660","20470","9683","10787",
"연지동","총인구","2022.06 월","8664","20446","9668","10778",
"연지동","총인구","2022.07 월","8664","20428","9657","10771",
"연지동","총인구","2022.08 월","8650","20358","9634","10724",
"연지동","총인구","2022.09 월","8638","20353","9641","10712",
"연지동","총인구","2022.10 월","9311","22063","10482","11581",
"연지동","총인구","2022.11 월","9952","23767","11311","12456",
"연지동","총인구","2022.12 월","10235","24490","11670","12820",
"연지동","총인구","2023.01 월","10372","24896","11875","13021",
"연지동","총인구","2023.02 월","10486","25237","12021","13216",
"연지동","총인구","2023.03 월","10542","25381","12087","13294",
"연지동","총인구","2023.04 월","10602","25501","12142","13359",
"연지동","총인구","2023.05 월","10642","25585","12201","13384",
"연지동","총인구","2023.06 월","10676","25676","12237","13439",
"연지동","총인구","2023.07 월","10714","25751","12281","13470",
"연지동","총인구","2023.08 월","10749","25845","12311","13534",
"연지동","총인구","2023.09 월","10763","25889","12319","13570",
"연지동","총인구","2023.10 월","10746","25869","12312","13557",
"연지동","총인구","2023.11 월","10757","25922","12330","13592",
"연지동","총인구","2023.12 월","10757","25927","12319","13608",
"연지동","총인구","2024.01 월","10755","25858","12282","13576",
"연지동","총인구","2024.02 월","10748","25805","12254","13551",
"연지동","총인구","2024.03 월","10745","25782","12237","13545",
"연지동","총인구","2024.04 월","10756","25770","12226","13544",
"연지동","총인구","2024.05 월","10752","25782","12221","13561",
"연지동","총인구","2024.06 월","10735","25691","12172","13519",
"연지동","총인구","2024.07 월","10732","25649","12151","13498",
"연지동","총인구","2024.08 월","10730","25640","12144","13496",
"연지동","총인구","2024.09 월","10742","25641","12161","13480",
"연지동","총인구","2024.10 월","10722","25642","12166","13476",
"연지동","총인구","2024.11 월","10744","25660","12164","13496",
"연지동","총인구","2024.12 월","10759","25679","12186","13493",
"초읍동","총인구","2020.01 월","9142","20649","9997","10652",
"초읍동","총인구","2020.02 월","9136","20591","9963","10628",
"초읍동","총인구","2020.03 월","9166","20612","9975","10637",
"초읍동","총인구","2020.04 월","9481","21458","10398","11060",
"초읍동","총인구","2020.05 월","9704","22017","10672","11345",
"초읍동","총인구","2020.06 월","9852","22319","10807","11512",
"초읍동","총인구","2020.07 월","9988","22539","10927","11612",
"초읍동","총인구","2020.08 월","10033","22560","10936","11624",
"초읍동","총인구","2020.09 월","10043","22543","10924","11619",
"초읍동","총인구","2020.10 월","10053","22513","10923","11590",
"초읍동","총인구","2020.11 월","10082","22530","10933","11597",
"초읍동","총인구","2020.12 월","10109","22533","10914","11619",
"초읍동","총인구","2021.01 월","10118","22528","10917","11611",
"초읍동","총인구","2021.02 월","10120","22463","10882","11581",
"초읍동","총인구","2021.03 월","10017","22353","10824","11529",
"초읍동","총인구","2021.04 월","9991","22296","10803","11493",
"초읍동","총인구","2021.05 월","10012","22315","10803","11512",
"초읍동","총인구","2021.06 월","10012","22262","10755","11507",
"초읍동","총인구","2021.07 월","9985","22210","10725","11485",
"초읍동","총인구","2021.08 월","10030","22268","10730","11538",
"초읍동","총인구","2021.09 월","10056","22306","10734","11572",
"초읍동","총인구","2021.10 월","10080","22285","10729","11556",
"초읍동","총인구","2021.11 월","10079","22260","10712","11548",
"초읍동","총인구","2021.12 월","10081","22237","10709","11528",
"초읍동","총인구","2022.01 월","10056","22150","10676","11474",
"초읍동","총인구","2022.02 월","10041","22113","10647","11466",
"초읍동","총인구","2022.03 월","9998","21994","10581","11413",
"초읍동","총인구","2022.04 월","9973","21901","10522","11379",
"초읍동","총인구","2022.05 월","9984","21890","10519","11371",
"초읍동","총인구","2022.06 월","9981","21839","10487","11352",
"초읍동","총인구","2022.07 월","9972","21798","10476","11322",
"초읍동","총인구","2022.08 월","9986","21768","10443","11325",
"초읍동","총인구","2022.09 월","9950","21684","10407","11277",
"초읍동","총인구","2022.10 월","9915","21477","10295","11182",
"초읍동","총인구","2022.11 월","9885","21345","10250","11095",
"초읍동","총인구","2022.12 월","9864","21265","10205","11060",
"초읍동","총인구","2023.01 월","9861","21230","10192","11038",
"초읍동","총인구","2023.02 월","9875","21218","10189","11029",
"초읍동","총인구","2023.03 월","9862","21142","10150","10992",
"초읍동","총인구","2023.04 월","9858","21118","10129","10989",
"초읍동","총인구","2023.05 월","9863","21102","10120","10982",
"초읍동","총인구","2023.06 월","9845","21045","10091","10954",
"초읍동","총인구","2023.07 월","9842","20995","10067","10928",
"초읍동","총인구","2023.08 월","9815","20925","10040","10885",
"초읍동","총인구","2023.09 월","9813","20891","10030","10861",
"초읍동","총인구","2023.10 월","9804","20852","10022","10830",
"초읍동","총인구","2023.11 월","9788","20812","9997","10815",
"초읍동","총인구","2023.12 월","9780","20739","9965","10774",
"초읍동","총인구","2024.01 월","9770","20654","9927","10727",
"초읍동","총인구","2024.02 월","9736","20549","9869","10680",
"초읍동","총인구","2024.03 월","9723","20520","9852","10668",
"초읍동","총인구","2024.04 월","9708","20488","9825","10663",
"초읍동","총인구","2024.05 월","9694","20425","9806","10619",
"초읍동","총인구","2024.06 월","10036","21274","10252","11022",
"초읍동","총인구","2024.07 월","10206","21685","10447","11238",
"초읍동","총인구","2024.08 월","10254","21812","10516","11296",
"초읍동","총인구","2024.09 월","10274","21838","10521","11317",
"초읍동","총인구","2024.10 월","10292","21855","10528","11327",
"초읍동","총인구","2024.11 월","10282","21823","10509","11314",
"초읍동","총인구","2024.12 월","10291","21844","10517","11327",
"양정1동","총인구","2020.01 월","8924","20696","9870","10826",
"양정1동","총인구","2020.02 월","8911","20632","9839","10793",
"양정1동","총인구","2020.03 월","8931","20637","9820","10817",
"양정1동","총인구","2020.04 월","8958","20647","9840","10807",
"양정1동","총인구","2020.05 월","8991","20652","9847","10805",
"양정1동","총인구","2020.06 월","8962","20598","9820","10778",
"양정1동","총인구","2020.07 월","8958","20555","9787","10768",
"양정1동","총인구","2020.08 월","9094","20686","9824","10862",
"양정1동","총인구","2020.09 월","9149","20705","9844","10861",
"양정1동","총인구","2020.10 월","9194","20709","9825","10884",
"양정1동","총인구","2020.11 월","9230","20671","9781","10890",
"양정1동","총인구","2020.12 월","9266","20662","9769","10893",
"양정1동","총인구","2021.01 월","9258","20589","9705","10884",
"양정1동","총인구","2021.02 월","9260","20535","9683","10852",
"양정1동","총인구","2021.03 월","9170","20415","9620","10795",
"양정1동","총인구","2021.04 월","9177","20388","9602","10786",
"양정1동","총인구","2021.05 월","9198","20402","9608","10794",
"양정1동","총인구","2021.06 월","9208","20373","9590","10783",
"양정1동","총인구","2021.07 월","9240","20364","9591","10773",
"양정1동","총인구","2021.08 월","9231","20326","9568","10758",
"양정1동","총인구","2021.09 월","9249","20323","9554","10769",
"양정1동","총인구","2021.10 월","9251","20273","9525","10748",
"양정1동","총인구","2021.11 월","9227","20184","9485","10699",
"양정1동","총인구","2021.12 월","9215","20139","9468","10671",
"양정1동","총인구","2022.01 월","9193","20062","9439","10623",
"양정1동","총인구","2022.02 월","9180","19953","9388","10565",
"양정1동","총인구","2022.03 월","9174","19930","9364","10566",
"양정1동","총인구","2022.04 월","9174","19875","9331","10544",
"양정1동","총인구","2022.05 월","9179","19832","9301","10531",
"양정1동","총인구","2022.06 월","9175","19809","9288","10521",
"양정1동","총인구","2022.07 월","9142","19709","9246","10463",
"양정1동","총인구","2022.08 월","9156","19681","9230","10451",
"양정1동","총인구","2022.09 월","9123","19609","9191","10418",
"양정1동","총인구","2022.10 월","9127","19556","9156","10400",
"양정1동","총인구","2022.11 월","9116","19468","9120","10348",
"양정1동","총인구","2022.12 월","9114","19427","9104","10323",
"양정1동","총인구","2023.01 월","9108","19377","9056","10321",
"양정1동","총인구","2023.02 월","9139","19342","9046","10296",
"양정1동","총인구","2023.03 월","9140","19305","9020","10285",
"양정1동","총인구","2023.04 월","9133","19234","8972","10262",
"양정1동","총인구","2023.05 월","9134","19250","8977","10273",
"양정1동","총인구","2023.06 월","9135","19240","8971","10269",
"양정1동","총인구","2023.07 월","9188","19291","9008","10283",
"양정1동","총인구","2023.08 월","9271","19372","9036","10336",
"양정1동","총인구","2023.09 월","9280","19336","9017","10319",
"양정1동","총인구","2023.10 월","9280","19288","8985","10303",
"양정1동","총인구","2023.11 월","9275","19274","8981","10293",
"양정1동","총인구","2023.12 월","9266","19215","8958","10257",
"양정1동","총인구","2024.01 월","9238","19104","8905","10199",
"양정1동","총인구","2024.02 월","9216","19099","8891","10208",
"양정1동","총인구","2024.03 월","9253","19106","8889","10217",
"양정1동","총인구","2024.04 월","9240","19077","8868","10209",
"양정1동","총인구","2024.05 월","9308","19142","8892","10250",
"양정1동","총인구","2024.06 월","9300","19106","8868","10238",
"양정1동","총인구","2024.07 월","9306","19046","8831","10215",
"양정1동","총인구","2024.08 월","9311","19032","8829","10203",
"양정1동","총인구","2024.09 월","9311","19001","8803","10198",
"양정1동","총인구","2024.10 월","9286","18942","8768","10174",
"양정1동","총인구","2024.11 월","9257","18888","8738","10150",
"양정1동","총인구","2024.12 월","9241","18801","8691","10110",
"양정2동","총인구","2020.01 월","7685","13254","6067","7187",
"양정2동","총인구","2020.02 월","7720","13231","6052","7179",
"양정2동","총인구","2020.03 월","7757","13272","6062","7210",
"양정2동","총인구","2020.04 월","7771","13234","6054","7180",
"양정2동","총인구","2020.05 월","7799","13218","6052","7166",
"양정2동","총인구","2020.06 월","7820","13247","6057","7190",
"양정2동","총인구","2020.07 월","7811","13207","6044","7163",
"양정2동","총인구","2020.08 월","7820","13149","6027","7122",
"양정2동","총인구","2020.09 월","7835","13106","6000","7106",
"양정2동","총인구","2020.10 월","7831","13092","6009","7083",
"양정2동","총인구","2020.11 월","7841","13056","5987","7069",
"양정2동","총인구","2020.12 월","7850","13012","5985","7027",
"양정2동","총인구","2021.01 월","7846","12979","5949","7030",
"양정2동","총인구","2021.02 월","7895","12985","5940","7045",
"양정2동","총인구","2021.03 월","7805","12863","5877","6986",
"양정2동","총인구","2021.04 월","7823","12855","5890","6965",
"양정2동","총인구","2021.05 월","7809","12769","5833","6936",
"양정2동","총인구","2021.06 월","7737","12613","5754","6859",
"양정2동","총인구","2021.07 월","7653","12424","5667","6757",
"양정2동","총인구","2021.08 월","7602","12290","5600","6690",
"양정2동","총인구","2021.09 월","7608","12208","5562","6646",
"양정2동","총인구","2021.10 월","7580","12141","5535","6606",
"양정2동","총인구","2021.11 월","7569","12077","5504","6573",
"양정2동","총인구","2021.12 월","7560","12055","5508","6547",
"양정2동","총인구","2022.01 월","7524","11979","5468","6511",
"양정2동","총인구","2022.02 월","7545","11971","5467","6504",
"양정2동","총인구","2022.03 월","7573","11972","5486","6486",
"양정2동","총인구","2022.04 월","7569","11930","5476","6454",
"양정2동","총인구","2022.05 월","7600","11952","5474","6478",
"양정2동","총인구","2022.06 월","7632","11981","5502","6479",
"양정2동","총인구","2022.07 월","7658","11988","5501","6487",
"양정2동","총인구","2022.08 월","7700","12007","5482","6525",
"양정2동","총인구","2022.09 월","7704","12002","5469","6533",
"양정2동","총인구","2022.10 월","7685","11955","5460","6495",
"양정2동","총인구","2022.11 월","7619","11890","5432","6458",
"양정2동","총인구","2022.12 월","7583","11828","5399","6429",
"양정2동","총인구","2023.01 월","7576","11784","5377","6407",
"양정2동","총인구","2023.02 월","7604","11792","5375","6417",
"양정2동","총인구","2023.03 월","7600","11754","5374","6380",
"양정2동","총인구","2023.04 월","7595","11731","5365","6366",
"양정2동","총인구","2023.05 월","7622","11745","5389","6356",
"양정2동","총인구","2023.06 월","7652","11759","5390","6369",
"양정2동","총인구","2023.07 월","7634","11727","5366","6361",
"양정2동","총인구","2023.08 월","7648","11742","5375","6367",
"양정2동","총인구","2023.09 월","8131","12991","5977","7014",
"양정2동","총인구","2023.10 월","8481","13922","6418","7504",
"양정2동","총인구","2023.11 월","8640","14271","6574","7697",
"양정2동","총인구","2023.12 월","8753","14547","6706","7841",
"양정2동","총인구","2024.01 월","8841","14702","6769","7933",
"양정2동","총인구","2024.02 월","8950","14835","6803","8032",
"양정2동","총인구","2024.03 월","9016","14962","6866","8096",
"양정2동","총인구","2024.04 월","9009","14961","6872","8089",
"양정2동","총인구","2024.05 월","9042","15025","6920","8105",
"양정2동","총인구","2024.06 월","9058","15046","6929","8117",
"양정2동","총인구","2024.07 월","9037","14986","6885","8101",
"양정2동","총인구","2024.08 월","9085","15075","6930","8145",
"양정2동","총인구","2024.09 월","9128","15141","6963","8178",
"양정2동","총인구","2024.10 월","9133","15159","6973","8186",
"양정2동","총인구","2024.11 월","9144","15136","6946","8190",
"양정2동","총인구","2024.12 월","9140","15130","6935","8195",
"전포1동","총인구","2020.01 월","10325","18401","8763","9638",
"전포1동","총인구","2020.02 월","10363","18418","8770","9648",
"전포1동","총인구","2020.03 월","10352","18382","8748","9634",
"전포1동","총인구","2020.04 월","10361","18360","8706","9654",
"전포1동","총인구","2020.05 월","10431","18369","8713","9656",
"전포1동","총인구","2020.06 월","10420","18318","8682","9636",
"전포1동","총인구","2020.07 월","10468","18311","8683","9628",
"전포1동","총인구","2020.08 월","10459","18247","8675","9572",
"전포1동","총인구","2020.09 월","10449","18226","8664","9562",
"전포1동","총인구","2020.10 월","10973","19394","9263","10131",
"전포1동","총인구","2020.11 월","11684","21084","10124","10960",
"전포1동","총인구","2020.12 월","12058","21999","10535","11464",
"전포1동","총인구","2021.01 월","12248","22375","10704","11671",
"전포1동","총인구","2021.02 월","12401","22588","10802","11786",
"전포1동","총인구","2021.03 월","12302","22499","10777","11722",
"전포1동","총인구","2021.04 월","12283","22466","10769","11697",
"전포1동","총인구","2021.05 월","12267","22429","10742","11687",
"전포1동","총인구","2021.06 월","12223","22315","10682","11633",
"전포1동","총인구","2021.07 월","12165","22219","10623","11596",
"전포1동","총인구","2021.08 월","12135","22148","10586","11562",
"전포1동","총인구","2021.09 월","12084","22055","10533","11522",
"전포1동","총인구","2021.10 월","12097","22073","10537","11536",
"전포1동","총인구","2021.11 월","12053","21997","10506","11491",
"전포1동","총인구","2021.12 월","12050","21937","10472","11465",
"전포1동","총인구","2022.01 월","12067","21936","10482","11454",
"전포1동","총인구","2022.02 월","12125","22001","10490","11511",
"전포1동","총인구","2022.03 월","12123","21948","10490","11458",
"전포1동","총인구","2022.04 월","12083","21846","10444","11402",
"전포1동","총인구","2022.05 월","12054","21804","10408","11396",
"전포1동","총인구","2022.06 월","12060","21806","10424","11382",
"전포1동","총인구","2022.07 월","12028","21718","10379","11339",
"전포1동","총인구","2022.08 월","12046","21701","10384","11317",
"전포1동","총인구","2022.09 월","12000","21585","10335","11250",
"전포1동","총인구","2022.10 월","11972","21462","10314","11148",
"전포1동","총인구","2022.11 월","11969","21395","10276","11119",
"전포1동","총인구","2022.12 월","11998","21369","10255","11114",
"전포1동","총인구","2023.01 월","12027","21366","10248","11118",
"전포1동","총인구","2023.02 월","12024","21256","10184","11072",
"전포1동","총인구","2023.03 월","12042","21234","10165","11069",
"전포1동","총인구","2023.04 월","12048","21226","10165","11061",
"전포1동","총인구","2023.05 월","12110","21314","10185","11129",
"전포1동","총인구","2023.06 월","12103","21256","10167","11089",
"전포1동","총인구","2023.07 월","12108","21241","10168","11073",
"전포1동","총인구","2023.08 월","12100","21234","10159","11075",
"전포1동","총인구","2023.09 월","12044","21151","10122","11029",
"전포1동","총인구","2023.10 월","12009","21073","10082","10991",
"전포1동","총인구","2023.11 월","12017","21057","10081","10976",
"전포1동","총인구","2023.12 월","11968","20963","10020","10943",
"전포1동","총인구","2024.01 월","11979","20958","10012","10946",
"전포1동","총인구","2024.02 월","12017","20930","9991","10939",
"전포1동","총인구","2024.03 월","12037","20920","9990","10930",
"전포1동","총인구","2024.04 월","12020","20879","9947","10932",
"전포1동","총인구","2024.05 월","12031","20870","9957","10913",
"전포1동","총인구","2024.06 월","12039","20871","9963","10908",
"전포1동","총인구","2024.07 월","12030","20827","9940","10887",
"전포1동","총인구","2024.08 월","12040","20801","9916","10885",
"전포1동","총인구","2024.09 월","12029","20761","9897","10864",
"전포1동","총인구","2024.10 월","11948","20598","9818","10780",
"전포1동","총인구","2024.11 월","11936","20534","9775","10759",
"전포1동","총인구","2024.12 월","11916","20474","9734","10740",
"전포2동","총인구","2020.01 월","11059","21649","10188","11461",
"전포2동","총인구","2020.02 월","11116","21658","10204","11454",
"전포2동","총인구","2020.03 월","11185","21680","10218","11462",
"전포2동","총인구","2020.04 월","11239","21671","10186","11485",
"전포2동","총인구","2020.05 월","11260","21658","10183","11475",
"전포2동","총인구","2020.06 월","11264","21647","10194","11453",
"전포2동","총인구","2020.07 월","11282","21631","10181","11450",
"전포2동","총인구","2020.08 월","11286","21565","10156","11409",
"전포2동","총인구","2020.09 월","11270","21500","10104","11396",
"전포2동","총인구","2020.10 월","11250","21398","10081","11317",
"전포2동","총인구","2020.11 월","11245","21271","10011","11260",
"전포2동","총인구","2020.12 월","11284","21277","10005","11272",
"전포2동","총인구","2021.01 월","11348","21290","10019","11271",
"전포2동","총인구","2021.02 월","11402","21308","10007","11301",
"전포2동","총인구","2021.03 월","11338","21153","9931","11222",
"전포2동","총인구","2021.04 월","11355","21126","9924","11202",
"전포2동","총인구","2021.05 월","11391","21131","9933","11198",
"전포2동","총인구","2021.06 월","11417","21165","9954","11211",
"전포2동","총인구","2021.07 월","11432","21151","9947","11204",
"전포2동","총인구","2021.08 월","11426","21074","9895","11179",
"전포2동","총인구","2021.09 월","11479","21123","9908","11215",
"전포2동","총인구","2021.10 월","11482","21111","9901","11210",
"전포2동","총인구","2021.11 월","11477","21089","9878","11211",
"전포2동","총인구","2021.12 월","11475","21015","9827","11188",
"전포2동","총인구","2022.01 월","11499","21001","9814","11187",
"전포2동","총인구","2022.02 월","11521","20967","9794","11173",
"전포2동","총인구","2022.03 월","11555","20971","9792","11179",
"전포2동","총인구","2022.04 월","11557","20939","9764","11175",
"전포2동","총인구","2022.05 월","11579","20926","9783","11143",
"전포2동","총인구","2022.06 월","11569","20902","9770","11132",
"전포2동","총인구","2022.07 월","11565","20894","9759","11135",
"전포2동","총인구","2022.08 월","11574","20870","9737","11133",
"전포2동","총인구","2022.09 월","11543","20842","9721","11121",
"전포2동","총인구","2022.10 월","12014","21928","10261","11667",
"전포2동","총인구","2022.11 월","12311","22593","10557","12036",
"전포2동","총인구","2022.12 월","12481","22932","10706","12226",
"전포2동","총인구","2023.01 월","12556","23137","10802","12335",
"전포2동","총인구","2023.02 월","12652","23309","10870","12439",
"전포2동","총인구","2023.03 월","12732","23406","10916","12490",
"전포2동","총인구","2023.04 월","12762","23458","10945","12513",
"전포2동","총인구","2023.05 월","12775","23458","10949","12509",
"전포2동","총인구","2023.06 월","12801","23513","10971","12542",
"전포2동","총인구","2023.07 월","12825","23532","10986","12546",
"전포2동","총인구","2023.08 월","12888","23579","11026","12553",
"전포2동","총인구","2023.09 월","12924","23626","11050","12576",
"전포2동","총인구","2023.10 월","12901","23550","11013","12537",
"전포2동","총인구","2023.11 월","12908","23537","10990","12547",
"전포2동","총인구","2023.12 월","12931","23541","11002","12539",
"전포2동","총인구","2024.01 월","12901","23458","10978","12480",
"전포2동","총인구","2024.02 월","12937","23500","10994","12506",
"전포2동","총인구","2024.03 월","12979","23528","11034","12494",
"전포2동","총인구","2024.04 월","12975","23532","11022","12510",
"전포2동","총인구","2024.05 월","12990","23540","11016","12524",
"전포2동","총인구","2024.06 월","12983","23533","10999","12534",
"전포2동","총인구","2024.07 월","12954","23470","10956","12514",
"전포2동","총인구","2024.08 월","12963","23486","10961","12525",
"전포2동","총인구","2024.09 월","12982","23507","10968","12539",
"전포2동","총인구","2024.10 월","12985","23484","10950","12534",
"전포2동","총인구","2024.11 월","12983","23455","10926","12529",
"전포2동","총인구","2024.12 월","12971","23416","10912","12504",
"부암1동","총인구","2020.01 월","9533","23071","11271","11800",
"부암1동","총인구","2020.02 월","9489","22946","11208","11738",
"부암1동","총인구","2020.03 월","9480","22929","11191","11738",
"부암1동","총인구","2020.04 월","9425","22797","11116","11681",
"부암1동","총인구","2020.05 월","9387","22699","11068","11631",
"부암1동","총인구","2020.06 월","9348","22588","11018","11570",
"부암1동","총인구","2020.07 월","9381","22579","11000","11579",
"부암1동","총인구","2020.08 월","9534","22846","11119","11727",
"부암1동","총인구","2020.09 월","9622","22993","11195","11798",
"부암1동","총인구","2020.10 월","9662","23050","11231","11819",
"부암1동","총인구","2020.11 월","9709","23107","11263","11844",
"부암1동","총인구","2020.12 월","9764","23185","11315","11870",
"부암1동","총인구","2021.01 월","9786","23202","11322","11880",
"부암1동","총인구","2021.02 월","9817","23217","11328","11889",
"부암1동","총인구","2021.03 월","9623","22992","11242","11750",
"부암1동","총인구","2021.04 월","9624","22979","11247","11732",
"부암1동","총인구","2021.05 월","9634","22978","11245","11733",
"부암1동","총인구","2021.06 월","9622","22943","11244","11699",
"부암1동","총인구","2021.07 월","9645","22962","11248","11714",
"부암1동","총인구","2021.08 월","9711","23005","11265","11740",
"부암1동","총인구","2021.09 월","9766","23053","11274","11779",
"부암1동","총인구","2021.10 월","9799","23063","11261","11802",
"부암1동","총인구","2021.11 월","9826","23087","11264","11823",
"부암1동","총인구","2021.12 월","9858","23099","11259","11840",
"부암1동","총인구","2022.01 월","9890","23087","11263","11824",
"부암1동","총인구","2022.02 월","9966","23117","11253","11864",
"부암1동","총인구","2022.03 월","10053","23229","11291","11938",
"부암1동","총인구","2022.04 월","10140","23317","11318","11999",
"부암1동","총인구","2022.05 월","10168","23367","11331","12036",
"부암1동","총인구","2022.06 월","10181","23390","11332","12058",
"부암1동","총인구","2022.07 월","10180","23367","11328","12039",
"부암1동","총인구","2022.08 월","10185","23337","11309","12028",
"부암1동","총인구","2022.09 월","10138","23278","11281","11997",
"부암1동","총인구","2022.10 월","10119","23166","11219","11947",
"부암1동","총인구","2022.11 월","10069","22933","11113","11820",
"부암1동","총인구","2022.12 월","10135","23023","11162","11861",
"부암1동","총인구","2023.01 월","10246","23235","11251","11984",
"부암1동","총인구","2023.02 월","10321","23327","11302","12025",
"부암1동","총인구","2023.03 월","10393","23457","11357","12100",
"부암1동","총인구","2023.04 월","10449","23524","11392","12132",
"부암1동","총인구","2023.05 월","10478","23557","11404","12153",
"부암1동","총인구","2023.06 월","10519","23594","11411","12183",
"부암1동","총인구","2023.07 월","10543","23635","11432","12203",
"부암1동","총인구","2023.08 월","10557","23670","11456","12214",
"부암1동","총인구","2023.09 월","10566","23627","11432","12195",
"부암1동","총인구","2023.10 월","10559","23664","11442","12222",
"부암1동","총인구","2023.11 월","10565","23637","11429","12208",
"부암1동","총인구","2023.12 월","10545","23574","11395","12179",
"부암1동","총인구","2024.01 월","10509","23457","11338","12119",
"부암1동","총인구","2024.02 월","10518","23410","11319","12091",
"부암1동","총인구","2024.03 월","10496","23303","11276","12027",
"부암1동","총인구","2024.04 월","10476","23248","11253","11995",
"부암1동","총인구","2024.05 월","10489","23286","11272","12014",
"부암1동","총인구","2024.06 월","10497","23263","11265","11998",
"부암1동","총인구","2024.07 월","10509","23268","11264","12004",
"부암1동","총인구","2024.08 월","10495","23232","11233","11999",
"부암1동","총인구","2024.09 월","10517","23267","11248","12019",
"부암1동","총인구","2024.10 월","10521","23277","11243","12034",
"부암1동","총인구","2024.11 월","10527","23231","11211","12020",
"부암1동","총인구","2024.12 월","10534","23220","11196","12024",
"부암3동","총인구","2020.01 월","7100","18634","9225","9409",
"부암3동","총인구","2020.02 월","7085","18554","9181","9373",
"부암3동","총인구","2020.03 월","7075","18497","9142","9355",
"부암3동","총인구","2020.04 월","7050","18400","9083","9317",
"부암3동","총인구","2020.05 월","7055","18357","9058","9299",
"부암3동","총인구","2020.06 월","7059","18298","9016","9282",
"부암3동","총인구","2020.07 월","7066","18270","9003","9267",
"부암3동","총인구","2020.08 월","7057","18233","8986","9247",
"부암3동","총인구","2020.09 월","7056","18182","8955","9227",
"부암3동","총인구","2020.10 월","7038","18115","8922","9193",
"부암3동","총인구","2020.11 월","7036","18053","8881","9172",
"부암3동","총인구","2020.12 월","7037","18001","8848","9153",
"부암3동","총인구","2021.01 월","7042","17965","8815","9150",
"부암3동","총인구","2021.02 월","7050","17923","8780","9143",
"부암3동","총인구","2021.03 월","6996","17821","8729","9092",
"부암3동","총인구","2021.04 월","7003","17791","8722","9069",
"부암3동","총인구","2021.05 월","7002","17767","8718","9049",
"부암3동","총인구","2021.06 월","6994","17729","8699","9030",
"부암3동","총인구","2021.07 월","6994","17706","8701","9005",
"부암3동","총인구","2021.08 월","7000","17700","8692","9008",
"부암3동","총인구","2021.09 월","6987","17643","8664","8979",
"부암3동","총인구","2021.10 월","6972","17576","8632","8944",
"부암3동","총인구","2021.11 월","6978","17535","8619","8916",
"부암3동","총인구","2021.12 월","6958","17476","8584","8892",
"부암3동","총인구","2022.01 월","6960","17444","8569","8875",
"부암3동","총인구","2022.02 월","6961","17403","8548","8855",
"부암3동","총인구","2022.03 월","6955","17355","8511","8844",
"부암3동","총인구","2022.04 월","6937","17299","8487","8812",
"부암3동","총인구","2022.05 월","6934","17269","8470","8799",
"부암3동","총인구","2022.06 월","6927","17226","8447","8779",
"부암3동","총인구","2022.07 월","6925","17185","8422","8763",
"부암3동","총인구","2022.08 월","6926","17177","8418","8759",
"부암3동","총인구","2022.09 월","6898","17141","8400","8741",
"부암3동","총인구","2022.10 월","6889","17106","8369","8737",
"부암3동","총인구","2022.11 월","6879","17091","8363","8728",
"부암3동","총인구","2022.12 월","6849","17011","8323","8688",
"부암3동","총인구","2023.01 월","6834","16983","8310","8673",
"부암3동","총인구","2023.02 월","6822","16919","8277","8642",
"부암3동","총인구","2023.03 월","6804","16858","8257","8601",
"부암3동","총인구","2023.04 월","6806","16823","8225","8598",
"부암3동","총인구","2023.05 월","6805","16807","8208","8599",
"부암3동","총인구","2023.06 월","6793","16749","8180","8569",
"부암3동","총인구","2023.07 월","6783","16696","8158","8538",
"부암3동","총인구","2023.08 월","6777","16679","8151","8528",
"부암3동","총인구","2023.09 월","6770","16629","8122","8507",
"부암3동","총인구","2023.10 월","6747","16576","8092","8484",
"부암3동","총인구","2023.11 월","6741","16570","8087","8483",
"부암3동","총인구","2023.12 월","6770","16589","8092","8497",
"부암3동","총인구","2024.01 월","7392","18108","8814","9294",
"부암3동","총인구","2024.02 월","7964","19483","9509","9974",
"부암3동","총인구","2024.03 월","8196","20010","9773","10237",
"부암3동","총인구","2024.04 월","8362","20343","9955","10388",
"부암3동","총인구","2024.05 월","8494","20622","10086","10536",
"부암3동","총인구","2024.06 월","8567","20749","10140","10609",
"부암3동","총인구","2024.07 월","8610","20867","10189","10678",
"부암3동","총인구","2024.08 월","8646","20947","10213","10734",
"부암3동","총인구","2024.09 월","8682","21067","10267","10800",
"부암3동","총인구","2024.10 월","8704","21153","10318","10835",
"부암3동","총인구","2024.11 월","8721","21159","10312","10847",
"부암3동","총인구","2024.12 월","8726","21167","10315","10852",
"당감1동","총인구","2020.01 월","10514","24878","11933","12945",
"당감1동","총인구","2020.02 월","10499","24810","11889","12921",
"당감1동","총인구","2020.03 월","10512","24769","11863","12906",
"당감1동","총인구","2020.04 월","10521","24688","11818","12870",
"당감1동","총인구","2020.05 월","10516","24591","11751","12840",
"당감1동","총인구","2020.06 월","10521","24546","11712","12834",
"당감1동","총인구","2020.07 월","10507","24433","11679","12754",
"당감1동","총인구","2020.08 월","10489","24323","11620","12703",
"당감1동","총인구","2020.09 월","10479","24229","11560","12669",
"당감1동","총인구","2020.10 월","10481","24181","11527","12654",
"당감1동","총인구","2020.11 월","10453","24063","11458","12605",
"당감1동","총인구","2020.12 월","10460","23957","11420","12537",
"당감1동","총인구","2021.01 월","10458","23873","11385","12488",
"당감1동","총인구","2021.02 월","10484","23868","11381","12487",
"당감1동","총인구","2021.03 월","10358","23632","11295","12337",
"당감1동","총인구","2021.04 월","10359","23566","11255","12311",
"당감1동","총인구","2021.05 월","10355","23485","11204","12281",
"당감1동","총인구","2021.06 월","10359","23480","11199","12281",
"당감1동","총인구","2021.07 월","10358","23412","11167","12245",
"당감1동","총인구","2021.08 월","10359","23380","11155","12225",
"당감1동","총인구","2021.09 월","10369","23329","11122","12207",
"당감1동","총인구","2021.10 월","10361","23298","11108","12190",
"당감1동","총인구","2021.11 월","10363","23243","11091","12152",
"당감1동","총인구","2021.12 월","10377","23219","11067","12152",
"당감1동","총인구","2022.01 월","10367","23169","11044","12125",
"당감1동","총인구","2022.02 월","10348","23059","11000","12059",
"당감1동","총인구","2022.03 월","10330","22993","10967","12026",
"당감1동","총인구","2022.04 월","10341","22986","10961","12025",
"당감1동","총인구","2022.05 월","10341","22944","10935","12009",
"당감1동","총인구","2022.06 월","10328","22891","10920","11971",
"당감1동","총인구","2022.07 월","10331","22839","10894","11945",
"당감1동","총인구","2022.08 월","10315","22740","10836","11904",
"당감1동","총인구","2022.09 월","10269","22657","10781","11876",
"당감1동","총인구","2022.10 월","10246","22523","10722","11801",
"당감1동","총인구","2022.11 월","10214","22419","10674","11745",
"당감1동","총인구","2022.12 월","10205","22376","10651","11725",
"당감1동","총인구","2023.01 월","10194","22325","10632","11693",
"당감1동","총인구","2023.02 월","10174","22234","10557","11677",
"당감1동","총인구","2023.03 월","10153","22123","10505","11618",
"당감1동","총인구","2023.04 월","10132","22014","10453","11561",
"당감1동","총인구","2023.05 월","10116","21963","10437","11526",
"당감1동","총인구","2023.06 월","10106","21905","10419","11486",
"당감1동","총인구","2023.07 월","10104","21869","10407","11462",
"당감1동","총인구","2023.08 월","10098","21842","10386","11456",
"당감1동","총인구","2023.09 월","10096","21814","10382","11432",
"당감1동","총인구","2023.10 월","10062","21736","10341","11395",
"당감1동","총인구","2023.11 월","10056","21685","10312","11373",
"당감1동","총인구","2023.12 월","10042","21590","10255","11335",
"당감1동","총인구","2024.01 월","10000","21407","10150","11257",
"당감1동","총인구","2024.02 월","9971","21264","10060","11204",
"당감1동","총인구","2024.03 월","9952","21151","9991","11160",
"당감1동","총인구","2024.04 월","9925","21064","9945","11119",
"당감1동","총인구","2024.05 월","9919","21032","9937","11095",
"당감1동","총인구","2024.06 월","9926","21010","9915","11095",
"당감1동","총인구","2024.07 월","9917","20989","9904","11085",
"당감1동","총인구","2024.08 월","9918","20958","9889","11069",
"당감1동","총인구","2024.09 월","9928","20925","9880","11045",
"당감1동","총인구","2024.10 월","9920","20921","9882","11039",
"당감1동","총인구","2024.11 월","9905","20860","9856","11004",
"당감1동","총인구","2024.12 월","9901","20819","9834","10985",
"당감2동","총인구","2020.01 월","4436","10471","5061","5410",
"당감2동","총인구","2020.02 월","4444","10476","5057","5419",
"당감2동","총인구","2020.03 월","4474","10507","5073","5434",
"당감2동","총인구","2020.04 월","4461","10459","5054","5405",
"당감2동","총인구","2020.05 월","4473","10457","5044","5413",
"당감2동","총인구","2020.06 월","4494","10434","5024","5410",
"당감2동","총인구","2020.07 월","4506","10426","5017","5409",
"당감2동","총인구","2020.08 월","4539","10423","5010","5413",
"당감2동","총인구","2020.09 월","4560","10420","5005","5415",
"당감2동","총인구","2020.10 월","4572","10439","5019","5420",
"당감2동","총인구","2020.11 월","4584","10401","5000","5401",
"당감2동","총인구","2020.12 월","4616","10432","5010","5422",
"당감2동","총인구","2021.01 월","4669","10510","5037","5473",
"당감2동","총인구","2021.02 월","4684","10507","5023","5484",
"당감2동","총인구","2021.03 월","4630","10441","4992","5449",
"당감2동","총인구","2021.04 월","4625","10413","4972","5441",
"당감2동","총인구","2021.05 월","4649","10419","4971","5448",
"당감2동","총인구","2021.06 월","4637","10385","4970","5415",
"당감2동","총인구","2021.07 월","4646","10381","4949","5432",
"당감2동","총인구","2021.08 월","4661","10399","4947","5452",
"당감2동","총인구","2021.09 월","4657","10380","4937","5443",
"당감2동","총인구","2021.10 월","4648","10338","4916","5422",
"당감2동","총인구","2021.11 월","4666","10351","4920","5431",
"당감2동","총인구","2021.12 월","4661","10332","4916","5416",
"당감2동","총인구","2022.01 월","4657","10321","4907","5414",
"당감2동","총인구","2022.02 월","4663","10291","4898","5393",
"당감2동","총인구","2022.03 월","4660","10265","4901","5364",
"당감2동","총인구","2022.04 월","4661","10254","4894","5360",
"당감2동","총인구","2022.05 월","4656","10254","4893","5361",
"당감2동","총인구","2022.06 월","4664","10256","4894","5362",
"당감2동","총인구","2022.07 월","4665","10244","4884","5360",
"당감2동","총인구","2022.08 월","4677","10238","4880","5358",
"당감2동","총인구","2022.09 월","4657","10233","4857","5376",
"당감2동","총인구","2022.10 월","4639","10151","4821","5330",
"당감2동","총인구","2022.11 월","4628","10096","4793","5303",
"당감2동","총인구","2022.12 월","4624","10075","4784","5291",
"당감2동","총인구","2023.01 월","4613","10048","4761","5287",
"당감2동","총인구","2023.02 월","4631","10043","4746","5297",
"당감2동","총인구","2023.03 월","4634","10039","4744","5295",
"당감2동","총인구","2023.04 월","4625","10000","4712","5288",
"당감2동","총인구","2023.05 월","4618","9997","4720","5277",
"당감2동","총인구","2023.06 월","4624","9978","4707","5271",
"당감2동","총인구","2023.07 월","4622","9989","4713","5276",
"당감2동","총인구","2023.08 월","4606","9957","4699","5258",
"당감2동","총인구","2023.09 월","4654","10097","4783","5314",
"당감2동","총인구","2023.10 월","4918","10751","5100","5651",
"당감2동","총인구","2023.11 월","5108","11194","5317","5877",
"당감2동","총인구","2023.12 월","5173","11363","5388","5975",
"당감2동","총인구","2024.01 월","5233","11520","5459","6061",
"당감2동","총인구","2024.02 월","5248","11555","5474","6081",
"당감2동","총인구","2024.03 월","5274","11599","5500","6099",
"당감2동","총인구","2024.04 월","5295","11644","5516","6128",
"당감2동","총인구","2024.05 월","5277","11578","5499","6079",
"당감2동","총인구","2024.06 월","5280","11606","5515","6091",
"당감2동","총인구","2024.07 월","5297","11641","5523","6118",
"당감2동","총인구","2024.08 월","5307","11683","5551","6132",
"당감2동","총인구","2024.09 월","5310","11698","5568","6130",
"당감2동","총인구","2024.10 월","5307","11683","5564","6119",
"당감2동","총인구","2024.11 월","5319","11709","5574","6135",
"당감2동","총인구","2024.12 월","5329","11744","5590","6154",
"당감4동","총인구","2020.01 월","5269","12317","6039","6278",
"당감4동","총인구","2020.02 월","5274","12301","6035","6266",
"당감4동","총인구","2020.03 월","5255","12198","5984","6214",
"당감4동","총인구","2020.04 월","5242","12142","5946","6196",
"당감4동","총인구","2020.05 월","5225","12071","5911","6160",
"당감4동","총인구","2020.06 월","5224","12036","5892","6144",
"당감4동","총인구","2020.07 월","5221","12012","5876","6136",
"당감4동","총인구","2020.08 월","5232","11990","5872","6118",
"당감4동","총인구","2020.09 월","5220","11908","5840","6068",
"당감4동","총인구","2020.10 월","5206","11842","5800","6042",
"당감4동","총인구","2020.11 월","5206","11818","5785","6033",
"당감4동","총인구","2020.12 월","5190","11752","5747","6005",
"당감4동","총인구","2021.01 월","5193","11717","5746","5971",
"당감4동","총인구","2021.02 월","5195","11663","5714","5949",
"당감4동","총인구","2021.03 월","5124","11541","5652","5889",
"당감4동","총인구","2021.04 월","5137","11535","5649","5886",
"당감4동","총인구","2021.05 월","5137","11514","5633","5881",
"당감4동","총인구","2021.06 월","5135","11486","5621","5865",
"당감4동","총인구","2021.07 월","5136","11455","5608","5847",
"당감4동","총인구","2021.08 월","5140","11433","5587","5846",
"당감4동","총인구","2021.09 월","5131","11425","5589","5836",
"당감4동","총인구","2021.10 월","5141","11415","5580","5835",
"당감4동","총인구","2021.11 월","5135","11386","5564","5822",
"당감4동","총인구","2021.12 월","5139","11380","5560","5820",
"당감4동","총인구","2022.01 월","5136","11345","5543","5802",
"당감4동","총인구","2022.02 월","5130","11320","5524","5796",
"당감4동","총인구","2022.03 월","5128","11280","5497","5783",
"당감4동","총인구","2022.04 월","5136","11267","5488","5779",
"당감4동","총인구","2022.05 월","5128","11249","5464","5785",
"당감4동","총인구","2022.06 월","5124","11220","5454","5766",
"당감4동","총인구","2022.07 월","5138","11222","5459","5763",
"당감4동","총인구","2022.08 월","5143","11199","5433","5766",
"당감4동","총인구","2022.09 월","5126","11148","5401","5747",
"당감4동","총인구","2022.10 월","5114","11105","5385","5720",
"당감4동","총인구","2022.11 월","5093","11064","5369","5695",
"당감4동","총인구","2022.12 월","5090","11042","5346","5696",
"당감4동","총인구","2023.01 월","5084","11015","5338","5677",
"당감4동","총인구","2023.02 월","5075","10988","5320","5668",
"당감4동","총인구","2023.03 월","5076","10981","5322","5659",
"당감4동","총인구","2023.04 월","5063","10942","5297","5645",
"당감4동","총인구","2023.05 월","5054","10897","5275","5622",
"당감4동","총인구","2023.06 월","5035","10862","5250","5612",
"당감4동","총인구","2023.07 월","5038","10858","5239","5619",
"당감4동","총인구","2023.08 월","5035","10816","5216","5600",
"당감4동","총인구","2023.09 월","5026","10803","5214","5589",
"당감4동","총인구","2023.10 월","5020","10791","5204","5587",
"당감4동","총인구","2023.11 월","4990","10725","5169","5556",
"당감4동","총인구","2023.12 월","4974","10679","5149","5530",
"당감4동","총인구","2024.01 월","4933","10533","5084","5449",
"당감4동","총인구","2024.02 월","4907","10395","5018","5377",
"당감4동","총인구","2024.03 월","4903","10336","4983","5353",
"당감4동","총인구","2024.04 월","4897","10300","4982","5318",
"당감4동","총인구","2024.05 월","4897","10272","4973","5299",
"당감4동","총인구","2024.06 월","4894","10245","4961","5284",
"당감4동","총인구","2024.07 월","4894","10238","4961","5277",
"당감4동","총인구","2024.08 월","4899","10240","4968","5272",
"당감4동","총인구","2024.09 월","4897","10216","4957","5259",
"당감4동","총인구","2024.10 월","4898","10204","4942","5262",
"당감4동","총인구","2024.11 월","4897","10176","4939","5237",
"당감4동","총인구","2024.12 월","4897","10159","4930","5229",
"가야1동","총인구","2020.01 월","10217","21139","10518","10621",
"가야1동","총인구","2020.02 월","10236","21072","10503","10569",
"가야1동","총인구","2020.03 월","10314","21088","10522","10566",
"가야1동","총인구","2020.04 월","10319","20956","10478","10478",
"가야1동","총인구","2020.05 월","10352","20905","10448","10457",
"가야1동","총인구","2020.06 월","10339","20863","10419","10444",
"가야1동","총인구","2020.07 월","10362","20849","10405","10444",
"가야1동","총인구","2020.08 월","10356","20775","10360","10415",
"가야1동","총인구","2020.09 월","10332","20702","10313","10389",
"가야1동","총인구","2020.10 월","10307","20619","10263","10356",
"가야1동","총인구","2020.11 월","10324","20596","10234","10362",
"가야1동","총인구","2020.12 월","10267","20422","10153","10269",
"가야1동","총인구","2021.01 월","10228","20313","10099","10214",
"가야1동","총인구","2021.02 월","10209","20238","10085","10153",
"가야1동","총인구","2021.03 월","10058","20083","10016","10067",
"가야1동","총인구","2021.04 월","10066","20060","10015","10045",
"가야1동","총인구","2021.05 월","10085","20025","10010","10015",
"가야1동","총인구","2021.06 월","10075","19986","9996","9990",
"가야1동","총인구","2021.07 월","10086","19936","9973","9963",
"가야1동","총인구","2021.08 월","10089","19899","9946","9953",
"가야1동","총인구","2021.09 월","10137","19928","9939","9989",
"가야1동","총인구","2021.10 월","10148","19930","9944","9986",
"가야1동","총인구","2021.11 월","10161","19919","9938","9981",
"가야1동","총인구","2021.12 월","10159","19842","9916","9926",
"가야1동","총인구","2022.01 월","10118","19755","9878","9877",
"가야1동","총인구","2022.02 월","10089","19677","9854","9823",
"가야1동","총인구","2022.03 월","10114","19655","9847","9808",
"가야1동","총인구","2022.04 월","10119","19629","9838","9791",
"가야1동","총인구","2022.05 월","10127","19600","9815","9785",
"가야1동","총인구","2022.06 월","10136","19571","9799","9772",
"가야1동","총인구","2022.07 월","10126","19509","9753","9756",
"가야1동","총인구","2022.08 월","10139","19461","9755","9706",
"가야1동","총인구","2022.09 월","10133","19413","9720","9693",
"가야1동","총인구","2022.10 월","10121","19333","9677","9656",
"가야1동","총인구","2022.11 월","10058","19239","9626","9613",
"가야1동","총인구","2022.12 월","9996","19104","9544","9560",
"가야1동","총인구","2023.01 월","9932","18976","9482","9494",
"가야1동","총인구","2023.02 월","9946","18927","9472","9455",
"가야1동","총인구","2023.03 월","9979","18898","9460","9438",
"가야1동","총인구","2023.04 월","9951","18811","9431","9380",
"가야1동","총인구","2023.05 월","9919","18729","9389","9340",
"가야1동","총인구","2023.06 월","9861","18620","9343","9277",
"가야1동","총인구","2023.07 월","9784","18458","9267","9191",
"가야1동","총인구","2023.08 월","9722","18309","9228","9081",
"가야1동","총인구","2023.09 월","9658","18154","9163","8991",
"가야1동","총인구","2023.10 월","9509","17851","9021","8830",
"가야1동","총인구","2023.11 월","9373","17614","8902","8712",
"가야1동","총인구","2023.12 월","9263","17401","8793","8608",
"가야1동","총인구","2024.01 월","9146","17163","8678","8485",
"가야1동","총인구","2024.02 월","9138","17082","8655","8427",
"가야1동","총인구","2024.03 월","9233","17144","8690","8454",
"가야1동","총인구","2024.04 월","9252","17195","8704","8491",
"가야1동","총인구","2024.05 월","9262","17211","8711","8500",
"가야1동","총인구","2024.06 월","9269","17219","8706","8513",
"가야1동","총인구","2024.07 월","9252","17152","8658","8494",
"가야1동","총인구","2024.08 월","9242","17096","8639","8457",
"가야1동","총인구","2024.09 월","9249","17232","8719","8513",
"가야1동","총인구","2024.10 월","9244","17254","8747","8507",
"가야1동","총인구","2024.11 월","9245","17207","8724","8483",
"가야1동","총인구","2024.12 월","9219","17144","8709","8435",
"가야2동","총인구","2020.01 월","7105","17193","8414","8779",
"가야2동","총인구","2020.02 월","7107","17143","8396","8747",
"가야2동","총인구","2020.03 월","7084","17056","8337","8719",
"가야2동","총인구","2020.04 월","7076","17018","8313","8705",
"가야2동","총인구","2020.05 월","7082","16993","8288","8705",
"가야2동","총인구","2020.06 월","7107","16993","8270","8723",
"가야2동","총인구","2020.07 월","7178","17115","8322","8793",
"가야2동","총인구","2020.08 월","7247","17242","8397","8845",
"가야2동","총인구","2020.09 월","7299","17334","8440","8894",
"가야2동","총인구","2020.10 월","7308","17350","8446","8904",
"가야2동","총인구","2020.11 월","7321","17333","8428","8905",
"가야2동","총인구","2020.12 월","7315","17296","8414","8882",
"가야2동","총인구","2021.01 월","7301","17238","8383","8855",
"가야2동","총인구","2021.02 월","7313","17209","8363","8846",
"가야2동","총인구","2021.03 월","7281","17161","8340","8821",
"가야2동","총인구","2021.04 월","7286","17171","8324","8847",
"가야2동","총인구","2021.05 월","7290","17124","8298","8826",
"가야2동","총인구","2021.06 월","7302","17113","8290","8823",
"가야2동","총인구","2021.07 월","7309","17067","8255","8812",
"가야2동","총인구","2021.08 월","7320","17029","8231","8798",
"가야2동","총인구","2021.09 월","7326","17028","8244","8784",
"가야2동","총인구","2021.10 월","7320","17012","8240","8772",
"가야2동","총인구","2021.11 월","7338","16999","8245","8754",
"가야2동","총인구","2021.12 월","7322","16967","8222","8745",
"가야2동","총인구","2022.01 월","7324","16935","8205","8730",
"가야2동","총인구","2022.02 월","7307","16879","8187","8692",
"가야2동","총인구","2022.03 월","7314","16886","8198","8688",
"가야2동","총인구","2022.04 월","7294","16827","8166","8661",
"가야2동","총인구","2022.05 월","7304","16807","8152","8655",
"가야2동","총인구","2022.06 월","7301","16772","8135","8637",
"가야2동","총인구","2022.07 월","7310","16788","8134","8654",
"가야2동","총인구","2022.08 월","7300","16721","8097","8624",
"가야2동","총인구","2022.09 월","7293","16711","8090","8621",
"가야2동","총인구","2022.10 월","7591","17497","8474","9023",
"가야2동","총인구","2022.11 월","7776","17980","8688","9292",
"가야2동","총인구","2022.12 월","7839","18103","8733","9370",
"가야2동","총인구","2023.01 월","7861","18157","8755","9402",
"가야2동","총인구","2023.02 월","7907","18196","8776","9420",
"가야2동","총인구","2023.03 월","7940","18254","8820","9434",
"가야2동","총인구","2023.04 월","7967","18281","8844","9437",
"가야2동","총인구","2023.05 월","7998","18332","8864","9468",
"가야2동","총인구","2023.06 월","8022","18370","8877","9493",
"가야2동","총인구","2023.07 월","8041","18404","8893","9511",
"가야2동","총인구","2023.08 월","8067","18430","8897","9533",
"가야2동","총인구","2023.09 월","8072","18446","8906","9540",
"가야2동","총인구","2023.10 월","8081","18431","8897","9534",
"가야2동","총인구","2023.11 월","8090","18427","8902","9525",
"가야2동","총인구","2023.12 월","8095","18429","8903","9526",
"가야2동","총인구","2024.01 월","8076","18362","8877","9485",
"가야2동","총인구","2024.02 월","8080","18312","8851","9461",
"가야2동","총인구","2024.03 월","8088","18290","8847","9443",
"가야2동","총인구","2024.04 월","8081","18274","8834","9440",
"가야2동","총인구","2024.05 월","8075","18242","8808","9434",
"가야2동","총인구","2024.06 월","8062","18171","8770","9401",
"가야2동","총인구","2024.07 월","8069","18159","8757","9402",
"가야2동","총인구","2024.08 월","8079","18161","8762","9399",
"가야2동","총인구","2024.09 월","8089","18149","8757","9392",
"가야2동","총인구","2024.10 월","8089","18171","8765","9406",
"가야2동","총인구","2024.11 월","8079","18139","8737","9402",
"가야2동","총인구","2024.12 월","8087","18121","8725","9396",
"개금1동","총인구","2020.01 월","8626","17320","8258","9062",
"개금1동","총인구","2020.02 월","8698","17346","8265","9081",
"개금1동","총인구","2020.03 월","8724","17349","8265","9084",
"개금1동","총인구","2020.04 월","8756","17426","8294","9132",
"개금1동","총인구","2020.05 월","8787","17464","8314","9150",
"개금1동","총인구","2020.06 월","8809","17489","8325","9164",
"개금1동","총인구","2020.07 월","8851","17471","8313","9158",
"개금1동","총인구","2020.08 월","8866","17435","8298","9137",
"개금1동","총인구","2020.09 월","8868","17413","8281","9132",
"개금1동","총인구","2020.10 월","8860","17395","8287","9108",
"개금1동","총인구","2020.11 월","8859","17357","8276","9081",
"개금1동","총인구","2020.12 월","8888","17341","8276","9065",
"개금1동","총인구","2021.01 월","8879","17270","8233","9037",
"개금1동","총인구","2021.02 월","8890","17231","8204","9027",
"개금1동","총인구","2021.03 월","8857","17143","8171","8972",
"개금1동","총인구","2021.04 월","8823","17077","8155","8922",
"개금1동","총인구","2021.05 월","8818","17035","8133","8902",
"개금1동","총인구","2021.06 월","8810","16990","8118","8872",
"개금1동","총인구","2021.07 월","8836","16966","8120","8846",
"개금1동","총인구","2021.08 월","8869","16964","8112","8852",
"개금1동","총인구","2021.09 월","8892","16960","8113","8847",
"개금1동","총인구","2021.10 월","8902","16933","8093","8840",
"개금1동","총인구","2021.11 월","8878","16879","8078","8801",
"개금1동","총인구","2021.12 월","8866","16858","8066","8792",
"개금1동","총인구","2022.01 월","8880","16826","8058","8768",
"개금1동","총인구","2022.02 월","8918","16830","8045","8785",
"개금1동","총인구","2022.03 월","8945","16833","8057","8776",
"개금1동","총인구","2022.04 월","8959","16830","8070","8760",
"개금1동","총인구","2022.05 월","8963","16847","8069","8778",
"개금1동","총인구","2022.06 월","8975","16841","8075","8766",
"개금1동","총인구","2022.07 월","8985","16816","8067","8749",
"개금1동","총인구","2022.08 월","9018","16860","8098","8762",
"개금1동","총인구","2022.09 월","9032","16845","8076","8769",
"개금1동","총인구","2022.10 월","9016","16772","8043","8729",
"개금1동","총인구","2022.11 월","8995","16690","8004","8686",
"개금1동","총인구","2022.12 월","8967","16627","7965","8662",
"개금1동","총인구","2023.01 월","8986","16683","8003","8680",
"개금1동","총인구","2023.02 월","9334","17465","8407","9058",
"개금1동","총인구","2023.03 월","9543","17933","8640","9293",
"개금1동","총인구","2023.04 월","9638","18166","8775","9391",
"개금1동","총인구","2023.05 월","9699","18300","8839","9461",
"개금1동","총인구","2023.06 월","9736","18374","8874","9500",
"개금1동","총인구","2023.07 월","9789","18427","8900","9527",
"개금1동","총인구","2023.08 월","9814","18502","8943","9559",
"개금1동","총인구","2023.09 월","9791","18478","8933","9545",
"개금1동","총인구","2023.10 월","9748","18403","8884","9519",
"개금1동","총인구","2023.11 월","9747","18381","8887","9494",
"개금1동","총인구","2023.12 월","9769","18383","8895","9488",
"개금1동","총인구","2024.01 월","9767","18408","8893","9515",
"개금1동","총인구","2024.02 월","9805","18413","8900","9513",
"개금1동","총인구","2024.03 월","9830","18422","8918","9504",
"개금1동","총인구","2024.04 월","9824","18427","8910","9517",
"개금1동","총인구","2024.05 월","9840","18430","8923","9507",
"개금1동","총인구","2024.06 월","9820","18405","8918","9487",
"개금1동","총인구","2024.07 월","9832","18395","8915","9480",
"개금1동","총인구","2024.08 월","9845","18407","8913","9494",
"개금1동","총인구","2024.09 월","9875","18427","8928","9499",
"개금1동","총인구","2024.10 월","9884","18405","8921","9484",
"개금1동","총인구","2024.11 월","9884","18400","8909","9491",
"개금1동","총인구","2024.12 월","9897","18416","8915","9501",
"개금2동","총인구","2020.01 월","5095","11878","5810","6068",
"개금2동","총인구","2020.02 월","5073","11858","5796","6062",
"개금2동","총인구","2020.03 월","5074","11839","5770","6069",
"개금2동","총인구","2020.04 월","5073","11813","5769","6044",
"개금2동","총인구","2020.05 월","5077","11772","5760","6012",
"개금2동","총인구","2020.06 월","5070","11732","5722","6010",
"개금2동","총인구","2020.07 월","5073","11691","5701","5990",
"개금2동","총인구","2020.08 월","5070","11622","5685","5937",
"개금2동","총인구","2020.09 월","5063","11571","5656","5915",
"개금2동","총인구","2020.10 월","5061","11509","5621","5888",
"개금2동","총인구","2020.11 월","5058","11443","5590","5853",
"개금2동","총인구","2020.12 월","5046","11381","5561","5820",
"개금2동","총인구","2021.01 월","5049","11374","5566","5808",
"개금2동","총인구","2021.02 월","5052","11357","5552","5805",
"개금2동","총인구","2021.03 월","5016","11278","5511","5767",
"개금2동","총인구","2021.04 월","5030","11267","5510","5757",
"개금2동","총인구","2021.05 월","5033","11221","5477","5744",
"개금2동","총인구","2021.06 월","5023","11213","5474","5739",
"개금2동","총인구","2021.07 월","5028","11193","5465","5728",
"개금2동","총인구","2021.08 월","5030","11190","5461","5729",
"개금2동","총인구","2021.09 월","5020","11156","5439","5717",
"개금2동","총인구","2021.10 월","5004","11093","5404","5689",
"개금2동","총인구","2021.11 월","5006","11068","5392","5676",
"개금2동","총인구","2021.12 월","4995","11024","5369","5655",
"개금2동","총인구","2022.01 월","4991","10996","5350","5646",
"개금2동","총인구","2022.02 월","4996","10969","5335","5634",
"개금2동","총인구","2022.03 월","4974","10909","5306","5603",
"개금2동","총인구","2022.04 월","4988","10908","5305","5603",
"개금2동","총인구","2022.05 월","4986","10869","5291","5578",
"개금2동","총인구","2022.06 월","4982","10848","5276","5572",
"개금2동","총인구","2022.07 월","4979","10833","5274","5559",
"개금2동","총인구","2022.08 월","4985","10805","5264","5541",
"개금2동","총인구","2022.09 월","4975","10770","5235","5535",
"개금2동","총인구","2022.10 월","4961","10702","5203","5499",
"개금2동","총인구","2022.11 월","4952","10655","5183","5472",
"개금2동","총인구","2022.12 월","4951","10614","5160","5454",
"개금2동","총인구","2023.01 월","4932","10560","5135","5425",
"개금2동","총인구","2023.02 월","4923","10486","5086","5400",
"개금2동","총인구","2023.03 월","4914","10445","5063","5382",
"개금2동","총인구","2023.04 월","4915","10419","5051","5368",
"개금2동","총인구","2023.05 월","4912","10385","5026","5359",
"개금2동","총인구","2023.06 월","4918","10380","5008","5372",
"개금2동","총인구","2023.07 월","4907","10347","4985","5362",
"개금2동","총인구","2023.08 월","4895","10321","4968","5353",
"개금2동","총인구","2023.09 월","4893","10312","4956","5356",
"개금2동","총인구","2023.10 월","4880","10291","4946","5345",
"개금2동","총인구","2023.11 월","4866","10257","4919","5338",
"개금2동","총인구","2023.12 월","4853","10231","4903","5328",
"개금2동","총인구","2024.01 월","4839","10196","4877","5319",
"개금2동","총인구","2024.02 월","4829","10159","4870","5289",
"개금2동","총인구","2024.03 월","4817","10117","4847","5270",
"개금2동","총인구","2024.04 월","4809","10085","4823","5262",
"개금2동","총인구","2024.05 월","4809","10057","4805","5252",
"개금2동","총인구","2024.06 월","4812","10054","4799","5255",
"개금2동","총인구","2024.07 월","4811","10031","4794","5237",
"개금2동","총인구","2024.08 월","4801","9995","4773","5222",
"개금2동","총인구","2024.09 월","4798","9983","4763","5220",
"개금2동","총인구","2024.10 월","4789","9945","4746","5199",
"개금2동","총인구","2024.11 월","4788","9931","4743","5188",
"개금2동","총인구","2024.12 월","4782","9905","4732","5173",
"개금3동","총인구","2020.01 월","12383","30419","14771","15648",
"개금3동","총인구","2020.02 월","12362","30314","14713","15601",
"개금3동","총인구","2020.03 월","12363","30252","14675","15577",
"개금3동","총인구","2020.04 월","12357","30213","14673","15540",
"개금3동","총인구","2020.05 월","12376","30181","14648","15533",
"개금3동","총인구","2020.06 월","12371","30090","14598","15492",
"개금3동","총인구","2020.07 월","12382","30000","14547","15453",
"개금3동","총인구","2020.08 월","12382","29876","14473","15403",
"개금3동","총인구","2020.09 월","12407","29782","14418","15364",
"개금3동","총인구","2020.10 월","12408","29711","14383","15328",
"개금3동","총인구","2020.11 월","12418","29656","14345","15311",
"개금3동","총인구","2020.12 월","12428","29549","14297","15252",
"개금3동","총인구","2021.01 월","12433","29490","14260","15230",
"개금3동","총인구","2021.02 월","12464","29472","14244","15228",
"개금3동","총인구","2021.03 월","12440","29369","14186","15183",
"개금3동","총인구","2021.04 월","12443","29338","14176","15162",
"개금3동","총인구","2021.05 월","12446","29301","14178","15123",
"개금3동","총인구","2021.06 월","12450","29231","14124","15107",
"개금3동","총인구","2021.07 월","12448","29148","14077","15071",
"개금3동","총인구","2021.08 월","12462","29079","14017","15062",
"개금3동","총인구","2021.09 월","12467","29046","13999","15047",
"개금3동","총인구","2021.10 월","12471","29007","13988","15019",
"개금3동","총인구","2021.11 월","12486","29014","13987","15027",
"개금3동","총인구","2021.12 월","12490","28919","13936","14983",
"개금3동","총인구","2022.01 월","12475","28850","13908","14942",
"개금3동","총인구","2022.02 월","12460","28753","13858","14895",
"개금3동","총인구","2022.03 월","12462","28651","13792","14859",
"개금3동","총인구","2022.04 월","12474","28617","13770","14847",
"개금3동","총인구","2022.05 월","12476","28543","13726","14817",
"개금3동","총인구","2022.06 월","12481","28500","13692","14808",
"개금3동","총인구","2022.07 월","12476","28412","13664","14748",
"개금3동","총인구","2022.08 월","12474","28367","13644","14723",
"개금3동","총인구","2022.09 월","12447","28297","13602","14695",
"개금3동","총인구","2022.10 월","12418","28187","13540","14647",
"개금3동","총인구","2022.11 월","12382","28063","13481","14582",
"개금3동","총인구","2022.12 월","12351","27992","13450","14542",
"개금3동","총인구","2023.01 월","12310","27872","13378","14494",
"개금3동","총인구","2023.02 월","12285","27707","13286","14421",
"개금3동","총인구","2023.03 월","12260","27583","13222","14361",
"개금3동","총인구","2023.04 월","12262","27553","13210","14343",
"개금3동","총인구","2023.05 월","12254","27483","13166","14317",
"개금3동","총인구","2023.06 월","12253","27403","13126","14277",
"개금3동","총인구","2023.07 월","12247","27355","13102","14253",
"개금3동","총인구","2023.08 월","12240","27305","13082","14223",
"개금3동","총인구","2023.09 월","12255","27315","13079","14236",
"개금3동","총인구","2023.10 월","12245","27258","13050","14208",
"개금3동","총인구","2023.11 월","12221","27177","13002","14175",
"개금3동","총인구","2023.12 월","12219","27115","12962","14153",
"개금3동","총인구","2024.01 월","12200","26995","12900","14095",
"개금3동","총인구","2024.02 월","12182","26871","12831","14040",
"개금3동","총인구","2024.03 월","12192","26859","12819","14040",
"개금3동","총인구","2024.04 월","12182","26794","12781","14013",
"개금3동","총인구","2024.05 월","12187","26731","12743","13988",
"개금3동","총인구","2024.06 월","12162","26650","12718","13932",
"개금3동","총인구","2024.07 월","12146","26592","12689","13903",
"개금3동","총인구","2024.08 월","12138","26512","12639","13873",
"개금3동","총인구","2024.09 월","12112","26454","12602","13852",
"개금3동","총인구","2024.10 월","12093","26386","12587","13799",
"개금3동","총인구","2024.11 월","12069","26288","12544","13744",
"개금3동","총인구","2024.12 월","12074","26249","12509","13740",
"범천1동","총인구","2020.01 월","6638","11573","5541","6032",
"범천1동","총인구","2020.02 월","6753","11697","5574","6123",
"범천1동","총인구","2020.03 월","6879","11848","5635","6213",
"범천1동","총인구","2020.04 월","6964","11979","5695","6284",
"범천1동","총인구","2020.05 월","7034","12046","5719","6327",
"범천1동","총인구","2020.06 월","7083","12093","5737","6356",
"범천1동","총인구","2020.07 월","7103","12114","5749","6365",
"범천1동","총인구","2020.08 월","7155","12149","5788","6361",
"범천1동","총인구","2020.09 월","7211","12218","5818","6400",
"범천1동","총인구","2020.10 월","7207","12222","5813","6409",
"범천1동","총인구","2020.11 월","7197","12169","5775","6394",
"범천1동","총인구","2020.12 월","7188","12136","5759","6377",
"범천1동","총인구","2021.01 월","7226","12156","5757","6399",
"범천1동","총인구","2021.02 월","7236","12193","5787","6406",
"범천1동","총인구","2021.03 월","7189","12154","5743","6411",
"범천1동","총인구","2021.04 월","7201","12164","5749","6415",
"범천1동","총인구","2021.05 월","7176","12115","5729","6386",
"범천1동","총인구","2021.06 월","7181","12118","5741","6377",
"범천1동","총인구","2021.07 월","7212","12144","5745","6399",
"범천1동","총인구","2021.08 월","7213","12129","5719","6410",
"범천1동","총인구","2021.09 월","7209","12156","5727","6429",
"범천1동","총인구","2021.10 월","7196","12165","5721","6444",
"범천1동","총인구","2021.11 월","7167","12109","5675","6434",
"범천1동","총인구","2021.12 월","7167","12094","5674","6420",
"범천1동","총인구","2022.01 월","7181","12075","5671","6404",
"범천1동","총인구","2022.02 월","7186","12043","5656","6387",
"범천1동","총인구","2022.03 월","7185","12043","5645","6398",
"범천1동","총인구","2022.04 월","7193","12047","5650","6397",
"범천1동","총인구","2022.05 월","7241","12102","5696","6406",
"범천1동","총인구","2022.06 월","7329","12251","5753","6498",
"범천1동","총인구","2022.07 월","7441","12400","5818","6582",
"범천1동","총인구","2022.08 월","7536","12499","5849","6650",
"범천1동","총인구","2022.09 월","7584","12555","5875","6680",
"범천1동","총인구","2022.10 월","7615","12560","5876","6684",
"범천1동","총인구","2022.11 월","7601","12562","5871","6691",
"범천1동","총인구","2022.12 월","7614","12583","5872","6711",
"범천1동","총인구","2023.01 월","7646","12591","5866","6725",
"범천1동","총인구","2023.02 월","7690","12629","5875","6754",
"범천1동","총인구","2023.03 월","7687","12625","5873","6752",
"범천1동","총인구","2023.04 월","7686","12622","5865","6757",
"범천1동","총인구","2023.05 월","7678","12607","5842","6765",
"범천1동","총인구","2023.06 월","7666","12588","5821","6767",
"범천1동","총인구","2023.07 월","7638","12528","5800","6728",
"범천1동","총인구","2023.08 월","7611","12504","5790","6714",
"범천1동","총인구","2023.09 월","7611","12478","5791","6687",
"범천1동","총인구","2023.10 월","7612","12483","5801","6682",
"범천1동","총인구","2023.11 월","7559","12413","5759","6654",
"범천1동","총인구","2023.12 월","7559","12376","5740","6636",
"범천1동","총인구","2024.01 월","7559","12377","5738","6639",
"범천1동","총인구","2024.02 월","7580","12375","5734","6641",
"범천1동","총인구","2024.03 월","7594","12351","5706","6645",
"범천1동","총인구","2024.04 월","7602","12345","5700","6645",
"범천1동","총인구","2024.05 월","7635","12358","5711","6647",
"범천1동","총인구","2024.06 월","7640","12337","5691","6646",
"범천1동","총인구","2024.07 월","7651","12310","5682","6628",
"범천1동","총인구","2024.08 월","7672","12327","5706","6621",
"범천1동","총인구","2024.09 월","7662","12291","5690","6601",
"범천1동","총인구","2024.10 월","7686","12305","5686","6619",
"범천1동","총인구","2024.11 월","7696","12318","5698","6620",
"범천1동","총인구","2024.12 월","7684","12321","5701","6620",
"범천2동","총인구","2020.01 월","9731","20170","9828","10342",
"범천2동","총인구","2020.02 월","9729","20125","9789","10336",
"범천2동","총인구","2020.03 월","9730","20089","9774","10315",
"범천2동","총인구","2020.04 월","9731","20064","9761","10303",
"범천2동","총인구","2020.05 월","9733","20029","9760","10269",
"범천2동","총인구","2020.06 월","9889","20249","9887","10362",
"범천2동","총인구","2020.07 월","10077","20572","10030","10542",
"범천2동","총인구","2020.08 월","10198","20733","10095","10638",
"범천2동","총인구","2020.09 월","10277","20824","10124","10700",
"범천2동","총인구","2020.10 월","10302","20851","10139","10712",
"범천2동","총인구","2020.11 월","10319","20832","10122","10710",
"범천2동","총인구","2020.12 월","10407","20949","10176","10773",
"범천2동","총인구","2021.01 월","10445","20975","10196","10779",
"범천2동","총인구","2021.02 월","10444","20924","10150","10774",
"범천2동","총인구","2021.03 월","10322","20764","10073","10691",
"범천2동","총인구","2021.04 월","10313","20684","10042","10642",
"범천2동","총인구","2021.05 월","10332","20651","10018","10633",
"범천2동","총인구","2021.06 월","10334","20625","9987","10638",
"범천2동","총인구","2021.07 월","10346","20616","9977","10639",
"범천2동","총인구","2021.08 월","10356","20600","9963","10637",
"범천2동","총인구","2021.09 월","10361","20582","9961","10621",
"범천2동","총인구","2021.10 월","10348","20549","9916","10633",
"범천2동","총인구","2021.11 월","10315","20455","9879","10576",
"범천2동","총인구","2021.12 월","10341","20444","9874","10570",
"범천2동","총인구","2022.01 월","10346","20388","9839","10549",
"범천2동","총인구","2022.02 월","10333","20318","9809","10509",
"범천2동","총인구","2022.03 월","10345","20278","9789","10489",
"범천2동","총인구","2022.04 월","10345","20268","9780","10488",
"범천2동","총인구","2022.05 월","10359","20280","9769","10511",
"범천2동","총인구","2022.06 월","10406","20324","9793","10531",
"범천2동","총인구","2022.07 월","10795","21146","10229","10917",
"범천2동","총인구","2022.08 월","11027","21674","10482","11192",
"범천2동","총인구","2022.09 월","11081","21839","10575","11264",
"범천2동","총인구","2022.10 월","11130","21911","10591","11320",
"범천2동","총인구","2022.11 월","11157","21971","10620","11351",
"범천2동","총인구","2022.12 월","11160","21941","10609","11332",
"범천2동","총인구","2023.01 월","11148","21904","10587","11317",
"범천2동","총인구","2023.02 월","11150","21907","10587","11320",
"범천2동","총인구","2023.03 월","11136","21839","10537","11302",
"범천2동","총인구","2023.04 월","11133","21819","10515","11304",
"범천2동","총인구","2023.05 월","11151","21842","10527","11315",
"범천2동","총인구","2023.06 월","11137","21754","10493","11261",
"범천2동","총인구","2023.07 월","11135","21744","10492","11252",
"범천2동","총인구","2023.08 월","11146","21723","10466","11257",
"범천2동","총인구","2023.09 월","11230","21814","10500","11314",
"범천2동","총인구","2023.10 월","11254","21815","10498","11317",
"범천2동","총인구","2023.11 월","11295","21854","10516","11338",
"범천2동","총인구","2023.12 월","11299","21831","10503","11328",
"범천2동","총인구","2024.01 월","11284","21759","10455","11304",
"범천2동","총인구","2024.02 월","11276","21694","10418","11276",
"범천2동","총인구","2024.03 월","11258","21645","10386","11259",
"범천2동","총인구","2024.04 월","11257","21658","10395","11263",
"범천2동","총인구","2024.05 월","11221","21613","10359","11254",
"범천2동","총인구","2024.06 월","11212","21588","10344","11244",
"범천2동","총인구","2024.07 월","11186","21483","10298","11185",
"범천2동","총인구","2024.08 월","11189","21433","10270","11163",
"범천2동","총인구","2024.09 월","11176","21393","10242","11151",
"범천2동","총인구","2024.10 월","11143","21344","10208","11136",
"범천2동","총인구","2024.11 월","11128","21277","10166","11111",
"범천2동","총인구","2024.12 월","11113","21276","10178","11098",
"동래구","총인구","2020.01 월","112473","272820","132832","139988",
"동래구","총인구","2020.02 월","112724","272785","132783","140002",
"동래구","총인구","2020.03 월","113266","273573","133179","140394",
"동래구","총인구","2020.04 월","113547","273819","133324","140495",
"동래구","총인구","2020.05 월","113823","273785","133313","140472",
"동래구","총인구","2020.06 월","114058","273713","133195","140518",
"동래구","총인구","2020.07 월","114414","273793","133256","140537",
"동래구","총인구","2020.08 월","114527","273413","132982","140431",
"동래구","총인구","2020.09 월","114679","273215","132886","140329",
"동래구","총인구","2020.10 월","114739","272862","132690","140172",
"동래구","총인구","2020.11 월","114826","272403","132444","139959",
"동래구","총인구","2020.12 월","114987","271966","132164","139802",
"동래구","총인구","2021.01 월","115221","271917","132126","139791",
"동래구","총인구","2021.02 월","115476","271884","132133","139751",
"동래구","총인구","2021.03 월","114936","270706","131639","139067",
"동래구","총인구","2021.04 월","114977","270221","131322","138899",
"동래구","총인구","2021.05 월","115078","269829","131102","138727",
"동래구","총인구","2021.06 월","115173","269590","130971","138619",
"동래구","총인구","2021.07 월","115239","269171","130761","138410",
"동래구","총인구","2021.08 월","115276","268834","130575","138259",
"동래구","총인구","2021.09 월","115356","268587","130446","138141",
"동래구","총인구","2021.10 월","115301","268074","130178","137896",
"동래구","총인구","2021.11 월","115310","267705","129977","137728",
"동래구","총인구","2021.12 월","115718","268004","130093","137911",
"동래구","총인구","2022.01 월","117211","271480","131810","139670",
"동래구","총인구","2022.02 월","118748","274961","133387","141574",
"동래구","총인구","2022.03 월","119112","275297","133522","141775",
"동래구","총인구","2022.04 월","119227","275134","133411","141723",
"동래구","총인구","2022.05 월","119446","275173","133310","141863",
"동래구","총인구","2022.06 월","119772","275668","133524","142144",
"동래구","총인구","2022.07 월","120011","275956","133663","142293",
"동래구","총인구","2022.08 월","119984","275830","133543","142287",
"동래구","총인구","2022.09 월","119696","275354","133287","142067",
"동래구","총인구","2022.10 월","119629","274992","133065","141927",
"동래구","총인구","2022.11 월","119508","274660","132883","141777",
"동래구","총인구","2022.12 월","119503","274445","132739","141706",
"동래구","총인구","2023.01 월","119557","274400","132696","141704",
"동래구","총인구","2023.02 월","119887","274567","132730","141837",
"동래구","총인구","2023.03 월","119963","274419","132596","141823",
"동래구","총인구","2023.04 월","119980","274273","132498","141775",
"동래구","총인구","2023.05 월","120032","274065","132445","141620",
"동래구","총인구","2023.06 월","120060","273878","132307","141571",
"동래구","총인구","2023.07 월","120056","273671","132199","141472",
"동래구","총인구","2023.08 월","120076","273489","132097","141392",
"동래구","총인구","2023.09 월","119933","273197","131963","141234",
"동래구","총인구","2023.10 월","119841","273002","131864","141138",
"동래구","총인구","2023.11 월","119814","272849","131768","141081",
"동래구","총인구","2023.12 월","119706","272178","131435","140743",
"동래구","총인구","2024.01 월","119440","271164","130888","140276",
"동래구","총인구","2024.02 월","119497","270713","130585","140128",
"동래구","총인구","2024.03 월","119481","270392","130392","140000",
"동래구","총인구","2024.04 월","119528","270252","130232","140020",
"동래구","총인구","2024.05 월","119577","270255","130208","140047",
"동래구","총인구","2024.06 월","119755","270504","130320","140184",
"동래구","총인구","2024.07 월","119824","270453","130334","140119",
"동래구","총인구","2024.08 월","119850","270402","130279","140123",
"동래구","총인구","2024.09 월","119959","270513","130296","140217",
"동래구","총인구","2024.10 월","120971","273084","131528","141556",
"동래구","총인구","2024.11 월","121775","275121","132514","142607",
"동래구","총인구","2024.12 월","122121","275848","132855","142993",
"수민동","총인구","2020.01 월","13174","33040","16171","16869",
"수민동","총인구","2020.02 월","13272","33132","16211","16921",
"수민동","총인구","2020.03 월","13315","33144","16215","16929",
"수민동","총인구","2020.04 월","13360","33173","16233","16940",
"수민동","총인구","2020.05 월","13402","33170","16229","16941",
"수민동","총인구","2020.06 월","13428","33167","16205","16962",
"수민동","총인구","2020.07 월","13437","33118","16170","16948",
"수민동","총인구","2020.08 월","13433","32999","16102","16897",
"수민동","총인구","2020.09 월","13474","33040","16109","16931",
"수민동","총인구","2020.10 월","13539","33112","16148","16964",
"수민동","총인구","2020.11 월","13586","33111","16123","16988",
"수민동","총인구","2020.12 월","13642","33151","16147","17004",
"수민동","총인구","2021.01 월","13658","33112","16118","16994",
"수민동","총인구","2021.02 월","13702","33178","16143","17035",
"수민동","총인구","2021.03 월","13646","33055","16091","16964",
"수민동","총인구","2021.04 월","13657","32996","16045","16951",
"수민동","총인구","2021.05 월","13682","32990","16021","16969",
"수민동","총인구","2021.06 월","13689","32999","16028","16971",
"수민동","총인구","2021.07 월","13691","32952","15986","16966",
"수민동","총인구","2021.08 월","13677","32883","15947","16936",
"수민동","총인구","2021.09 월","13660","32813","15909","16904",
"수민동","총인구","2021.10 월","13650","32803","15898","16905",
"수민동","총인구","2021.11 월","13656","32750","15870","16880",
"수민동","총인구","2021.12 월","13661","32698","15840","16858",
"수민동","총인구","2022.01 월","13632","32529","15754","16775",
"수민동","총인구","2022.02 월","13619","32368","15661","16707",
"수민동","총인구","2022.03 월","13610","32301","15624","16677",
"수민동","총인구","2022.04 월","13592","32250","15609","16641",
"수민동","총인구","2022.05 월","13609","32248","15593","16655",
"수민동","총인구","2022.06 월","13604","32201","15573","16628",
"수민동","총인구","2022.07 월","13592","32120","15546","16574",
"수민동","총인구","2022.08 월","13576","32045","15495","16550",
"수민동","총인구","2022.09 월","13564","31995","15461","16534",
"수민동","총인구","2022.10 월","13541","31909","15410","16499",
"수민동","총인구","2022.11 월","13529","31869","15399","16470",
"수민동","총인구","2022.12 월","13513","31793","15368","16425",
"수민동","총인구","2023.01 월","13491","31736","15348","16388",
"수민동","총인구","2023.02 월","13463","31643","15292","16351",
"수민동","총인구","2023.03 월","13471","31580","15240","16340",
"수민동","총인구","2023.04 월","13457","31533","15211","16322",
"수민동","총인구","2023.05 월","13462","31525","15204","16321",
"수민동","총인구","2023.06 월","13442","31445","15158","16287",
"수민동","총인구","2023.07 월","13431","31363","15111","16252",
"수민동","총인구","2023.08 월","13417","31306","15084","16222",
"수민동","총인구","2023.09 월","13402","31247","15064","16183",
"수민동","총인구","2023.10 월","13385","31192","15047","16145",
"수민동","총인구","2023.11 월","13381","31153","15036","16117",
"수민동","총인구","2023.12 월","13351","31065","14980","16085",
"수민동","총인구","2024.01 월","13319","30915","14896","16019",
"수민동","총인구","2024.02 월","13285","30752","14805","15947",
"수민동","총인구","2024.03 월","13299","30718","14772","15946",
"수민동","총인구","2024.04 월","13296","30695","14748","15947",
"수민동","총인구","2024.05 월","13377","30818","14806","16012",
"수민동","총인구","2024.06 월","13438","30899","14842","16057",
"수민동","총인구","2024.07 월","13470","30895","14847","16048",
"수민동","총인구","2024.08 월","13478","30865","14808","16057",
"수민동","총인구","2024.09 월","13480","30849","14796","16053",
"수민동","총인구","2024.10 월","13461","30777","14773","16004",
"수민동","총인구","2024.11 월","13450","30680","14748","15932",
"수민동","총인구","2024.12 월","13452","30660","14751","15909",
"복산동","총인구","2020.01 월","4988","10748","5233","5515",
"복산동","총인구","2020.02 월","4978","10679","5187","5492",
"복산동","총인구","2020.03 월","4980","10626","5163","5463",
"복산동","총인구","2020.04 월","4976","10581","5144","5437",
"복산동","총인구","2020.05 월","4987","10558","5143","5415",
"복산동","총인구","2020.06 월","5008","10572","5147","5425",
"복산동","총인구","2020.07 월","5006","10525","5121","5404",
"복산동","총인구","2020.08 월","4995","10464","5084","5380",
"복산동","총인구","2020.09 월","4984","10433","5082","5351",
"복산동","총인구","2020.10 월","4963","10348","5032","5316",
"복산동","총인구","2020.11 월","4947","10296","5012","5284",
"복산동","총인구","2020.12 월","4933","10216","4960","5256",
"복산동","총인구","2021.01 월","4933","10169","4939","5230",
"복산동","총인구","2021.02 월","4926","10106","4903","5203",
"복산동","총인구","2021.03 월","4900","10033","4856","5177",
"복산동","총인구","2021.04 월","4869","9966","4827","5139",
"복산동","총인구","2021.05 월","4847","9890","4793","5097",
"복산동","총인구","2021.06 월","4825","9822","4758","5064",
"복산동","총인구","2021.07 월","4824","9785","4744","5041",
"복산동","총인구","2021.08 월","4818","9741","4722","5019",
"복산동","총인구","2021.09 월","4801","9699","4701","4998",
"복산동","총인구","2021.10 월","4781","9629","4668","4961",
"복산동","총인구","2021.11 월","4758","9578","4653","4925",
"복산동","총인구","2021.12 월","4753","9552","4645","4907",
"복산동","총인구","2022.01 월","4721","9475","4615","4860",
"복산동","총인구","2022.02 월","4704","9407","4585","4822",
"복산동","총인구","2022.03 월","4681","9344","4552","4792",
"복산동","총인구","2022.04 월","4672","9307","4543","4764",
"복산동","총인구","2022.05 월","4683","9311","4548","4763",
"복산동","총인구","2022.06 월","4672","9273","4512","4761",
"복산동","총인구","2022.07 월","4647","9224","4491","4733",
"복산동","총인구","2022.08 월","4638","9203","4480","4723",
"복산동","총인구","2022.09 월","4574","9094","4430","4664",
"복산동","총인구","2022.10 월","4562","9058","4418","4640",
"복산동","총인구","2022.11 월","4547","9016","4395","4621",
"복산동","총인구","2022.12 월","4530","8985","4379","4606",
"복산동","총인구","2023.01 월","4521","8974","4377","4597",
"복산동","총인구","2023.02 월","4514","8946","4357","4589",
"복산동","총인구","2023.03 월","4504","8919","4342","4577",
"복산동","총인구","2023.04 월","4485","8882","4321","4561",
"복산동","총인구","2023.05 월","4480","8857","4313","4544",
"복산동","총인구","2023.06 월","4454","8807","4286","4521",
"복산동","총인구","2023.07 월","4434","8752","4259","4493",
"복산동","총인구","2023.08 월","4441","8764","4267","4497",
"복산동","총인구","2023.09 월","4416","8699","4227","4472",
"복산동","총인구","2023.10 월","4382","8661","4196","4465",
"복산동","총인구","2023.11 월","4376","8637","4180","4457",
"복산동","총인구","2023.12 월","4365","8616","4168","4448",
"복산동","총인구","2024.01 월","4345","8552","4137","4415",
"복산동","총인구","2024.02 월","4343","8520","4117","4403",
"복산동","총인구","2024.03 월","4337","8500","4108","4392",
"복산동","총인구","2024.04 월","4326","8470","4083","4387",
"복산동","총인구","2024.05 월","4311","8452","4079","4373",
"복산동","총인구","2024.06 월","4302","8425","4066","4359",
"복산동","총인구","2024.07 월","4294","8399","4050","4349",
"복산동","총인구","2024.08 월","4291","8395","4050","4345",
"복산동","총인구","2024.09 월","4279","8355","4034","4321",
"복산동","총인구","2024.10 월","4265","8320","4017","4303",
"복산동","총인구","2024.11 월","4244","8269","3995","4274",
"복산동","총인구","2024.12 월","4219","8222","3963","4259",
"명륜동","총인구","2020.01 월","9344","25168","12247","12921",
"명륜동","총인구","2020.02 월","9353","25210","12277","12933",
"명륜동","총인구","2020.03 월","9317","25055","12196","12859",
"명륜동","총인구","2020.04 월","9314","25027","12197","12830",
"명륜동","총인구","2020.05 월","9323","24996","12176","12820",
"명륜동","총인구","2020.06 월","9328","24982","12162","12820",
"명륜동","총인구","2020.07 월","9341","24967","12165","12802",
"명륜동","총인구","2020.08 월","9335","24924","12144","12780",
"명륜동","총인구","2020.09 월","9322","24882","12117","12765",
"명륜동","총인구","2020.10 월","9304","24791","12084","12707",
"명륜동","총인구","2020.11 월","9307","24793","12097","12696",
"명륜동","총인구","2020.12 월","9313","24796","12099","12697",
"명륜동","총인구","2021.01 월","9413","25009","12242","12767",
"명륜동","총인구","2021.02 월","9465","25152","12312","12840",
"명륜동","총인구","2021.03 월","9386","25054","12280","12774",
"명륜동","총인구","2021.04 월","9380","25009","12270","12739",
"명륜동","총인구","2021.05 월","9405","25068","12298","12770",
"명륜동","총인구","2021.06 월","9398","25025","12284","12741",
"명륜동","총인구","2021.07 월","9411","25009","12280","12729",
"명륜동","총인구","2021.08 월","9429","25007","12286","12721",
"명륜동","총인구","2021.09 월","9414","24978","12283","12695",
"명륜동","총인구","2021.10 월","9411","24904","12240","12664",
"명륜동","총인구","2021.11 월","9415","24886","12226","12660",
"명륜동","총인구","2021.12 월","9426","24823","12189","12634",
"명륜동","총인구","2022.01 월","9387","24688","12124","12564",
"명륜동","총인구","2022.02 월","9377","24579","12079","12500",
"명륜동","총인구","2022.03 월","9380","24552","12062","12490",
"명륜동","총인구","2022.04 월","9375","24499","12036","12463",
"명륜동","총인구","2022.05 월","9352","24466","12007","12459",
"명륜동","총인구","2022.06 월","9676","25280","12417","12863",
"명륜동","총인구","2022.07 월","9902","25879","12710","13169",
"명륜동","총인구","2022.08 월","9991","26172","12854","13318",
"명륜동","총인구","2022.09 월","10016","26262","12902","13360",
"명륜동","총인구","2022.10 월","10047","26353","12935","13418",
"명륜동","총인구","2022.11 월","10079","26424","12980","13444",
"명륜동","총인구","2022.12 월","10100","26497","13007","13490",
"명륜동","총인구","2023.01 월","10104","26498","13002","13496",
"명륜동","총인구","2023.02 월","10126","26508","12998","13510",
"명륜동","총인구","2023.03 월","10119","26497","12983","13514",
"명륜동","총인구","2023.04 월","10132","26494","12973","13521",
"명륜동","총인구","2023.05 월","10153","26500","12992","13508",
"명륜동","총인구","2023.06 월","10172","26523","12999","13524",
"명륜동","총인구","2023.07 월","10179","26525","12992","13533",
"명륜동","총인구","2023.08 월","10180","26534","12985","13549",
"명륜동","총인구","2023.09 월","10165","26541","12991","13550",
"명륜동","총인구","2023.10 월","10161","26542","12999","13543",
"명륜동","총인구","2023.11 월","10163","26577","13014","13563",
"명륜동","총인구","2023.12 월","10160","26552","13007","13545",
"명륜동","총인구","2024.01 월","10135","26475","12976","13499",
"명륜동","총인구","2024.02 월","10126","26396","12943","13453",
"명륜동","총인구","2024.03 월","10119","26362","12929","13433",
"명륜동","총인구","2024.04 월","10140","26353","12909","13444",
"명륜동","총인구","2024.05 월","10129","26349","12909","13440",
"명륜동","총인구","2024.06 월","10129","26333","12906","13427",
"명륜동","총인구","2024.07 월","10117","26297","12886","13411",
"명륜동","총인구","2024.08 월","10122","26314","12896","13418",
"명륜동","총인구","2024.09 월","10131","26353","12918","13435",
"명륜동","총인구","2024.10 월","10085","26226","12866","13360",
"명륜동","총인구","2024.11 월","10074","26213","12864","13349",
"명륜동","총인구","2024.12 월","10044","26174","12851","13323",
"온천1동","총인구","2020.01 월","10093","19315","9137","10178",
"온천1동","총인구","2020.02 월","10141","19358","9166","10192",
"온천1동","총인구","2020.03 월","10193","19410","9190","10220",
"온천1동","총인구","2020.04 월","10238","19472","9212","10260",
"온천1동","총인구","2020.05 월","10287","19502","9227","10275",
"온천1동","총인구","2020.06 월","10349","19579","9253","10326",
"온천1동","총인구","2020.07 월","10384","19586","9260","10326",
"온천1동","총인구","2020.08 월","10394","19579","9230","10349",
"온천1동","총인구","2020.09 월","10433","19608","9252","10356",
"온천1동","총인구","2020.10 월","10448","19632","9253","10379",
"온천1동","총인구","2020.11 월","10464","19607","9239","10368",
"온천1동","총인구","2020.12 월","10521","19642","9253","10389",
"온천1동","총인구","2021.01 월","10612","19703","9279","10424",
"온천1동","총인구","2021.02 월","10691","19764","9306","10458",
"온천1동","총인구","2021.03 월","10660","19688","9324","10364",
"온천1동","총인구","2021.04 월","10751","19786","9344","10442",
"온천1동","총인구","2021.05 월","10809","19838","9380","10458",
"온천1동","총인구","2021.06 월","10912","19936","9424","10512",
"온천1동","총인구","2021.07 월","10993","19996","9461","10535",
"온천1동","총인구","2021.08 월","11030","20028","9483","10545",
"온천1동","총인구","2021.09 월","11061","20090","9511","10579",
"온천1동","총인구","2021.10 월","11048","20060","9473","10587",
"온천1동","총인구","2021.11 월","11061","20092","9483","10609",
"온천1동","총인구","2021.12 월","11394","20763","9801","10962",
"온천1동","총인구","2022.01 월","11713","21420","10099","11321",
"온천1동","총인구","2022.02 월","11994","21960","10337","11623",
"온천1동","총인구","2022.03 월","12174","22236","10458","11778",
"온천1동","총인구","2022.04 월","12301","22465","10562","11903",
"온천1동","총인구","2022.05 월","12369","22598","10627","11971",
"온천1동","총인구","2022.06 월","12400","22637","10634","12003",
"온천1동","총인구","2022.07 월","12401","22639","10629","12010",
"온천1동","총인구","2022.08 월","12412","22653","10624","12029",
"온천1동","총인구","2022.09 월","12364","22605","10587","12018",
"온천1동","총인구","2022.10 월","12371","22634","10601","12033",
"온천1동","총인구","2022.11 월","12370","22625","10599","12026",
"온천1동","총인구","2022.12 월","12364","22595","10577","12018",
"온천1동","총인구","2023.01 월","12438","22778","10669","12109",
"온천1동","총인구","2023.02 월","12737","23468","10990","12478",
"온천1동","총인구","2023.03 월","12867","23778","11128","12650",
"온천1동","총인구","2023.04 월","12922","23906","11187","12719",
"온천1동","총인구","2023.05 월","12957","23981","11244","12737",
"온천1동","총인구","2023.06 월","12980","24022","11243","12779",
"온천1동","총인구","2023.07 월","13052","24151","11305","12846",
"온천1동","총인구","2023.08 월","13142","24323","11385","12938",
"온천1동","총인구","2023.09 월","13183","24431","11447","12984",
"온천1동","총인구","2023.10 월","13244","24578","11520","13058",
"온천1동","총인구","2023.11 월","13298","24710","11591","13119",
"온천1동","총인구","2023.12 월","13334","24794","11643","13151",
"온천1동","총인구","2024.01 월","13373","24833","11655","13178",
"온천1동","총인구","2024.02 월","13458","24923","11664","13259",
"온천1동","총인구","2024.03 월","13481","24903","11636","13267",
"온천1동","총인구","2024.04 월","13509","24964","11657","13307",
"온천1동","총인구","2024.05 월","13496","24945","11657","13288",
"온천1동","총인구","2024.06 월","13466","24899","11651","13248",
"온천1동","총인구","2024.07 월","13451","24898","11654","13244",
"온천1동","총인구","2024.08 월","13428","24872","11642","13230",
"온천1동","총인구","2024.09 월","13484","24993","11690","13303",
"온천1동","총인구","2024.10 월","14674","28134","13192","14942",
"온천1동","총인구","2024.11 월","15582","30669","14415","16254",
"온천1동","총인구","2024.12 월","15933","31623","14858","16765",
"온천2동","총인구","2020.01 월","6298","15733","7591","8142",
"온천2동","총인구","2020.02 월","6294","15660","7559","8101",
"온천2동","총인구","2020.03 월","6279","15584","7516","8068",
"온천2동","총인구","2020.04 월","6265","15531","7483","8048",
"온천2동","총인구","2020.05 월","6263","15486","7474","8012",
"온천2동","총인구","2020.06 월","6263","15446","7458","7988",
"온천2동","총인구","2020.07 월","6252","15405","7443","7962",
"온천2동","총인구","2020.08 월","6265","15381","7440","7941",
"온천2동","총인구","2020.09 월","6266","15348","7422","7926",
"온천2동","총인구","2020.10 월","6259","15323","7414","7909",
"온천2동","총인구","2020.11 월","6269","15291","7409","7882",
"온천2동","총인구","2020.12 월","6275","15265","7399","7866",
"온천2동","총인구","2021.01 월","6285","15227","7370","7857",
"온천2동","총인구","2021.02 월","6301","15218","7356","7862",
"온천2동","총인구","2021.03 월","6280","15125","7311","7814",
"온천2동","총인구","2021.04 월","6293","15077","7278","7799",
"온천2동","총인구","2021.05 월","6301","15038","7243","7795",
"온천2동","총인구","2021.06 월","6298","15008","7226","7782",
"온천2동","총인구","2021.07 월","6285","14923","7182","7741",
"온천2동","총인구","2021.08 월","6271","14875","7150","7725",
"온천2동","총인구","2021.09 월","6280","14844","7128","7716",
"온천2동","총인구","2021.10 월","6263","14816","7115","7701",
"온천2동","총인구","2021.11 월","6253","14778","7091","7687",
"온천2동","총인구","2021.12 월","6351","15000","7187","7813",
"온천2동","총인구","2022.01 월","7770","19050","9172","9878",
"온천2동","총인구","2022.02 월","9060","22914","11030","11884",
"온천2동","총인구","2022.03 월","9342","23622","11366","12256",
"온천2동","총인구","2022.04 월","9483","23934","11512","12422",
"온천2동","총인구","2022.05 월","9597","24196","11618","12578",
"온천2동","총인구","2022.06 월","9666","24307","11660","12647",
"온천2동","총인구","2022.07 월","9710","24406","11711","12695",
"온천2동","총인구","2022.08 월","9726","24481","11743","12738",
"온천2동","총인구","2022.09 월","9645","24383","11708","12675",
"온천2동","총인구","2022.10 월","9661","24417","11732","12685",
"온천2동","총인구","2022.11 월","9670","24441","11730","12711",
"온천2동","총인구","2022.12 월","9679","24470","11754","12716",
"온천2동","총인구","2023.01 월","9690","24495","11766","12729",
"온천2동","총인구","2023.02 월","9716","24492","11768","12724",
"온천2동","총인구","2023.03 월","9722","24510","11779","12731",
"온천2동","총인구","2023.04 월","9723","24540","11803","12737",
"온천2동","총인구","2023.05 월","9738","24544","11814","12730",
"온천2동","총인구","2023.06 월","9761","24587","11833","12754",
"온천2동","총인구","2023.07 월","9771","24610","11844","12766",
"온천2동","총인구","2023.08 월","9763","24566","11824","12742",
"온천2동","총인구","2023.09 월","9759","24591","11836","12755",
"온천2동","총인구","2023.10 월","9740","24558","11825","12733",
"온천2동","총인구","2023.11 월","9737","24532","11814","12718",
"온천2동","총인구","2023.12 월","9740","24489","11782","12707",
"온천2동","총인구","2024.01 월","9700","24375","11717","12658",
"온천2동","총인구","2024.02 월","9689","24259","11648","12611",
"온천2동","총인구","2024.03 월","9685","24256","11640","12616",
"온천2동","총인구","2024.04 월","9684","24226","11621","12605",
"온천2동","총인구","2024.05 월","9674","24193","11593","12600",
"온천2동","총인구","2024.06 월","9661","24155","11579","12576",
"온천2동","총인구","2024.07 월","9649","24133","11572","12561",
"온천2동","총인구","2024.08 월","9656","24137","11577","12560",
"온천2동","총인구","2024.09 월","9657","24127","11567","12560",
"온천2동","총인구","2024.10 월","9633","24051","11549","12502",
"온천2동","총인구","2024.11 월","9615","23994","11524","12470",
"온천2동","총인구","2024.12 월","9634","24017","11531","12486",
"온천3동","총인구","2020.01 월","16620","38583","18869","19714",
"온천3동","총인구","2020.02 월","16705","38696","18911","19785",
"온천3동","총인구","2020.03 월","16755","38653","18899","19754",
"온천3동","총인구","2020.04 월","16791","38690","18916","19774",
"온천3동","총인구","2020.05 월","16842","38729","18930","19799",
"온천3동","총인구","2020.06 월","16875","38731","18927","19804",
"온천3동","총인구","2020.07 월","17105","39224","19188","20036",
"온천3동","총인구","2020.08 월","17206","39385","19265","20120",
"온천3동","총인구","2020.09 월","17254","39437","19309","20128",
"온천3동","총인구","2020.10 월","17281","39429","19296","20133",
"온천3동","총인구","2020.11 월","17298","39405","19276","20129",
"온천3동","총인구","2020.12 월","17322","39367","19246","20121",
"온천3동","총인구","2021.01 월","17359","39393","19237","20156",
"온천3동","총인구","2021.02 월","17385","39313","19228","20085",
"온천3동","총인구","2021.03 월","17341","39222","19193","20029",
"온천3동","총인구","2021.04 월","17336","39152","19155","19997",
"온천3동","총인구","2021.05 월","17317","39030","19087","19943",
"온천3동","총인구","2021.06 월","17330","38993","19061","19932",
"온천3동","총인구","2021.07 월","17299","38872","19000","19872",
"온천3동","총인구","2021.08 월","17308","38805","18975","19830",
"온천3동","총인구","2021.09 월","17347","38795","18971","19824",
"온천3동","총인구","2021.10 월","17376","38764","18974","19790",
"온천3동","총인구","2021.11 월","17423","38773","18962","19811",
"온천3동","총인구","2021.12 월","17461","38716","18908","19808",
"온천3동","총인구","2022.01 월","17442","38565","18852","19713",
"온천3동","총인구","2022.02 월","17511","38500","18802","19698",
"온천3동","총인구","2022.03 월","17540","38491","18796","19695",
"온천3동","총인구","2022.04 월","17518","38440","18734","19706",
"온천3동","총인구","2022.05 월","17542","38413","18725","19688",
"온천3동","총인구","2022.06 월","17526","38341","18702","19639",
"온천3동","총인구","2022.07 월","17520","38257","18659","19598",
"온천3동","총인구","2022.08 월","17520","38180","18613","19567",
"온천3동","총인구","2022.09 월","17518","38172","18578","19594",
"온천3동","총인구","2022.10 월","17512","38081","18536","19545",
"온천3동","총인구","2022.11 월","17468","37980","18470","19510",
"온천3동","총인구","2022.12 월","17468","37929","18425","19504",
"온천3동","총인구","2023.01 월","17476","37892","18393","19499",
"온천3동","총인구","2023.02 월","17520","37853","18373","19480",
"온천3동","총인구","2023.03 월","17506","37754","18309","19445",
"온천3동","총인구","2023.04 월","17505","37718","18293","19425",
"온천3동","총인구","2023.05 월","17508","37676","18263","19413",
"온천3동","총인구","2023.06 월","17508","37625","18243","19382",
"온천3동","총인구","2023.07 월","17451","37478","18175","19303",
"온천3동","총인구","2023.08 월","17439","37377","18117","19260",
"온천3동","총인구","2023.09 월","17367","37209","18048","19161",
"온천3동","총인구","2023.10 월","17332","37180","18052","19128",
"온천3동","총인구","2023.11 월","17284","37035","17950","19085",
"온천3동","총인구","2023.12 월","17262","36900","17903","18997",
"온천3동","총인구","2024.01 월","17196","36736","17833","18903",
"온천3동","총인구","2024.02 월","17203","36621","17767","18854",
"온천3동","총인구","2024.03 월","17187","36536","17743","18793",
"온천3동","총인구","2024.04 월","17184","36503","17714","18789",
"온천3동","총인구","2024.05 월","17162","36471","17705","18766",
"온천3동","총인구","2024.06 월","17148","36383","17653","18730",
"온천3동","총인구","2024.07 월","17099","36226","17579","18647",
"온천3동","총인구","2024.08 월","17059","36122","17532","18590",
"온천3동","총인구","2024.09 월","17052","36061","17487","18574",
"온천3동","총인구","2024.10 월","17050","36011","17480","18531",
"온천3동","총인구","2024.11 월","17046","35941","17436","18505",
"온천3동","총인구","2024.12 월","17097","35954","17466","18488",
"사직1동","총인구","2020.01 월","4654","10959","5267","5692",
"사직1동","총인구","2020.02 월","4675","11011","5296","5715",
"사직1동","총인구","2020.03 월","4656","10948","5264","5684",
"사직1동","총인구","2020.04 월","4687","10949","5249","5700",
"사직1동","총인구","2020.05 월","4692","10941","5247","5694",
"사직1동","총인구","2020.06 월","4699","10915","5234","5681",
"사직1동","총인구","2020.07 월","4730","10917","5240","5677",
"사직1동","총인구","2020.08 월","4756","10916","5226","5690",
"사직1동","총인구","2020.09 월","4788","10936","5226","5710",
"사직1동","총인구","2020.10 월","4796","10934","5233","5701",
"사직1동","총인구","2020.11 월","4791","10881","5204","5677",
"사직1동","총인구","2020.12 월","4781","10848","5177","5671",
"사직1동","총인구","2021.01 월","4775","10830","5175","5655",
"사직1동","총인구","2021.02 월","4806","10855","5185","5670",
"사직1동","총인구","2021.03 월","4803","10851","5183","5668",
"사직1동","총인구","2021.04 월","4789","10812","5165","5647",
"사직1동","총인구","2021.05 월","4779","10766","5146","5620",
"사직1동","총인구","2021.06 월","4782","10746","5145","5601",
"사직1동","총인구","2021.07 월","4792","10744","5147","5597",
"사직1동","총인구","2021.08 월","4798","10742","5144","5598",
"사직1동","총인구","2021.09 월","4807","10725","5143","5582",
"사직1동","총인구","2021.10 월","4811","10714","5131","5583",
"사직1동","총인구","2021.11 월","4799","10674","5112","5562",
"사직1동","총인구","2021.12 월","4807","10673","5119","5554",
"사직1동","총인구","2022.01 월","4808","10606","5095","5511",
"사직1동","총인구","2022.02 월","4792","10549","5056","5493",
"사직1동","총인구","2022.03 월","4809","10587","5077","5510",
"사직1동","총인구","2022.04 월","4811","10580","5068","5512",
"사직1동","총인구","2022.05 월","4814","10581","5060","5521",
"사직1동","총인구","2022.06 월","4817","10565","5053","5512",
"사직1동","총인구","2022.07 월","4816","10538","5048","5490",
"사직1동","총인구","2022.08 월","4816","10518","5036","5482",
"사직1동","총인구","2022.09 월","4771","10443","5005","5438",
"사직1동","총인구","2022.10 월","4760","10389","4974","5415",
"사직1동","총인구","2022.11 월","4751","10366","4964","5402",
"사직1동","총인구","2022.12 월","4750","10366","4958","5408",
"사직1동","총인구","2023.01 월","4747","10371","4964","5407",
"사직1동","총인구","2023.02 월","4747","10368","4967","5401",
"사직1동","총인구","2023.03 월","4751","10349","4967","5382",
"사직1동","총인구","2023.04 월","4750","10336","4959","5377",
"사직1동","총인구","2023.05 월","4762","10356","4978","5378",
"사직1동","총인구","2023.06 월","4759","10326","4967","5359",
"사직1동","총인구","2023.07 월","4753","10323","4964","5359",
"사직1동","총인구","2023.08 월","4741","10274","4943","5331",
"사직1동","총인구","2023.09 월","4733","10261","4940","5321",
"사직1동","총인구","2023.10 월","4739","10257","4936","5321",
"사직1동","총인구","2023.11 월","4725","10210","4912","5298",
"사직1동","총인구","2023.12 월","4719","10167","4888","5279",
"사직1동","총인구","2024.01 월","4704","10093","4834","5259",
"사직1동","총인구","2024.02 월","4689","10044","4797","5247",
"사직1동","총인구","2024.03 월","4687","10028","4777","5251",
"사직1동","총인구","2024.04 월","4686","10035","4784","5251",
"사직1동","총인구","2024.05 월","4708","10088","4810","5278",
"사직1동","총인구","2024.06 월","4880","10589","5054","5535",
"사직1동","총인구","2024.07 월","5055","11067","5299","5768",
"사직1동","총인구","2024.08 월","5158","11309","5412","5897",
"사직1동","총인구","2024.09 월","5218","11509","5520","5989",
"사직1동","총인구","2024.10 월","5229","11587","5546","6041",
"사직1동","총인구","2024.11 월","5245","11629","5554","6075",
"사직1동","총인구","2024.12 월","5256","11693","5589","6104",
"사직2동","총인구","2020.01 월","9758","29194","14161","15033",
"사직2동","총인구","2020.02 월","9748","29140","14129","15011",
"사직2동","총인구","2020.03 월","9726","28910","14002","14908",
"사직2동","총인구","2020.04 월","9728","28823","13967","14856",
"사직2동","총인구","2020.05 월","9734","28797","13954","14843",
"사직2동","총인구","2020.06 월","9738","28759","13945","14814",
"사직2동","총인구","2020.07 월","9719","28625","13860","14765",
"사직2동","총인구","2020.08 월","9714","28567","13831","14736",
"사직2동","총인구","2020.09 월","9697","28489","13780","14709",
"사직2동","총인구","2020.10 월","9689","28442","13746","14696",
"사직2동","총인구","2020.11 월","9679","28372","13709","14663",
"사직2동","총인구","2020.12 월","9676","28272","13641","14631",
"사직2동","총인구","2021.01 월","9639","28171","13583","14588",
"사직2동","총인구","2021.02 월","9640","28134","13573","14561",
"사직2동","총인구","2021.03 월","9587","28006","13518","14488",
"사직2동","총인구","2021.04 월","9587","27938","13472","14466",
"사직2동","총인구","2021.05 월","9582","27890","13452","14438",
"사직2동","총인구","2021.06 월","9588","27858","13437","14421",
"사직2동","총인구","2021.07 월","9578","27786","13403","14383",
"사직2동","총인구","2021.08 월","9582","27751","13362","14389",
"사직2동","총인구","2021.09 월","9571","27666","13323","14343",
"사직2동","총인구","2021.10 월","9558","27579","13287","14292",
"사직2동","총인구","2021.11 월","9547","27489","13242","14247",
"사직2동","총인구","2021.12 월","9519","27371","13178","14193",
"사직2동","총인구","2022.01 월","9462","27150","13086","14064",
"사직2동","총인구","2022.02 월","9417","26979","12999","13980",
"사직2동","총인구","2022.03 월","9296","26692","12863","13829",
"사직2동","총인구","2022.04 월","9168","26373","12709","13664",
"사직2동","총인구","2022.05 월","9088","26138","12584","13554",
"사직2동","총인구","2022.06 월","9037","25997","12505","13492",
"사직2동","총인구","2022.07 월","9020","25930","12468","13462",
"사직2동","총인구","2022.08 월","8970","25811","12409","13402",
"사직2동","총인구","2022.09 월","8965","25784","12397","13387",
"사직2동","총인구","2022.10 월","8942","25731","12356","13375",
"사직2동","총인구","2022.11 월","8889","25641","12314","13327",
"사직2동","총인구","2022.12 월","8873","25570","12264","13306",
"사직2동","총인구","2023.01 월","8873","25582","12264","13318",
"사직2동","총인구","2023.02 월","8855","25454","12188","13266",
"사직2동","총인구","2023.03 월","8831","25376","12156","13220",
"사직2동","총인구","2023.04 월","8813","25320","12125","13195",
"사직2동","총인구","2023.05 월","8826","25324","12137","13187",
"사직2동","총인구","2023.06 월","8842","25350","12154","13196",
"사직2동","총인구","2023.07 월","8854","25361","12163","13198",
"사직2동","총인구","2023.08 월","8845","25324","12141","13183",
"사직2동","총인구","2023.09 월","8853","25345","12141","13204",
"사직2동","총인구","2023.10 월","8848","25313","12112","13201",
"사직2동","총인구","2023.11 월","8851","25341","12130","13211",
"사직2동","총인구","2023.12 월","8821","25201","12063","13138",
"사직2동","총인구","2024.01 월","8781","25037","11971","13066",
"사직2동","총인구","2024.02 월","8776","25024","11950","13074",
"사직2동","총인구","2024.03 월","8777","25016","11940","13076",
"사직2동","총인구","2024.04 월","8787","24993","11921","13072",
"사직2동","총인구","2024.05 월","8781","24941","11881","13060",
"사직2동","총인구","2024.06 월","8776","24887","11835","13052",
"사직2동","총인구","2024.07 월","8749","24786","11796","12990",
"사직2동","총인구","2024.08 월","8730","24726","11761","12965",
"사직2동","총인구","2024.09 월","8731","24704","11750","12954",
"사직2동","총인구","2024.10 월","8731","24647","11709","12938",
"사직2동","총인구","2024.11 월","8731","24619","11696","12923",
"사직2동","총인구","2024.12 월","8725","24580","11676","12904",
"사직3동","총인구","2020.01 월","6646","15426","7620","7806",
"사직3동","총인구","2020.02 월","6664","15427","7613","7814",
"사직3동","총인구","2020.03 월","7193","17063","8462","8601",
"사직3동","총인구","2020.04 월","7363","17579","8730","8849",
"사직3동","총인구","2020.05 월","7459","17767","8823","8944",
"사직3동","총인구","2020.06 월","7524","17901","8863","9038",
"사직3동","총인구","2020.07 월","7550","17878","8865","9013",
"사직3동","총인구","2020.08 월","7552","17878","8854","9024",
"사직3동","총인구","2020.09 월","7567","17879","8860","9019",
"사직3동","총인구","2020.10 월","7553","17860","8846","9014",
"사직3동","총인구","2020.11 월","7554","17834","8829","9005",
"사직3동","총인구","2020.12 월","7551","17764","8804","8960",
"사직3동","총인구","2021.01 월","7561","17775","8804","8971",
"사직3동","총인구","2021.02 월","7548","17725","8784","8941",
"사직3동","총인구","2021.03 월","7469","17547","8696","8851",
"사직3동","총인구","2021.04 월","7459","17516","8664","8852",
"사직3동","총인구","2021.05 월","7476","17521","8662","8859",
"사직3동","총인구","2021.06 월","7470","17484","8652","8832",
"사직3동","총인구","2021.07 월","7484","17496","8660","8836",
"사직3동","총인구","2021.08 월","7506","17539","8686","8853",
"사직3동","총인구","2021.09 월","7525","17582","8705","8877",
"사직3동","총인구","2021.10 월","7529","17568","8706","8862",
"사직3동","총인구","2021.11 월","7525","17554","8702","8852",
"사직3동","총인구","2021.12 월","7516","17506","8687","8819",
"사직3동","총인구","2022.01 월","7492","17408","8644","8764",
"사직3동","총인구","2022.02 월","7536","17401","8623","8778",
"사직3동","총인구","2022.03 월","7543","17322","8565","8757",
"사직3동","총인구","2022.04 월","7544","17248","8522","8726",
"사직3동","총인구","2022.05 월","7588","17280","8527","8753",
"사직3동","총인구","2022.06 월","7589","17257","8512","8745",
"사직3동","총인구","2022.07 월","7605","17258","8507","8751",
"사직3동","총인구","2022.08 월","7589","17240","8499","8741",
"사직3동","총인구","2022.09 월","7585","17229","8484","8745",
"사직3동","총인구","2022.10 월","7584","17217","8479","8738",
"사직3동","총인구","2022.11 월","7582","17247","8508","8739",
"사직3동","총인구","2022.12 월","7594","17238","8505","8733",
"사직3동","총인구","2023.01 월","7586","17191","8480","8711",
"사직3동","총인구","2023.02 월","7587","17151","8462","8689",
"사직3동","총인구","2023.03 월","7591","17137","8465","8672",
"사직3동","총인구","2023.04 월","7593","17117","8458","8659",
"사직3동","총인구","2023.05 월","7586","17066","8440","8626",
"사직3동","총인구","2023.06 월","7582","17049","8422","8627",
"사직3동","총인구","2023.07 월","7594","17065","8442","8623",
"사직3동","총인구","2023.08 월","7605","17075","8457","8618",
"사직3동","총인구","2023.09 월","7607","17094","8456","8638",
"사직3동","총인구","2023.10 월","7606","17104","8450","8654",
"사직3동","총인구","2023.11 월","7620","17159","8482","8677",
"사직3동","총인구","2023.12 월","7610","17115","8452","8663",
"사직3동","총인구","2024.01 월","7576","17014","8409","8605",
"사직3동","총인구","2024.02 월","7570","16961","8394","8567",
"사직3동","총인구","2024.03 월","7576","16939","8388","8551",
"사직3동","총인구","2024.04 월","7598","16966","8385","8581",
"사직3동","총인구","2024.05 월","7604","16940","8368","8572",
"사직3동","총인구","2024.06 월","7622","16953","8380","8573",
"사직3동","총인구","2024.07 월","7619","16890","8348","8542",
"사직3동","총인구","2024.08 월","7639","16905","8354","8551",
"사직3동","총인구","2024.09 월","7635","16876","8351","8525",
"사직3동","총인구","2024.10 월","7625","16850","8332","8518",
"사직3동","총인구","2024.11 월","7609","16817","8315","8502",
"사직3동","총인구","2024.12 월","7599","16777","8300","8477",
"안락1동","총인구","2020.01 월","6822","15303","7566","7737",
"안락1동","총인구","2020.02 월","6816","15239","7544","7695",
"안락1동","총인구","2020.03 월","6811","15229","7524","7705",
"안락1동","총인구","2020.04 월","6819","15248","7532","7716",
"안락1동","총인구","2020.05 월","6826","15234","7522","7712",
"안락1동","총인구","2020.06 월","6845","15246","7529","7717",
"안락1동","총인구","2020.07 월","6869","15244","7527","7717",
"안락1동","총인구","2020.08 월","6867","15207","7492","7715",
"안락1동","총인구","2020.09 월","6876","15142","7456","7686",
"안락1동","총인구","2020.10 월","6902","15122","7458","7664",
"안락1동","총인구","2020.11 월","6905","15041","7413","7628",
"안락1동","총인구","2020.12 월","6937","15041","7391","7650",
"안락1동","총인구","2021.01 월","6943","15043","7392","7651",
"안락1동","총인구","2021.02 월","6938","15008","7380","7628",
"안락1동","총인구","2021.03 월","6908","14945","7360","7585",
"안락1동","총인구","2021.04 월","6910","14906","7352","7554",
"안락1동","총인구","2021.05 월","6923","14901","7338","7563",
"안락1동","총인구","2021.06 월","6912","14855","7303","7552",
"안락1동","총인구","2021.07 월","6927","14835","7302","7533",
"안락1동","총인구","2021.08 월","6925","14794","7280","7514",
"안락1동","총인구","2021.09 월","6930","14776","7268","7508",
"안락1동","총인구","2021.10 월","6942","14760","7251","7509",
"안락1동","총인구","2021.11 월","6924","14702","7223","7479",
"안락1동","총인구","2021.12 월","6906","14645","7201","7444",
"안락1동","총인구","2022.01 월","6896","14567","7165","7402",
"안락1동","총인구","2022.02 월","6875","14472","7133","7339",
"안락1동","총인구","2022.03 월","6874","14420","7113","7307",
"안락1동","총인구","2022.04 월","6868","14401","7100","7301",
"안락1동","총인구","2022.05 월","6870","14365","7075","7290",
"안락1동","총인구","2022.06 월","6866","14315","7058","7257",
"안락1동","총인구","2022.07 월","6856","14270","7044","7226",
"안락1동","총인구","2022.08 월","6816","14231","7009","7222",
"안락1동","총인구","2022.09 월","6842","14253","7021","7232",
"안락1동","총인구","2022.10 월","6826","14218","7012","7206",
"안락1동","총인구","2022.11 월","6818","14181","6980","7201",
"안락1동","총인구","2022.12 월","6829","14178","6979","7199",
"안락1동","총인구","2023.01 월","6827","14172","6969","7203",
"안락1동","총인구","2023.02 월","6838","14145","6946","7199",
"안락1동","총인구","2023.03 월","6837","14124","6937","7187",
"안락1동","총인구","2023.04 월","6837","14110","6925","7185",
"안락1동","총인구","2023.05 월","6824","14068","6910","7158",
"안락1동","총인구","2023.06 월","6829","14066","6899","7167",
"안락1동","총인구","2023.07 월","6836","14068","6888","7180",
"안락1동","총인구","2023.08 월","6823","14012","6852","7160",
"안락1동","총인구","2023.09 월","6790","13928","6807","7121",
"안락1동","총인구","2023.10 월","6780","13879","6774","7105",
"안락1동","총인구","2023.11 월","6767","13818","6750","7068",
"안락1동","총인구","2023.12 월","6759","13778","6731","7047",
"안락1동","총인구","2024.01 월","6732","13704","6692","7012",
"안락1동","총인구","2024.02 월","6724","13642","6664","6978",
"안락1동","총인구","2024.03 월","6713","13610","6642","6968",
"안락1동","총인구","2024.04 월","6702","13589","6619","6970",
"안락1동","총인구","2024.05 월","6693","13563","6608","6955",
"안락1동","총인구","2024.06 월","6691","13549","6611","6938",
"안락1동","총인구","2024.07 월","6677","13487","6585","6902",
"안락1동","총인구","2024.08 월","6660","13426","6548","6878",
"안락1동","총인구","2024.09 월","6668","13418","6537","6881",
"안락1동","총인구","2024.10 월","6635","13344","6486","6858",
"안락1동","총인구","2024.11 월","6619","13315","6472","6843",
"안락1동","총인구","2024.12 월","6611","13272","6449","6823",
"안락2동","총인구","2020.01 월","11254","29017","14142","14875",
"안락2동","총인구","2020.02 월","11246","28901","14089","14812",
"안락2동","총인구","2020.03 월","11217","28716","13992","14724",
"안락2동","총인구","2020.04 월","11181","28562","13936","14626",
"안락2동","총인구","2020.05 월","11160","28415","13856","14559",
"안락2동","총인구","2020.06 월","11146","28317","13783","14534",
"안락2동","총인구","2020.07 월","11135","28232","13742","14490",
"안락2동","총인구","2020.08 월","11123","28141","13700","14441",
"안락2동","총인구","2020.09 월","11138","28088","13668","14420",
"안락2동","총인구","2020.10 월","11141","28022","13630","14392",
"안락2동","총인구","2020.11 월","11156","27991","13623","14368",
"안락2동","총인구","2020.12 월","11156","27913","13583","14330",
"안락2동","총인구","2021.01 월","11170","27868","13568","14300",
"안락2동","총인구","2021.02 월","11188","27850","13559","14291",
"안락2동","총인구","2021.03 월","11121","27702","13493","14209",
"안락2동","총인구","2021.04 월","11120","27632","13448","14184",
"안락2동","총인구","2021.05 월","11119","27537","13404","14133",
"안락2동","총인구","2021.06 월","11124","27515","13391","14124",
"안락2동","총인구","2021.07 월","11125","27471","13363","14108",
"안락2동","총인구","2021.08 월","11113","27394","13319","14075",
"안락2동","총인구","2021.09 월","11115","27382","13310","14072",
"안락2동","총인구","2021.10 월","11110","27337","13286","14051",
"안락2동","총인구","2021.11 월","11134","27356","13300","14056",
"안락2동","총인구","2021.12 월","11111","27264","13256","14008",
"안락2동","총인구","2022.01 월","11105","27160","13215","13945",
"안락2동","총인구","2022.02 월","11091","27085","13162","13923",
"안락2동","총인구","2022.03 월","11084","27031","13138","13893",
"안락2동","총인구","2022.04 월","11080","26950","13105","13845",
"안락2동","총인구","2022.05 월","11080","26888","13053","13835",
"안락2동","총인구","2022.06 월","11065","26846","13031","13815",
"안락2동","총인구","2022.07 월","11054","26802","13000","13802",
"안락2동","총인구","2022.08 월","11037","26744","12964","13780",
"안락2동","총인구","2022.09 월","11020","26683","12931","13752",
"안락2동","총인구","2022.10 월","10993","26602","12864","13738",
"안락2동","총인구","2022.11 월","10984","26523","12818","13705",
"안락2동","총인구","2022.12 월","11000","26534","12834","13700",
"안락2동","총인구","2023.01 월","11002","26472","12794","13678",
"안락2동","총인구","2023.02 월","10988","26396","12757","13639",
"안락2동","총인구","2023.03 월","10992","26350","12725","13625",
"안락2동","총인구","2023.04 월","10988","26307","12708","13599",
"안락2동","총인구","2023.05 월","10965","26227","12670","13557",
"안락2동","총인구","2023.06 월","10958","26214","12657","13557",
"안락2동","총인구","2023.07 월","10953","26177","12637","13540",
"안락2동","총인구","2023.08 월","10957","26177","12636","13541",
"안락2동","총인구","2023.09 월","10934","26124","12610","13514",
"안락2동","총인구","2023.10 월","10930","26085","12589","13496",
"안락2동","총인구","2023.11 월","10938","26076","12572","13504",
"안락2동","총인구","2023.12 월","10923","25972","12506","13466",
"안락2동","총인구","2024.01 월","10932","25944","12481","13463",
"안락2동","총인구","2024.02 월","11030","26225","12623","13602",
"안락2동","총인구","2024.03 월","11048","26258","12636","13622",
"안락2동","총인구","2024.04 월","11058","26257","12644","13613",
"안락2동","총인구","2024.05 월","11071","26313","12662","13651",
"안락2동","총인구","2024.06 월","11069","26274","12627","13647",
"안락2동","총인구","2024.07 월","11068","26229","12610","13619",
"안락2동","총인구","2024.08 월","11062","26212","12613","13599",
"안락2동","총인구","2024.09 월","11054","26158","12581","13577",
"안락2동","총인구","2024.10 월","11027","26118","12565","13553",
"안락2동","총인구","2024.11 월","11024","26061","12538","13523",
"안락2동","총인구","2024.12 월","11029","26035","12514","13521",
"명장1동","총인구","2020.01 월","6318","14880","7267","7613",
"명장1동","총인구","2020.02 월","6321","14892","7262","7630",
"명장1동","총인구","2020.03 월","6327","14867","7247","7620",
"명장1동","총인구","2020.04 월","6320","14806","7218","7588",
"명장1동","총인구","2020.05 월","6325","14801","7222","7579",
"명장1동","총인구","2020.06 월","6318","14721","7182","7539",
"명장1동","총인구","2020.07 월","6328","14722","7185","7537",
"명장1동","총인구","2020.08 월","6335","14683","7164","7519",
"명장1동","총인구","2020.09 월","6334","14687","7168","7519",
"명장1동","총인구","2020.10 월","6318","14624","7123","7501",
"명장1동","총인구","2020.11 월","6318","14583","7099","7484",
"명장1동","총인구","2020.12 월","6326","14550","7069","7481",
"명장1동","총인구","2021.01 월","6315","14505","7041","7464",
"명장1동","총인구","2021.02 월","6309","14503","7043","7460",
"명장1동","총인구","2021.03 월","6287","14465","7011","7454",
"명장1동","총인구","2021.04 월","6272","14454","6998","7456",
"명장1동","총인구","2021.05 월","6265","14373","6964","7409",
"명장1동","총인구","2021.06 월","6274","14388","6970","7418",
"명장1동","총인구","2021.07 월","6254","14334","6939","7395",
"명장1동","총인구","2021.08 월","6245","14310","6934","7376",
"명장1동","총인구","2021.09 월","6249","14274","6898","7376",
"명장1동","총인구","2021.10 월","6234","14205","6859","7346",
"명장1동","총인구","2021.11 월","6212","14132","6827","7305",
"명장1동","총인구","2021.12 월","6209","14088","6814","7274",
"명장1동","총인구","2022.01 월","6187","14004","6758","7246",
"명장1동","총인구","2022.02 월","6186","13976","6737","7239",
"명장1동","총인구","2022.03 월","6192","13978","6746","7232",
"명장1동","총인구","2022.04 월","6219","13984","6753","7231",
"명장1동","총인구","2022.05 월","6234","13975","6735","7240",
"명장1동","총인구","2022.06 월","6234","13992","6746","7246",
"명장1동","총인구","2022.07 월","6263","14007","6752","7255",
"명장1동","총인구","2022.08 월","6266","13977","6729","7248",
"명장1동","총인구","2022.09 월","6219","13900","6704","7196",
"명장1동","총인구","2022.10 월","6224","13876","6690","7186",
"명장1동","총인구","2022.11 월","6225","13872","6686","7186",
"명장1동","총인구","2022.12 월","6218","13858","6678","7180",
"명장1동","총인구","2023.01 월","6222","13841","6670","7171",
"명장1동","총인구","2023.02 월","6229","13812","6656","7156",
"명장1동","총인구","2023.03 월","6226","13788","6626","7162",
"명장1동","총인구","2023.04 월","6235","13805","6633","7172",
"명장1동","총인구","2023.05 월","6243","13781","6610","7171",
"명장1동","총인구","2023.06 월","6255","13762","6601","7161",
"명장1동","총인구","2023.07 월","6238","13700","6573","7127",
"명장1동","총인구","2023.08 월","6229","13698","6578","7120",
"명장1동","총인구","2023.09 월","6222","13669","6575","7094",
"명장1동","총인구","2023.10 월","6215","13650","6572","7078",
"명장1동","총인구","2023.11 월","6192","13600","6548","7052",
"명장1동","총인구","2023.12 월","6182","13550","6526","7024",
"명장1동","총인구","2024.01 월","6184","13546","6519","7027",
"명장1동","총인구","2024.02 월","6175","13522","6516","7006",
"명장1동","총인구","2024.03 월","6159","13468","6496","6972",
"명장1동","총인구","2024.04 월","6150","13420","6474","6946",
"명장1동","총인구","2024.05 월","6148","13408","6467","6941",
"명장1동","총인구","2024.06 월","6150","13402","6472","6930",
"명장1동","총인구","2024.07 월","6153","13405","6468","6937",
"명장1동","총인구","2024.08 월","6145","13399","6462","6937",
"명장1동","총인구","2024.09 월","6147","13402","6458","6944",
"명장1동","총인구","2024.10 월","6143","13375","6442","6933",
"명장1동","총인구","2024.11 월","6134","13325","6421","6904",
"명장1동","총인구","2024.12 월","6126","13284","6391","6893",
"명장2동","총인구","2020.01 월","6504","15454","7561","7893",
"명장2동","총인구","2020.02 월","6511","15440","7539","7901",
"명장2동","총인구","2020.03 월","6497","15368","7509","7859",
"명장2동","총인구","2020.04 월","6505","15378","7507","7871",
"명장2동","총인구","2020.05 월","6523","15389","7510","7879",
"명장2동","총인구","2020.06 월","6537","15377","7507","7870",
"명장2동","총인구","2020.07 월","6558","15350","7490","7860",
"명장2동","총인구","2020.08 월","6552","15289","7450","7839",
"명장2동","총인구","2020.09 월","6546","15246","7437","7809",
"명장2동","총인구","2020.10 월","6546","15223","7427","7796",
"명장2동","총인구","2020.11 월","6552","15198","7411","7787",
"명장2동","총인구","2020.12 월","6554","15141","7395","7746",
"명장2동","총인구","2021.01 월","6558","15112","7378","7734",
"명장2동","총인구","2021.02 월","6577","15078","7361","7717",
"명장2동","총인구","2021.03 월","6548","15013","7323","7690",
"명장2동","총인구","2021.04 월","6554","14977","7304","7673",
"명장2동","총인구","2021.05 월","6573","14987","7314","7673",
"명장2동","총인구","2021.06 월","6571","14961","7292","7669",
"명장2동","총인구","2021.07 월","6576","14968","7294","7674",
"명장2동","총인구","2021.08 월","6574","14965","7287","7678",
"명장2동","총인구","2021.09 월","6596","14963","7296","7667",
"명장2동","총인구","2021.10 월","6588","14935","7290","7645",
"명장2동","총인구","2021.11 월","6603","14941","7286","7655",
"명장2동","총인구","2021.12 월","6604","14905","7268","7637",
"명장2동","총인구","2022.01 월","6596","14858","7231","7627",
"명장2동","총인구","2022.02 월","6586","14771","7183","7588",
"명장2동","총인구","2022.03 월","6587","14721","7162","7559",
"명장2동","총인구","2022.04 월","6596","14703","7158","7545",
"명장2동","총인구","2022.05 월","6620","14714","7158","7556",
"명장2동","총인구","2022.06 월","6620","14657","7121","7536",
"명장2동","총인구","2022.07 월","6625","14626","7098","7528",
"명장2동","총인구","2022.08 월","6627","14575","7088","7487",
"명장2동","총인구","2022.09 월","6613","14551","7079","7472",
"명장2동","총인구","2022.10 월","6606","14507","7058","7449",
"명장2동","총인구","2022.11 월","6596","14475","7040","7435",
"명장2동","총인구","2022.12 월","6585","14432","7011","7421",
"명장2동","총인구","2023.01 월","6580","14398","7000","7398",
"명장2동","총인구","2023.02 월","6567","14331","6976","7355",
"명장2동","총인구","2023.03 월","6546","14257","6939","7318",
"명장2동","총인구","2023.04 월","6540","14205","6902","7303",
"명장2동","총인구","2023.05 월","6528","14160","6870","7290",
"명장2동","총인구","2023.06 월","6518","14102","6845","7257",
"명장2동","총인구","2023.07 월","6510","14098","6846","7252",
"명장2동","총인구","2023.08 월","6494","14059","6828","7231",
"명장2동","총인구","2023.09 월","6502","14058","6821","7237",
"명장2동","총인구","2023.10 월","6479","14003","6792","7211",
"명장2동","총인구","2023.11 월","6482","14001","6789","7212",
"명장2동","총인구","2023.12 월","6480","13979","6786","7193",
"명장2동","총인구","2024.01 월","6463","13940","6768","7172",
"명장2동","총인구","2024.02 월","6429","13824","6697","7127",
"명장2동","총인구","2024.03 월","6413","13798","6685","7113",
"명장2동","총인구","2024.04 월","6408","13781","6673","7108",
"명장2동","총인구","2024.05 월","6423","13774","6663","7111",
"명장2동","총인구","2024.06 월","6423","13756","6644","7112",
"명장2동","총인구","2024.07 월","6423","13741","6640","7101",
"명장2동","총인구","2024.08 월","6422","13720","6624","7096",
"명장2동","총인구","2024.09 월","6423","13708","6607","7101",
"명장2동","총인구","2024.10 월","6413","13644","6571","7073",
"명장2동","총인구","2024.11 월","6402","13589","6536","7053",
"명장2동","총인구","2024.12 월","6396","13557","6516","7041",
"남구","총인구","2020.01 월","117212","280052","137258","142794",
"남구","총인구","2020.02 월","117208","279203","136804","142399",
"남구","총인구","2020.03 월","117299","278619","136448","142171",
"남구","총인구","2020.04 월","117167","277599","136018","141581",
"남구","총인구","2020.05 월","117350","276728","135553","141175",
"남구","총인구","2020.06 월","117429","276111","135244","140867",
"남구","총인구","2020.07 월","117537","275565","134988","140577",
"남구","총인구","2020.08 월","117649","274994","134693","140301",
"남구","총인구","2020.09 월","117696","274824","134572","140252",
"남구","총인구","2020.10 월","117685","274219","134328","139891",
"남구","총인구","2020.11 월","117804","273735","134096","139639",
"남구","총인구","2020.12 월","117876","273144","133785","139359",
"남구","총인구","2021.01 월","117885","272700","133507","139193",
"남구","총인구","2021.02 월","118052","272272","133311","138961",
"남구","총인구","2021.03 월","117391","271176","132814","138362",
"남구","총인구","2021.04 월","117426","270610","132538","138072",
"남구","총인구","2021.05 월","117429","270063","132274","137789",
"남구","총인구","2021.06 월","117410","269492","131951","137541",
"남구","총인구","2021.07 월","117384","269085","131692","137393",
"남구","총인구","2021.08 월","117494","268615","131412","137203",
"남구","총인구","2021.09 월","117793","268683","131395","137288",
"남구","총인구","2021.10 월","118005","268663","131343","137320",
"남구","총인구","2021.11 월","117987","268246","131125","137121",
"남구","총인구","2021.12 월","117821","267422","130654","136768",
"남구","총인구","2022.01 월","117619","266557","130274","136283",
"남구","총인구","2022.02 월","117815","265905","129966","135939",
"남구","총인구","2022.03 월","118153","266025","130008","136017",
"남구","총인구","2022.04 월","118406","266059","130045","136014",
"남구","총인구","2022.05 월","118544","265675","129842","135833",
"남구","총인구","2022.06 월","118480","265158","129581","135577",
"남구","총인구","2022.07 월","118358","264557","129277","135280",
"남구","총인구","2022.08 월","118468","264112","129045","135067",
"남구","총인구","2022.09 월","118179","263401","128694","134707",
"남구","총인구","2022.10 월","117964","262904","128458","134446",
"남구","총인구","2022.11 월","117707","262584","128355","134229",
"남구","총인구","2022.12 월","117601","262253","128182","134071",
"남구","총인구","2023.01 월","117668","262093","128079","134014",
"남구","총인구","2023.02 월","118209","262157","128132","134025",
"남구","총인구","2023.03 월","118462","262385","128209","134176",
"남구","총인구","2023.04 월","118556","262382","128177","134205",
"남구","총인구","2023.05 월","118686","262272","128089","134183",
"남구","총인구","2023.06 월","118673","261921","127899","134022",
"남구","총인구","2023.07 월","118641","261486","127672","133814",
"남구","총인구","2023.08 월","118641","261141","127485","133656",
"남구","총인구","2023.09 월","118470","260910","127358","133552",
"남구","총인구","2023.10 월","118390","261212","127517","133695",
"남구","총인구","2023.11 월","118495","261166","127485","133681",
"남구","총인구","2023.12 월","118427","260899","127288","133611",
"남구","총인구","2024.01 월","118473","261011","127272","133739",
"남구","총인구","2024.02 월","119141","261630","127622","134008",
"남구","총인구","2024.03 월","119660","262024","127813","134211",
"남구","총인구","2024.04 월","119893","262834","128179","134655",
"남구","총인구","2024.05 월","119954","262794","128123","134671",
"남구","총인구","2024.06 월","120102","262982","128269","134713",
"남구","총인구","2024.07 월","120157","262903","128231","134672",
"남구","총인구","2024.08 월","120126","262440","127989","134451",
"남구","총인구","2024.09 월","120134","262584","128077","134507",
"남구","총인구","2024.10 월","120050","262893","128233","134660",
"남구","총인구","2024.11 월","119904","262605","128085","134520",
"남구","총인구","2024.12 월","119763","262318","127913","134405",
"대연1동","총인구","2020.01 월","8810","17808","8960","8848",
"대연1동","총인구","2020.02 월","8816","17733","8947","8786",
"대연1동","총인구","2020.03 월","8833","17687","8936","8751",
"대연1동","총인구","2020.04 월","8806","17595","8905","8690",
"대연1동","총인구","2020.05 월","8843","17490","8834","8656",
"대연1동","총인구","2020.06 월","8839","17443","8807","8636",
"대연1동","총인구","2020.07 월","8854","17394","8792","8602",
"대연1동","총인구","2020.08 월","8889","17380","8786","8594",
"대연1동","총인구","2020.09 월","8896","17316","8763","8553",
"대연1동","총인구","2020.10 월","8875","17265","8750","8515",
"대연1동","총인구","2020.11 월","8889","17207","8730","8477",
"대연1동","총인구","2020.12 월","8909","17177","8719","8458",
"대연1동","총인구","2021.01 월","8908","17136","8687","8449",
"대연1동","총인구","2021.02 월","8926","17134","8699","8435",
"대연1동","총인구","2021.03 월","8928","17131","8702","8429",
"대연1동","총인구","2021.04 월","8919","17064","8675","8389",
"대연1동","총인구","2021.05 월","8920","17043","8669","8374",
"대연1동","총인구","2021.06 월","8932","17040","8659","8381",
"대연1동","총인구","2021.07 월","8918","17046","8657","8389",
"대연1동","총인구","2021.08 월","8947","17054","8663","8391",
"대연1동","총인구","2021.09 월","9012","17101","8706","8395",
"대연1동","총인구","2021.10 월","9052","17131","8744","8387",
"대연1동","총인구","2021.11 월","9058","17103","8720","8383",
"대연1동","총인구","2021.12 월","8998","17023","8693","8330",
"대연1동","총인구","2022.01 월","8954","16929","8654","8275",
"대연1동","총인구","2022.02 월","9023","16956","8675","8281",
"대연1동","총인구","2022.03 월","9093","16995","8693","8302",
"대연1동","총인구","2022.04 월","9155","17046","8719","8327",
"대연1동","총인구","2022.05 월","9173","17034","8714","8320",
"대연1동","총인구","2022.06 월","9230","17078","8721","8357",
"대연1동","총인구","2022.07 월","9223","17086","8734","8352",
"대연1동","총인구","2022.08 월","9243","17097","8743","8354",
"대연1동","총인구","2022.09 월","9313","17161","8795","8366",
"대연1동","총인구","2022.10 월","9312","17149","8787","8362",
"대연1동","총인구","2022.11 월","9295","17165","8823","8342",
"대연1동","총인구","2022.12 월","9295","17170","8830","8340",
"대연1동","총인구","2023.01 월","9290","17152","8813","8339",
"대연1동","총인구","2023.02 월","9419","17222","8859","8363",
"대연1동","총인구","2023.03 월","9482","17322","8926","8396",
"대연1동","총인구","2023.04 월","9466","17263","8885","8378",
"대연1동","총인구","2023.05 월","9480","17252","8876","8376",
"대연1동","총인구","2023.06 월","9435","17143","8816","8327",
"대연1동","총인구","2023.07 월","9430","17093","8801","8292",
"대연1동","총인구","2023.08 월","9455","17055","8787","8268",
"대연1동","총인구","2023.09 월","9420","17089","8808","8281",
"대연1동","총인구","2023.10 월","9332","17021","8786","8235",
"대연1동","총인구","2023.11 월","9292","16927","8720","8207",
"대연1동","총인구","2023.12 월","9255","16856","8655","8201",
"대연1동","총인구","2024.01 월","9204","16796","8636","8160",
"대연1동","총인구","2024.02 월","9298","16894","8694","8200",
"대연1동","총인구","2024.03 월","9371","16952","8724","8228",
"대연1동","총인구","2024.04 월","9469","17227","8882","8345",
"대연1동","총인구","2024.05 월","9454","17207","8870","8337",
"대연1동","총인구","2024.06 월","9442","17139","8836","8303",
"대연1동","총인구","2024.07 월","9406","17056","8794","8262",
"대연1동","총인구","2024.08 월","9387","17003","8764","8239",
"대연1동","총인구","2024.09 월","9397","17052","8785","8267",
"대연1동","총인구","2024.10 월","9419","17237","8888","8349",
"대연1동","총인구","2024.11 월","9403","17208","8854","8354",
"대연1동","총인구","2024.12 월","9384","17217","8849","8368",
"대연3동","총인구","2020.01 월","14939","36090","17613","18477",
"대연3동","총인구","2020.02 월","14981","36070","17592","18478",
"대연3동","총인구","2020.03 월","15107","36114","17580","18534",
"대연3동","총인구","2020.04 월","15116","35775","17464","18311",
"대연3동","총인구","2020.05 월","15195","35565","17393","18172",
"대연3동","총인구","2020.06 월","15240","35547","17403","18144",
"대연3동","총인구","2020.07 월","15264","35469","17364","18105",
"대연3동","총인구","2020.08 월","15305","35422","17330","18092",
"대연3동","총인구","2020.09 월","15329","35646","17410","18236",
"대연3동","총인구","2020.10 월","15320","35560","17367","18193",
"대연3동","총인구","2020.11 월","15361","35554","17353","18201",
"대연3동","총인구","2020.12 월","15358","35381","17261","18120",
"대연3동","총인구","2021.01 월","15289","35271","17220","18051",
"대연3동","총인구","2021.02 월","15319","35211","17223","17988",
"대연3동","총인구","2021.03 월","15371","35284","17271","18013",
"대연3동","총인구","2021.04 월","15404","35233","17269","17964",
"대연3동","총인구","2021.05 월","15386","35124","17217","17907",
"대연3동","총인구","2021.06 월","15367","35003","17156","17847",
"대연3동","총인구","2021.07 월","15316","34911","17099","17812",
"대연3동","총인구","2021.08 월","15380","34857","17079","17778",
"대연3동","총인구","2021.09 월","15546","35147","17227","17920",
"대연3동","총인구","2021.10 월","15600","35214","17247","17967",
"대연3동","총인구","2021.11 월","15624","35196","17257","17939",
"대연3동","총인구","2021.12 월","15596","35047","17169","17878",
"대연3동","총인구","2022.01 월","15551","34924","17160","17764",
"대연3동","총인구","2022.02 월","15694","34955","17190","17765",
"대연3동","총인구","2022.03 월","15805","35210","17283","17927",
"대연3동","총인구","2022.04 월","15857","35220","17295","17925",
"대연3동","총인구","2022.05 월","15909","35210","17299","17911",
"대연3동","총인구","2022.06 월","15935","35182","17295","17887",
"대연3동","총인구","2022.07 월","15924","35083","17236","17847",
"대연3동","총인구","2022.08 월","16119","35215","17303","17912",
"대연3동","총인구","2022.09 월","16180","35310","17348","17962",
"대연3동","총인구","2022.10 월","16238","35624","17488","18136",
"대연3동","총인구","2022.11 월","16284","35782","17569","18213",
"대연3동","총인구","2022.12 월","16277","35805","17575","18230",
"대연3동","총인구","2023.01 월","16199","35691","17524","18167",
"대연3동","총인구","2023.02 월","16446","35774","17607","18167",
"대연3동","총인구","2023.03 월","16583","36071","17742","18329",
"대연3동","총인구","2023.04 월","16603","36091","17755","18336",
"대연3동","총인구","2023.05 월","16638","36141","17775","18366",
"대연3동","총인구","2023.06 월","16648","36096","17744","18352",
"대연3동","총인구","2023.07 월","16655","36005","17705","18300",
"대연3동","총인구","2023.08 월","16711","36004","17705","18299",
"대연3동","총인구","2023.09 월","16681","36110","17748","18362",
"대연3동","총인구","2023.10 월","16631","36289","17838","18451",
"대연3동","총인구","2023.11 월","16595","36182","17796","18386",
"대연3동","총인구","2023.12 월","16531","36116","17764","18352",
"대연3동","총인구","2024.01 월","16675","36565","17953","18612",
"대연3동","총인구","2024.02 월","17178","37370","18375","18995",
"대연3동","총인구","2024.03 월","17614","37945","18657","19288",
"대연3동","총인구","2024.04 월","17809","38723","19036","19687",
"대연3동","총인구","2024.05 월","17971","38935","19133","19802",
"대연3동","총인구","2024.06 월","18042","39060","19205","19855",
"대연3동","총인구","2024.07 월","18090","39108","19222","19886",
"대연3동","총인구","2024.08 월","18142","39060","19218","19842",
"대연3동","총인구","2024.09 월","18262","39329","19364","19965",
"대연3동","총인구","2024.10 월","18285","39765","19546","20219",
"대연3동","총인구","2024.11 월","18293","39804","19555","20249",
"대연3동","총인구","2024.12 월","18257","39781","19547","20234",
"대연4동","총인구","2020.01 월","5562","12972","6328","6644",
"대연4동","총인구","2020.02 월","5566","12950","6309","6641",
"대연4동","총인구","2020.03 월","5569","12950","6316","6634",
"대연4동","총인구","2020.04 월","5565","12937","6293","6644",
"대연4동","총인구","2020.05 월","5582","12942","6303","6639",
"대연4동","총인구","2020.06 월","5588","12938","6306","6632",
"대연4동","총인구","2020.07 월","5572","12864","6272","6592",
"대연4동","총인구","2020.08 월","5557","12763","6217","6546",
"대연4동","총인구","2020.09 월","5553","12748","6209","6539",
"대연4동","총인구","2020.10 월","5545","12717","6204","6513",
"대연4동","총인구","2020.11 월","5551","12686","6196","6490",
"대연4동","총인구","2020.12 월","5541","12656","6162","6494",
"대연4동","총인구","2021.01 월","5558","12661","6155","6506",
"대연4동","총인구","2021.02 월","5564","12654","6161","6493",
"대연4동","총인구","2021.03 월","5507","12599","6143","6456",
"대연4동","총인구","2021.04 월","5514","12593","6151","6442",
"대연4동","총인구","2021.05 월","5506","12587","6145","6442",
"대연4동","총인구","2021.06 월","5496","12552","6128","6424",
"대연4동","총인구","2021.07 월","5499","12532","6115","6417",
"대연4동","총인구","2021.08 월","5492","12476","6086","6390",
"대연4동","총인구","2021.09 월","5488","12453","6073","6380",
"대연4동","총인구","2021.10 월","5496","12465","6087","6378",
"대연4동","총인구","2021.11 월","5486","12444","6082","6362",
"대연4동","총인구","2021.12 월","5496","12455","6097","6358",
"대연4동","총인구","2022.01 월","5493","12428","6077","6351",
"대연4동","총인구","2022.02 월","5488","12362","6039","6323",
"대연4동","총인구","2022.03 월","5494","12326","6021","6305",
"대연4동","총인구","2022.04 월","5486","12308","6010","6298",
"대연4동","총인구","2022.05 월","5488","12280","5991","6289",
"대연4동","총인구","2022.06 월","5485","12260","5980","6280",
"대연4동","총인구","2022.07 월","5474","12209","5956","6253",
"대연4동","총인구","2022.08 월","5482","12195","5952","6243",
"대연4동","총인구","2022.09 월","5466","12173","5937","6236",
"대연4동","총인구","2022.10 월","5449","12107","5910","6197",
"대연4동","총인구","2022.11 월","5429","12094","5901","6193",
"대연4동","총인구","2022.12 월","5426","12088","5887","6201",
"대연4동","총인구","2023.01 월","5420","12060","5873","6187",
"대연4동","총인구","2023.02 월","5426","12025","5839","6186",
"대연4동","총인구","2023.03 월","5434","12021","5838","6183",
"대연4동","총인구","2023.04 월","5423","11996","5832","6164",
"대연4동","총인구","2023.05 월","5423","11983","5825","6158",
"대연4동","총인구","2023.06 월","5420","11957","5801","6156",
"대연4동","총인구","2023.07 월","5412","11928","5782","6146",
"대연4동","총인구","2023.08 월","5407","11931","5776","6155",
"대연4동","총인구","2023.09 월","5411","11944","5775","6169",
"대연4동","총인구","2023.10 월","5721","12663","6131","6532",
"대연4동","총인구","2023.11 월","6010","13296","6441","6855",
"대연4동","총인구","2023.12 월","6141","13564","6562","7002",
"대연4동","총인구","2024.01 월","6209","13724","6647","7077",
"대연4동","총인구","2024.02 월","6281","13872","6731","7141",
"대연4동","총인구","2024.03 월","6313","13944","6764","7180",
"대연4동","총인구","2024.04 월","6331","13957","6762","7195",
"대연4동","총인구","2024.05 월","6342","13993","6775","7218",
"대연4동","총인구","2024.06 월","6335","14002","6781","7221",
"대연4동","총인구","2024.07 월","6334","13998","6772","7226",
"대연4동","총인구","2024.08 월","6346","14005","6777","7228",
"대연4동","총인구","2024.09 월","6345","14020","6785","7235",
"대연4동","총인구","2024.10 월","6350","14009","6779","7230",
"대연4동","총인구","2024.11 월","6343","13986","6765","7221",
"대연4동","총인구","2024.12 월","6340","13977","6767","7210",
"대연5동","총인구","2020.01 월","7576","17362","8371","8991",
"대연5동","총인구","2020.02 월","7608","17354","8372","8982",
"대연5동","총인구","2020.03 월","7685","17450","8407","9043",
"대연5동","총인구","2020.04 월","7716","17458","8416","9042",
"대연5동","총인구","2020.05 월","7735","17389","8380","9009",
"대연5동","총인구","2020.06 월","7758","17368","8376","8992",
"대연5동","총인구","2020.07 월","7770","17316","8369","8947",
"대연5동","총인구","2020.08 월","7789","17250","8347","8903",
"대연5동","총인구","2020.09 월","7758","17137","8303","8834",
"대연5동","총인구","2020.10 월","7769","17066","8279","8787",
"대연5동","총인구","2020.11 월","7796","17046","8269","8777",
"대연5동","총인구","2020.12 월","7830","17068","8285","8783",
"대연5동","총인구","2021.01 월","7854","17076","8266","8810",
"대연5동","총인구","2021.02 월","7932","17122","8284","8838",
"대연5동","총인구","2021.03 월","7916","17067","8254","8813",
"대연5동","총인구","2021.04 월","7947","17066","8241","8825",
"대연5동","총인구","2021.05 월","7968","17049","8229","8820",
"대연5동","총인구","2021.06 월","7976","17044","8216","8828",
"대연5동","총인구","2021.07 월","8001","17081","8231","8850",
"대연5동","총인구","2021.08 월","8048","17123","8250","8873",
"대연5동","총인구","2021.09 월","8080","17120","8238","8882",
"대연5동","총인구","2021.10 월","8107","17152","8254","8898",
"대연5동","총인구","2021.11 월","8133","17169","8249","8920",
"대연5동","총인구","2021.12 월","8170","17187","8246","8941",
"대연5동","총인구","2022.01 월","8191","17185","8242","8943",
"대연5동","총인구","2022.02 월","8259","17180","8240","8940",
"대연5동","총인구","2022.03 월","8273","17121","8205","8916",
"대연5동","총인구","2022.04 월","8313","17146","8230","8916",
"대연5동","총인구","2022.05 월","8342","17150","8237","8913",
"대연5동","총인구","2022.06 월","8357","17145","8238","8907",
"대연5동","총인구","2022.07 월","8347","17123","8209","8914",
"대연5동","총인구","2022.08 월","8382","17120","8199","8921",
"대연5동","총인구","2022.09 월","8362","17084","8191","8893",
"대연5동","총인구","2022.10 월","8357","17025","8167","8858",
"대연5동","총인구","2022.11 월","8341","16990","8167","8823",
"대연5동","총인구","2022.12 월","8356","17028","8174","8854",
"대연5동","총인구","2023.01 월","8354","17002","8158","8844",
"대연5동","총인구","2023.02 월","8392","17005","8166","8839",
"대연5동","총인구","2023.03 월","8403","17001","8155","8846",
"대연5동","총인구","2023.04 월","8420","17030","8178","8852",
"대연5동","총인구","2023.05 월","8436","17028","8176","8852",
"대연5동","총인구","2023.06 월","8446","17021","8180","8841",
"대연5동","총인구","2023.07 월","8439","16991","8144","8847",
"대연5동","총인구","2023.08 월","8461","16972","8147","8825",
"대연5동","총인구","2023.09 월","8459","16951","8138","8813",
"대연5동","총인구","2023.10 월","8451","16939","8120","8819",
"대연5동","총인구","2023.11 월","8451","16910","8098","8812",
"대연5동","총인구","2023.12 월","8477","16913","8084","8829",
"대연5동","총인구","2024.01 월","8461","16852","8055","8797",
"대연5동","총인구","2024.02 월","8471","16806","8028","8778",
"대연5동","총인구","2024.03 월","8486","16781","8019","8762",
"대연5동","총인구","2024.04 월","8477","16865","8034","8831",
"대연5동","총인구","2024.05 월","8464","16847","8015","8832",
"대연5동","총인구","2024.06 월","8435","16778","7985","8793",
"대연5동","총인구","2024.07 월","8414","16683","7949","8734",
"대연5동","총인구","2024.08 월","8417","16626","7953","8673",
"대연5동","총인구","2024.09 월","8392","16597","7950","8647",
"대연5동","총인구","2024.10 월","8385","16602","7960","8642",
"대연5동","총인구","2024.11 월","8383","16600","7963","8637",
"대연5동","총인구","2024.12 월","8359","16555","7943","8612",
"대연6동","총인구","2020.01 월","6143","16499","7950","8549",
"대연6동","총인구","2020.02 월","6110","16316","7842","8474",
"대연6동","총인구","2020.03 월","6037","16095","7729","8366",
"대연6동","총인구","2020.04 월","5972","15927","7649","8278",
"대연6동","총인구","2020.05 월","5953","15846","7619","8227",
"대연6동","총인구","2020.06 월","5948","15831","7616","8215",
"대연6동","총인구","2020.07 월","5946","15802","7609","8193",
"대연6동","총인구","2020.08 월","5934","15747","7573","8174",
"대연6동","총인구","2020.09 월","5938","15733","7564","8169",
"대연6동","총인구","2020.10 월","5935","15725","7560","8165",
"대연6동","총인구","2020.11 월","5923","15703","7550","8153",
"대연6동","총인구","2020.12 월","5940","15732","7572","8160",
"대연6동","총인구","2021.01 월","5936","15736","7569","8167",
"대연6동","총인구","2021.02 월","5947","15738","7580","8158",
"대연6동","총인구","2021.03 월","5922","15685","7555","8130",
"대연6동","총인구","2021.04 월","5910","15648","7532","8116",
"대연6동","총인구","2021.05 월","5907","15625","7532","8093",
"대연6동","총인구","2021.06 월","5922","15635","7524","8111",
"대연6동","총인구","2021.07 월","5926","15605","7512","8093",
"대연6동","총인구","2021.08 월","5918","15562","7494","8068",
"대연6동","총인구","2021.09 월","5926","15549","7492","8057",
"대연6동","총인구","2021.10 월","5933","15526","7465","8061",
"대연6동","총인구","2021.11 월","5936","15526","7470","8056",
"대연6동","총인구","2021.12 월","5926","15466","7440","8026",
"대연6동","총인구","2022.01 월","5919","15407","7416","7991",
"대연6동","총인구","2022.02 월","5910","15350","7386","7964",
"대연6동","총인구","2022.03 월","5904","15320","7386","7934",
"대연6동","총인구","2022.04 월","5892","15245","7345","7900",
"대연6동","총인구","2022.05 월","5888","15221","7319","7902",
"대연6동","총인구","2022.06 월","5879","15214","7320","7894",
"대연6동","총인구","2022.07 월","5873","15136","7290","7846",
"대연6동","총인구","2022.08 월","5878","15160","7313","7847",
"대연6동","총인구","2022.09 월","5867","15131","7302","7829",
"대연6동","총인구","2022.10 월","5868","15114","7290","7824",
"대연6동","총인구","2022.11 월","5843","15060","7234","7826",
"대연6동","총인구","2022.12 월","5837","15040","7217","7823",
"대연6동","총인구","2023.01 월","5833","15011","7203","7808",
"대연6동","총인구","2023.02 월","5835","14953","7176","7777",
"대연6동","총인구","2023.03 월","5822","14937","7178","7759",
"대연6동","총인구","2023.04 월","5850","14959","7178","7781",
"대연6동","총인구","2023.05 월","5885","14986","7186","7800",
"대연6동","총인구","2023.06 월","5900","14995","7191","7804",
"대연6동","총인구","2023.07 월","5898","14974","7182","7792",
"대연6동","총인구","2023.08 월","5883","14954","7180","7774",
"대연6동","총인구","2023.09 월","5876","14943","7170","7773",
"대연6동","총인구","2023.10 월","5855","14876","7140","7736",
"대연6동","총인구","2023.11 월","5848","14847","7132","7715",
"대연6동","총인구","2023.12 월","5838","14812","7116","7696",
"대연6동","총인구","2024.01 월","5828","14784","7103","7681",
"대연6동","총인구","2024.02 월","5817","14734","7058","7676",
"대연6동","총인구","2024.03 월","5834","14736","7083","7653",
"대연6동","총인구","2024.04 월","5828","14718","7074","7644",
"대연6동","총인구","2024.05 월","5823","14710","7066","7644",
"대연6동","총인구","2024.06 월","6003","15150","7278","7872",
"대연6동","총인구","2024.07 월","6146","15510","7468","8042",
"대연6동","총인구","2024.08 월","6206","15664","7532","8132",
"대연6동","총인구","2024.09 월","6226","15727","7568","8159",
"대연6동","총인구","2024.10 월","6236","15772","7591","8181",
"대연6동","총인구","2024.11 월","6225","15772","7597","8175",
"대연6동","총인구","2024.12 월","6210","15756","7569","8187",
"용호1동","총인구","2020.01 월","17014","46425","22367","24058",
"용호1동","총인구","2020.02 월","17023","46326","22326","24000",
"용호1동","총인구","2020.03 월","17022","46248","22279","23969",
"용호1동","총인구","2020.04 월","17037","46149","22246","23903",
"용호1동","총인구","2020.05 월","17042","46019","22163","23856",
"용호1동","총인구","2020.06 월","17075","45931","22112","23819",
"용호1동","총인구","2020.07 월","17078","45874","22078","23796",
"용호1동","총인구","2020.08 월","17074","45752","22033","23719",
"용호1동","총인구","2020.09 월","17099","45681","22002","23679",
"용호1동","총인구","2020.10 월","17106","45625","21973","23652",
"용호1동","총인구","2020.11 월","17129","45646","21991","23655",
"용호1동","총인구","2020.12 월","17125","45540","21944","23596",
"용호1동","총인구","2021.01 월","17156","45512","21918","23594",
"용호1동","총인구","2021.02 월","17149","45367","21851","23516",
"용호1동","총인구","2021.03 월","17124","45298","21821","23477",
"용호1동","총인구","2021.04 월","17131","45256","21796","23460",
"용호1동","총인구","2021.05 월","17133","45218","21775","23443",
"용호1동","총인구","2021.06 월","17128","45107","21741","23366",
"용호1동","총인구","2021.07 월","17125","45020","21680","23340",
"용호1동","총인구","2021.08 월","17119","44948","21627","23321",
"용호1동","총인구","2021.09 월","17155","44967","21611","23356",
"용호1동","총인구","2021.10 월","17170","44915","21570","23345",
"용호1동","총인구","2021.11 월","17197","44916","21559","23357",
"용호1동","총인구","2021.12 월","17171","44819","21500","23319",
"용호1동","총인구","2022.01 월","17177","44771","21486","23285",
"용호1동","총인구","2022.02 월","17187","44658","21407","23251",
"용호1동","총인구","2022.03 월","17174","44530","21332","23198",
"용호1동","총인구","2022.04 월","17177","44443","21285","23158",
"용호1동","총인구","2022.05 월","17175","44360","21243","23117",
"용호1동","총인구","2022.06 월","17164","44248","21195","23053",
"용호1동","총인구","2022.07 월","17158","44183","21151","23032",
"용호1동","총인구","2022.08 월","17119","44072","21105","22967",
"용호1동","총인구","2022.09 월","17115","44030","21076","22954",
"용호1동","총인구","2022.10 월","17096","43936","21047","22889",
"용호1동","총인구","2022.11 월","17066","43913","21040","22873",
"용호1동","총인구","2022.12 월","17030","43792","20980","22812",
"용호1동","총인구","2023.01 월","16997","43582","20880","22702",
"용호1동","총인구","2023.02 월","17015","43559","20881","22678",
"용호1동","총인구","2023.03 월","17018","43452","20807","22645",
"용호1동","총인구","2023.04 월","17029","43464","20814","22650",
"용호1동","총인구","2023.05 월","17068","43486","20840","22646",
"용호1동","총인구","2023.06 월","17095","43536","20856","22680",
"용호1동","총인구","2023.07 월","17126","43542","20860","22682",
"용호1동","총인구","2023.08 월","17146","43546","20847","22699",
"용호1동","총인구","2023.09 월","17137","43467","20807","22660",
"용호1동","총인구","2023.10 월","17126","43529","20834","22695",
"용호1동","총인구","2023.11 월","17138","43508","20830","22678",
"용호1동","총인구","2023.12 월","17146","43500","20813","22687",
"용호1동","총인구","2024.01 월","17154","43414","20768","22646",
"용호1동","총인구","2024.02 월","17159","43245","20712","22533",
"용호1동","총인구","2024.03 월","17164","43185","20672","22513",
"용호1동","총인구","2024.04 월","17173","43081","20605","22476",
"용호1동","총인구","2024.05 월","17164","43007","20557","22450",
"용호1동","총인구","2024.06 월","17171","42970","20559","22411",
"용호1동","총인구","2024.07 월","17164","42907","20536","22371",
"용호1동","총인구","2024.08 월","17168","42851","20487","22364",
"용호1동","총인구","2024.09 월","17183","42965","20558","22407",
"용호1동","총인구","2024.10 월","17224","43037","20614","22423",
"용호1동","총인구","2024.11 월","17239","43047","20630","22417",
"용호1동","총인구","2024.12 월","17247","43069","20642","22427",
"용호2동","총인구","2020.01 월","6847","18023","8865","9158",
"용호2동","총인구","2020.02 월","6840","17960","8832","9128",
"용호2동","총인구","2020.03 월","6818","17911","8814","9097",
"용호2동","총인구","2020.04 월","6819","17855","8796","9059",
"용호2동","총인구","2020.05 월","6822","17860","8782","9078",
"용호2동","총인구","2020.06 월","6821","17809","8763","9046",
"용호2동","총인구","2020.07 월","6819","17797","8756","9041",
"용호2동","총인구","2020.08 월","6800","17718","8706","9012",
"용호2동","총인구","2020.09 월","6800","17700","8687","9013",
"용호2동","총인구","2020.10 월","6783","17627","8666","8961",
"용호2동","총인구","2020.11 월","6788","17605","8661","8944",
"용호2동","총인구","2020.12 월","6777","17487","8610","8877",
"용호2동","총인구","2021.01 월","6794","17474","8601","8873",
"용호2동","총인구","2021.02 월","6790","17420","8562","8858",
"용호2동","총인구","2021.03 월","6672","17238","8473","8765",
"용호2동","총인구","2021.04 월","6679","17200","8458","8742",
"용호2동","총인구","2021.05 월","6685","17160","8441","8719",
"용호2동","총인구","2021.06 월","6679","17119","8404","8715",
"용호2동","총인구","2021.07 월","6672","17099","8388","8711",
"용호2동","총인구","2021.08 월","6668","17058","8354","8704",
"용호2동","총인구","2021.09 월","6681","17047","8339","8708",
"용호2동","총인구","2021.10 월","6697","17079","8354","8725",
"용호2동","총인구","2021.11 월","6695","17066","8349","8717",
"용호2동","총인구","2021.12 월","6684","17029","8325","8704",
"용호2동","총인구","2022.01 월","6660","16959","8279","8680",
"용호2동","총인구","2022.02 월","6635","16886","8255","8631",
"용호2동","총인구","2022.03 월","6624","16839","8235","8604",
"용호2동","총인구","2022.04 월","6618","16778","8195","8583",
"용호2동","총인구","2022.05 월","6616","16743","8168","8575",
"용호2동","총인구","2022.06 월","6610","16713","8144","8569",
"용호2동","총인구","2022.07 월","6593","16687","8132","8555",
"용호2동","총인구","2022.08 월","6578","16626","8090","8536",
"용호2동","총인구","2022.09 월","6559","16576","8059","8517",
"용호2동","총인구","2022.10 월","6563","16534","8038","8496",
"용호2동","총인구","2022.11 월","6578","16529","8041","8488",
"용호2동","총인구","2022.12 월","6705","16771","8177","8594",
"용호2동","총인구","2023.01 월","7180","17776","8657","9119",
"용호2동","총인구","2023.02 월","7556","18565","9021","9544",
"용호2동","총인구","2023.03 월","7759","18942","9193","9749",
"용호2동","총인구","2023.04 월","7882","19190","9302","9888",
"용호2동","총인구","2023.05 월","7960","19361","9381","9980",
"용호2동","총인구","2023.06 월","8042","19521","9445","10076",
"용호2동","총인구","2023.07 월","8069","19602","9488","10114",
"용호2동","총인구","2023.08 월","8083","19677","9529","10148",
"용호2동","총인구","2023.09 월","8110","19719","9546","10173",
"용호2동","총인구","2023.10 월","8121","19711","9540","10171",
"용호2동","총인구","2023.11 월","8138","19723","9538","10185",
"용호2동","총인구","2023.12 월","8149","19740","9550","10190",
"용호2동","총인구","2024.01 월","8154","19744","9547","10197",
"용호2동","총인구","2024.02 월","8158","19713","9524","10189",
"용호2동","총인구","2024.03 월","8150","19678","9508","10170",
"용호2동","총인구","2024.04 월","8147","19687","9511","10176",
"용호2동","총인구","2024.05 월","8139","19754","9530","10224",
"용호2동","총인구","2024.06 월","8139","19736","9524","10212",
"용호2동","총인구","2024.07 월","8136","19705","9515","10190",
"용호2동","총인구","2024.08 월","8137","19700","9505","10195",
"용호2동","총인구","2024.09 월","8146","19703","9496","10207",
"용호2동","총인구","2024.10 월","8139","19694","9491","10203",
"용호2동","총인구","2024.11 월","8137","19698","9501","10197",
"용호2동","총인구","2024.12 월","8144","19698","9486","10212",
"용호3동","총인구","2020.01 월","5669","12908","6262","6646",
"용호3동","총인구","2020.02 월","5678","12908","6254","6654",
"용호3동","총인구","2020.03 월","5679","12869","6241","6628",
"용호3동","총인구","2020.04 월","5660","12827","6222","6605",
"용호3동","총인구","2020.05 월","5683","12805","6207","6598",
"용호3동","총인구","2020.06 월","5707","12797","6201","6596",
"용호3동","총인구","2020.07 월","5714","12766","6177","6589",
"용호3동","총인구","2020.08 월","5711","12744","6169","6575",
"용호3동","총인구","2020.09 월","5707","12733","6149","6584",
"용호3동","총인구","2020.10 월","5702","12685","6135","6550",
"용호3동","총인구","2020.11 월","5718","12661","6122","6539",
"용호3동","총인구","2020.12 월","5732","12676","6128","6548",
"용호3동","총인구","2021.01 월","5727","12620","6105","6515",
"용호3동","총인구","2021.02 월","5719","12584","6078","6506",
"용호3동","총인구","2021.03 월","5705","12544","6063","6481",
"용호3동","총인구","2021.04 월","5699","12468","6031","6437",
"용호3동","총인구","2021.05 월","5691","12419","6019","6400",
"용호3동","총인구","2021.06 월","5686","12393","5998","6395",
"용호3동","총인구","2021.07 월","5698","12420","6009","6411",
"용호3동","총인구","2021.08 월","5689","12372","5972","6400",
"용호3동","총인구","2021.09 월","5691","12334","5954","6380",
"용호3동","총인구","2021.10 월","5693","12341","5949","6392",
"용호3동","총인구","2021.11 월","5698","12319","5950","6369",
"용호3동","총인구","2021.12 월","5695","12296","5940","6356",
"용호3동","총인구","2022.01 월","5684","12251","5913","6338",
"용호3동","총인구","2022.02 월","5700","12237","5905","6332",
"용호3동","총인구","2022.03 월","5701","12218","5899","6319",
"용호3동","총인구","2022.04 월","5697","12191","5894","6297",
"용호3동","총인구","2022.05 월","5694","12122","5855","6267",
"용호3동","총인구","2022.06 월","5696","12107","5832","6275",
"용호3동","총인구","2022.07 월","5702","12098","5830","6268",
"용호3동","총인구","2022.08 월","5699","12055","5807","6248",
"용호3동","총인구","2022.09 월","5675","12003","5778","6225",
"용호3동","총인구","2022.10 월","5665","11971","5762","6209",
"용호3동","총인구","2022.11 월","5658","11948","5760","6188",
"용호3동","총인구","2022.12 월","5651","11911","5742","6169",
"용호3동","총인구","2023.01 월","5602","11734","5655","6079",
"용호3동","총인구","2023.02 월","5567","11619","5602","6017",
"용호3동","총인구","2023.03 월","5558","11576","5591","5985",
"용호3동","총인구","2023.04 월","5553","11544","5576","5968",
"용호3동","총인구","2023.05 월","5553","11520","5556","5964",
"용호3동","총인구","2023.06 월","5583","11561","5582","5979",
"용호3동","총인구","2023.07 월","5587","11566","5589","5977",
"용호3동","총인구","2023.08 월","5592","11520","5551","5969",
"용호3동","총인구","2023.09 월","5595","11499","5541","5958",
"용호3동","총인구","2023.10 월","5569","11462","5523","5939",
"용호3동","총인구","2023.11 월","5557","11415","5488","5927",
"용호3동","총인구","2023.12 월","5539","11359","5456","5903",
"용호3동","총인구","2024.01 월","5529","11310","5425","5885",
"용호3동","총인구","2024.02 월","5541","11319","5437","5882",
"용호3동","총인구","2024.03 월","5534","11285","5420","5865",
"용호3동","총인구","2024.04 월","5535","11262","5405","5857",
"용호3동","총인구","2024.05 월","5524","11205","5385","5820",
"용호3동","총인구","2024.06 월","5518","11166","5364","5802",
"용호3동","총인구","2024.07 월","5493","11112","5336","5776",
"용호3동","총인구","2024.08 월","5446","11013","5288","5725",
"용호3동","총인구","2024.09 월","5365","10852","5214","5638",
"용호3동","총인구","2024.10 월","5264","10648","5110","5538",
"용호3동","총인구","2024.11 월","5204","10525","5042","5483",
"용호3동","총인구","2024.12 월","5153","10398","4980","5418",
"용호4동","총인구","2020.01 월","3810","9024","4361","4663",
"용호4동","총인구","2020.02 월","3799","8968","4328","4640",
"용호4동","총인구","2020.03 월","3811","8975","4333","4642",
"용호4동","총인구","2020.04 월","3822","8981","4332","4649",
"용호4동","총인구","2020.05 월","3834","8999","4341","4658",
"용호4동","총인구","2020.06 월","3841","9001","4336","4665",
"용호4동","총인구","2020.07 월","3847","8968","4321","4647",
"용호4동","총인구","2020.08 월","3835","8928","4298","4630",
"용호4동","총인구","2020.09 월","3841","8919","4302","4617",
"용호4동","총인구","2020.10 월","3843","8898","4286","4612",
"용호4동","총인구","2020.11 월","3834","8858","4264","4594",
"용호4동","총인구","2020.12 월","3834","8831","4257","4574",
"용호4동","총인구","2021.01 월","3825","8776","4232","4544",
"용호4동","총인구","2021.02 월","3840","8785","4242","4543",
"용호4동","총인구","2021.03 월","3821","8733","4207","4526",
"용호4동","총인구","2021.04 월","3824","8724","4208","4516",
"용호4동","총인구","2021.05 월","3833","8710","4195","4515",
"용호4동","총인구","2021.06 월","3813","8651","4173","4478",
"용호4동","총인구","2021.07 월","3827","8667","4175","4492",
"용호4동","총인구","2021.08 월","3835","8651","4162","4489",
"용호4동","총인구","2021.09 월","3848","8648","4148","4500",
"용호4동","총인구","2021.10 월","3854","8625","4138","4487",
"용호4동","총인구","2021.11 월","3853","8618","4136","4482",
"용호4동","총인구","2021.12 월","3849","8612","4134","4478",
"용호4동","총인구","2022.01 월","3843","8594","4131","4463",
"용호4동","총인구","2022.02 월","3838","8559","4117","4442",
"용호4동","총인구","2022.03 월","3834","8531","4096","4435",
"용호4동","총인구","2022.04 월","3851","8536","4101","4435",
"용호4동","총인구","2022.05 월","3859","8527","4102","4425",
"용호4동","총인구","2022.06 월","3863","8513","4099","4414",
"용호4동","총인구","2022.07 월","3862","8494","4098","4396",
"용호4동","총인구","2022.08 월","3854","8481","4085","4396",
"용호4동","총인구","2022.09 월","3838","8440","4069","4371",
"용호4동","총인구","2022.10 월","3835","8439","4066","4373",
"용호4동","총인구","2022.11 월","3826","8412","4048","4364",
"용호4동","총인구","2022.12 월","3808","8354","4017","4337",
"용호4동","총인구","2023.01 월","3759","8193","3919","4274",
"용호4동","총인구","2023.02 월","3734","8086","3877","4209",
"용호4동","총인구","2023.03 월","3725","8046","3846","4200",
"용호4동","총인구","2023.04 월","3709","7977","3817","4160",
"용호4동","총인구","2023.05 월","3694","7941","3792","4149",
"용호4동","총인구","2023.06 월","3686","7919","3780","4139",
"용호4동","총인구","2023.07 월","3680","7902","3766","4136",
"용호4동","총인구","2023.08 월","3677","7891","3761","4130",
"용호4동","총인구","2023.09 월","3678","7883","3749","4134",
"용호4동","총인구","2023.10 월","3672","7859","3736","4123",
"용호4동","총인구","2023.11 월","3677","7840","3740","4100",
"용호4동","총인구","2023.12 월","3677","7827","3738","4089",
"용호4동","총인구","2024.01 월","3683","7826","3733","4093",
"용호4동","총인구","2024.02 월","3677","7803","3722","4081",
"용호4동","총인구","2024.03 월","3668","7793","3716","4077",
"용호4동","총인구","2024.04 월","3663","7768","3702","4066",
"용호4동","총인구","2024.05 월","3660","7752","3690","4062",
"용호4동","총인구","2024.06 월","3666","7756","3694","4062",
"용호4동","총인구","2024.07 월","3672","7770","3699","4071",
"용호4동","총인구","2024.08 월","3673","7766","3704","4062",
"용호4동","총인구","2024.09 월","3675","7730","3684","4046",
"용호4동","총인구","2024.10 월","3683","7740","3695","4045",
"용호4동","총인구","2024.11 월","3685","7729","3687","4042",
"용호4동","총인구","2024.12 월","3686","7733","3688","4045",
"용당동","총인구","2020.01 월","3337","8408","4265","4143",
"용당동","총인구","2020.02 월","3328","8360","4247","4113",
"용당동","총인구","2020.03 월","3327","8318","4229","4089",
"용당동","총인구","2020.04 월","3332","8329","4238","4091",
"용당동","총인구","2020.05 월","3335","8312","4232","4080",
"용당동","총인구","2020.06 월","3327","8271","4208","4063",
"용당동","총인구","2020.07 월","3349","8284","4222","4062",
"용당동","총인구","2020.08 월","3348","8256","4203","4053",
"용당동","총인구","2020.09 월","3358","8265","4205","4060",
"용당동","총인구","2020.10 월","3365","8273","4209","4064",
"용당동","총인구","2020.11 월","3381","8281","4216","4065",
"용당동","총인구","2020.12 월","3416","8338","4250","4088",
"용당동","총인구","2021.01 월","3458","8411","4289","4122",
"용당동","총인구","2021.02 월","3479","8450","4301","4149",
"용당동","총인구","2021.03 월","3444","8420","4277","4143",
"용당동","총인구","2021.04 월","3458","8466","4302","4164",
"용당동","총인구","2021.05 월","3459","8452","4293","4159",
"용당동","총인구","2021.06 월","3464","8441","4289","4152",
"용당동","총인구","2021.07 월","3481","8437","4290","4147",
"용당동","총인구","2021.08 월","3487","8455","4293","4162",
"용당동","총인구","2021.09 월","3502","8475","4302","4173",
"용당동","총인구","2021.10 월","3505","8474","4291","4183",
"용당동","총인구","2021.11 월","3499","8451","4271","4180",
"용당동","총인구","2021.12 월","3489","8425","4246","4179",
"용당동","총인구","2022.01 월","3483","8387","4217","4170",
"용당동","총인구","2022.02 월","3480","8348","4196","4152",
"용당동","총인구","2022.03 월","3476","8350","4202","4148",
"용당동","총인구","2022.04 월","3481","8391","4224","4167",
"용당동","총인구","2022.05 월","3485","8365","4214","4151",
"용당동","총인구","2022.06 월","3484","8351","4210","4141",
"용당동","총인구","2022.07 월","3478","8344","4206","4138",
"용당동","총인구","2022.08 월","3491","8326","4199","4127",
"용당동","총인구","2022.09 월","3495","8317","4195","4122",
"용당동","총인구","2022.10 월","3484","8289","4184","4105",
"용당동","총인구","2022.11 월","3468","8271","4178","4093",
"용당동","총인구","2022.12 월","3471","8261","4173","4088",
"용당동","총인구","2023.01 월","3469","8219","4168","4051",
"용당동","총인구","2023.02 월","3462","8202","4147","4055",
"용당동","총인구","2023.03 월","3459","8153","4137","4016",
"용당동","총인구","2023.04 월","3471","8199","4154","4045",
"용당동","총인구","2023.05 월","3488","8200","4153","4047",
"용당동","총인구","2023.06 월","3484","8164","4129","4035",
"용당동","총인구","2023.07 월","3494","8151","4123","4028",
"용당동","총인구","2023.08 월","3499","8126","4111","4015",
"용당동","총인구","2023.09 월","3501","8121","4106","4015",
"용당동","총인구","2023.10 월","3487","8094","4105","3989",
"용당동","총인구","2023.11 월","3490","8084","4096","3988",
"용당동","총인구","2023.12 월","3485","8068","4089","3979",
"용당동","총인구","2024.01 월","3468","8025","4062","3963",
"용당동","총인구","2024.02 월","3467","8008","4051","3957",
"용당동","총인구","2024.03 월","3469","8010","4037","3973",
"용당동","총인구","2024.04 월","3464","8006","4028","3978",
"용당동","총인구","2024.05 월","3458","7990","4018","3972",
"용당동","총인구","2024.06 월","3451","7953","4002","3951",
"용당동","총인구","2024.07 월","3452","7939","3997","3942",
"용당동","총인구","2024.08 월","3458","7908","3987","3921",
"용당동","총인구","2024.09 월","3462","7918","3992","3926",
"용당동","총인구","2024.10 월","3461","7911","3992","3919",
"용당동","총인구","2024.11 월","3464","7905","3989","3916",
"용당동","총인구","2024.12 월","3472","7893","3981","3912",
"감만1동","총인구","2020.01 월","6532","14765","7517","7248",
"감만1동","총인구","2020.02 월","6515","14649","7465","7184",
"감만1동","총인구","2020.03 월","6520","14604","7441","7163",
"감만1동","총인구","2020.04 월","6504","14583","7425","7158",
"감만1동","총인구","2020.05 월","6501","14527","7399","7128",
"감만1동","총인구","2020.06 월","6490","14459","7376","7083",
"감만1동","총인구","2020.07 월","6492","14442","7359","7083",
"감만1동","총인구","2020.08 월","6470","14352","7325","7027",
"감만1동","총인구","2020.09 월","6444","14255","7281","6974",
"감만1동","총인구","2020.10 월","6418","14145","7223","6922",
"감만1동","총인구","2020.11 월","6404","14064","7189","6875",
"감만1동","총인구","2020.12 월","6383","13989","7142","6847",
"감만1동","총인구","2021.01 월","6357","13916","7098","6818",
"감만1동","총인구","2021.02 월","6342","13826","7052","6774",
"감만1동","총인구","2021.03 월","6290","13695","6982","6713",
"감만1동","총인구","2021.04 월","6268","13600","6937","6663",
"감만1동","총인구","2021.05 월","6251","13519","6900","6619",
"감만1동","총인구","2021.06 월","6238","13463","6863","6600",
"감만1동","총인구","2021.07 월","6210","13369","6812","6557",
"감만1동","총인구","2021.08 월","6202","13298","6778","6520",
"감만1동","총인구","2021.09 월","6193","13259","6761","6498",
"감만1동","총인구","2021.10 월","6191","13225","6747","6478",
"감만1동","총인구","2021.11 월","6157","13135","6711","6424",
"감만1동","총인구","2021.12 월","6148","13087","6682","6405",
"감만1동","총인구","2022.01 월","6145","13021","6653","6368",
"감만1동","총인구","2022.02 월","6120","12950","6613","6337",
"감만1동","총인구","2022.03 월","6108","12874","6576","6298",
"감만1동","총인구","2022.04 월","6091","12830","6550","6280",
"감만1동","총인구","2022.05 월","6024","12693","6471","6222",
"감만1동","총인구","2022.06 월","5901","12445","6344","6101",
"감만1동","총인구","2022.07 월","5755","12110","6181","5929",
"감만1동","총인구","2022.08 월","5564","11731","5985","5746",
"감만1동","총인구","2022.09 월","5347","11348","5804","5544",
"감만1동","총인구","2022.10 월","5206","11090","5676","5414",
"감만1동","총인구","2022.11 월","5106","10896","5583","5313",
"감만1동","총인구","2022.12 월","4977","10670","5455","5215",
"감만1동","총인구","2023.01 월","4887","10506","5373","5133",
"감만1동","총인구","2023.02 월","4791","10272","5250","5022",
"감만1동","총인구","2023.03 월","4684","10061","5141","4920",
"감만1동","총인구","2023.04 월","4598","9908","5056","4852",
"감만1동","총인구","2023.05 월","4549","9830","5007","4823",
"감만1동","총인구","2023.06 월","4493","9705","4951","4754",
"감만1동","총인구","2023.07 월","4449","9604","4906","4698",
"감만1동","총인구","2023.08 월","4371","9456","4831","4625",
"감만1동","총인구","2023.09 월","4301","9346","4782","4564",
"감만1동","총인구","2023.10 월","4190","9130","4668","4462",
"감만1동","총인구","2023.11 월","4100","8951","4578","4373",
"감만1동","총인구","2023.12 월","4016","8770","4476","4294",
"감만1동","총인구","2024.01 월","3959","8640","4409","4231",
"감만1동","총인구","2024.02 월","3896","8527","4358","4169",
"감만1동","총인구","2024.03 월","3846","8414","4298","4116",
"감만1동","총인구","2024.04 월","3793","8308","4248","4060",
"감만1동","총인구","2024.05 월","3763","8256","4224","4032",
"감만1동","총인구","2024.06 월","3738","8210","4201","4009",
"감만1동","총인구","2024.07 월","3717","8158","4174","3984",
"감만1동","총인구","2024.08 월","3696","8102","4145","3957",
"감만1동","총인구","2024.09 월","3686","8098","4146","3952",
"감만1동","총인구","2024.10 월","3661","8043","4123","3920",
"감만1동","총인구","2024.11 월","3641","8004","4103","3901",
"감만1동","총인구","2024.12 월","3638","7990","4098","3892",
"감만2동","총인구","2020.01 월","3339","7366","3661","3705",
"감만2동","총인구","2020.02 월","3338","7360","3658","3702",
"감만2동","총인구","2020.03 월","3332","7331","3644","3687",
"감만2동","총인구","2020.04 월","3335","7309","3633","3676",
"감만2동","총인구","2020.05 월","3335","7283","3616","3667",
"감만2동","총인구","2020.06 월","3340","7264","3597","3667",
"감만2동","총인구","2020.07 월","3342","7237","3576","3661",
"감만2동","총인구","2020.08 월","3335","7192","3558","3634",
"감만2동","총인구","2020.09 월","3334","7162","3537","3625",
"감만2동","총인구","2020.10 월","3346","7151","3529","3622",
"감만2동","총인구","2020.11 월","3342","7109","3501","3608",
"감만2동","총인구","2020.12 월","3349","7071","3478","3593",
"감만2동","총인구","2021.01 월","3340","7024","3457","3567",
"감만2동","총인구","2021.02 월","3328","6986","3434","3552",
"감만2동","총인구","2021.03 월","3309","6948","3420","3528",
"감만2동","총인구","2021.04 월","3305","6918","3402","3516",
"감만2동","총인구","2021.05 월","3301","6873","3371","3502",
"감만2동","총인구","2021.06 월","3306","6858","3360","3498",
"감만2동","총인구","2021.07 월","3307","6830","3350","3480",
"감만2동","총인구","2021.08 월","3312","6838","3362","3476",
"감만2동","총인구","2021.09 월","3304","6813","3340","3473",
"감만2동","총인구","2021.10 월","3306","6813","3339","3474",
"감만2동","총인구","2021.11 월","3299","6798","3325","3473",
"감만2동","총인구","2021.12 월","3301","6791","3321","3470",
"감만2동","총인구","2022.01 월","3291","6755","3300","3455",
"감만2동","총인구","2022.02 월","3290","6742","3298","3444",
"감만2동","총인구","2022.03 월","3297","6735","3291","3444",
"감만2동","총인구","2022.04 월","3297","6710","3284","3426",
"감만2동","총인구","2022.05 월","3301","6715","3281","3434",
"감만2동","총인구","2022.06 월","3300","6713","3284","3429",
"감만2동","총인구","2022.07 월","3312","6727","3289","3438",
"감만2동","총인구","2022.08 월","3332","6753","3302","3451",
"감만2동","총인구","2022.09 월","3338","6759","3296","3463",
"감만2동","총인구","2022.10 월","3350","6762","3300","3462",
"감만2동","총인구","2022.11 월","3350","6754","3294","3460",
"감만2동","총인구","2022.12 월","3344","6748","3296","3452",
"감만2동","총인구","2023.01 월","3340","6727","3283","3444",
"감만2동","총인구","2023.02 월","3355","6718","3285","3433",
"감만2동","총인구","2023.03 월","3347","6709","3275","3434",
"감만2동","총인구","2023.04 월","3347","6697","3266","3431",
"감만2동","총인구","2023.05 월","3338","6648","3248","3400",
"감만2동","총인구","2023.06 월","3332","6628","3244","3384",
"감만2동","총인구","2023.07 월","3327","6620","3243","3377",
"감만2동","총인구","2023.08 월","3330","6629","3241","3388",
"감만2동","총인구","2023.09 월","3324","6622","3243","3379",
"감만2동","총인구","2023.10 월","3327","6592","3224","3368",
"감만2동","총인구","2023.11 월","3328","6574","3219","3355",
"감만2동","총인구","2023.12 월","3330","6577","3219","3358",
"감만2동","총인구","2024.01 월","3322","6548","3206","3342",
"감만2동","총인구","2024.02 월","3315","6521","3187","3334",
"감만2동","총인구","2024.03 월","3318","6505","3183","3322",
"감만2동","총인구","2024.04 월","3320","6512","3187","3325",
"감만2동","총인구","2024.05 월","3308","6477","3170","3307",
"감만2동","총인구","2024.06 월","3302","6463","3168","3295",
"감만2동","총인구","2024.07 월","3298","6435","3154","3281",
"감만2동","총인구","2024.08 월","3286","6405","3131","3274",
"감만2동","총인구","2024.09 월","3281","6385","3113","3272",
"감만2동","총인구","2024.10 월","3280","6376","3110","3266",
"감만2동","총인구","2024.11 월","3270","6346","3096","3250",
"감만2동","총인구","2024.12 월","3262","6315","3079","3236",
"우암동","총인구","2020.01 월","6004","13860","6907","6953",
"우암동","총인구","2020.02 월","5987","13830","6883","6947",
"우암동","총인구","2020.03 월","5974","13823","6867","6956",
"우암동","총인구","2020.04 월","5958","13789","6856","6933",
"우암동","총인구","2020.05 월","5956","13745","6816","6929",
"우암동","총인구","2020.06 월","5955","13710","6789","6921",
"우암동","총인구","2020.07 월","5952","13670","6761","6909",
"우암동","총인구","2020.08 월","5935","13605","6724","6881",
"우암동","총인구","2020.09 월","5927","13563","6700","6863",
"우암동","총인구","2020.10 월","5902","13465","6655","6810",
"우암동","총인구","2020.11 월","5882","13398","6621","6777",
"우암동","총인구","2020.12 월","5863","13327","6583","6744",
"우암동","총인구","2021.01 월","5861","13316","6576","6740",
"우암동","총인구","2021.02 월","5864","13278","6546","6732",
"우암동","총인구","2021.03 월","5759","13152","6506","6646",
"우암동","총인구","2021.04 월","5752","13096","6468","6628",
"우암동","총인구","2021.05 월","5754","13086","6466","6620",
"우암동","총인구","2021.06 월","5760","13037","6436","6601",
"우암동","총인구","2021.07 월","5768","13039","6442","6597",
"우암동","총인구","2021.08 월","5766","13003","6426","6577",
"우암동","총인구","2021.09 월","5755","12948","6392","6556",
"우암동","총인구","2021.10 월","5758","12935","6378","6557",
"우암동","총인구","2021.11 월","5760","12907","6356","6551",
"우암동","총인구","2021.12 월","5765","12863","6333","6530",
"우암동","총인구","2022.01 월","5752","12829","6314","6515",
"우암동","총인구","2022.02 월","5754","12794","6295","6499",
"우암동","총인구","2022.03 월","5750","12775","6290","6485",
"우암동","총인구","2022.04 월","5747","12753","6283","6470",
"우암동","총인구","2022.05 월","5733","12693","6251","6442",
"우암동","총인구","2022.06 월","5726","12667","6237","6430",
"우암동","총인구","2022.07 월","5777","12758","6276","6482",
"우암동","총인구","2022.08 월","5812","12787","6283","6504",
"우암동","총인구","2022.09 월","5822","12808","6288","6520",
"우암동","총인구","2022.10 월","5840","12813","6280","6533",
"우암동","총인구","2022.11 월","5832","12774","6258","6516",
"우암동","총인구","2022.12 월","5823","12728","6234","6494",
"우암동","총인구","2023.01 월","5807","12684","6207","6477",
"우암동","총인구","2023.02 월","5798","12646","6186","6460",
"우암동","총인구","2023.03 월","5807","12638","6179","6459",
"우암동","총인구","2023.04 월","5812","12624","6174","6450",
"우암동","총인구","2023.05 월","5811","12601","6162","6439",
"우암동","총인구","2023.06 월","5804","12571","6152","6419",
"우암동","총인구","2023.07 월","5806","12540","6130","6410",
"우암동","총인구","2023.08 월","5796","12511","6115","6396",
"우암동","총인구","2023.09 월","5789","12468","6093","6375",
"우암동","총인구","2023.10 월","5751","12398","6057","6341",
"우암동","총인구","2023.11 월","5736","12367","6037","6330",
"우암동","총인구","2023.12 월","5730","12334","6020","6314",
"우암동","총인구","2024.01 월","5711","12302","6000","6302",
"우암동","총인구","2024.02 월","5702","12246","5971","6275",
"우암동","총인구","2024.03 월","5701","12247","5974","6273",
"우암동","총인구","2024.04 월","5680","12200","5951","6249",
"우암동","총인구","2024.05 월","5669","12165","5932","6233",
"우암동","총인구","2024.06 월","5670","12169","5928","6241",
"우암동","총인구","2024.07 월","5658","12148","5915","6233",
"우암동","총인구","2024.08 월","5649","12108","5893","6215",
"우암동","총인구","2024.09 월","5634","12064","5866","6198",
"우암동","총인구","2024.10 월","5617","12029","5846","6183",
"우암동","총인구","2024.11 월","5601","12004","5839","6165",
"우암동","총인구","2024.12 월","5607","12004","5837","6167",
"문현1동","총인구","2020.01 월","6112","14932","7293","7639",
"문현1동","총인구","2020.02 월","6102","14902","7280","7622",
"문현1동","총인구","2020.03 월","6091","14855","7246","7609",
"문현1동","총인구","2020.04 월","6069","14795","7211","7584",
"문현1동","총인구","2020.05 월","6061","14724","7175","7549",
"문현1동","총인구","2020.06 월","6039","14647","7135","7512",
"문현1동","총인구","2020.07 월","6034","14586","7112","7474",
"문현1동","총인구","2020.08 월","5996","14427","7031","7396",
"문현1동","총인구","2020.09 월","5979","14345","6988","7357",
"문현1동","총인구","2020.10 월","5979","14273","6945","7328",
"문현1동","총인구","2020.11 월","5973","14182","6907","7275",
"문현1동","총인구","2020.12 월","5958","14114","6876","7238",
"문현1동","총인구","2021.01 월","5955","14078","6866","7212",
"문현1동","총인구","2021.02 월","5950","14049","6852","7197",
"문현1동","총인구","2021.03 월","5886","13931","6786","7145",
"문현1동","총인구","2021.04 월","5888","13910","6770","7140",
"문현1동","총인구","2021.05 월","5898","13898","6763","7135",
"문현1동","총인구","2021.06 월","5896","13872","6745","7127",
"문현1동","총인구","2021.07 월","5900","13841","6727","7114",
"문현1동","총인구","2021.08 월","5892","13792","6699","7093",
"문현1동","총인구","2021.09 월","5892","13779","6686","7093",
"문현1동","총인구","2021.10 월","5901","13764","6688","7076",
"문현1동","총인구","2021.11 월","5888","13707","6669","7038",
"문현1동","총인구","2021.12 월","5884","13624","6623","7001",
"문현1동","총인구","2022.01 월","5863","13541","6592","6949",
"문현1동","총인구","2022.02 월","5857","13478","6559","6919",
"문현1동","총인구","2022.03 월","5862","13455","6547","6908",
"문현1동","총인구","2022.04 월","5851","13421","6530","6891",
"문현1동","총인구","2022.05 월","5834","13364","6510","6854",
"문현1동","총인구","2022.06 월","5823","13323","6490","6833",
"문현1동","총인구","2022.07 월","5824","13304","6488","6816",
"문현1동","총인구","2022.08 월","5813","13256","6467","6789",
"문현1동","총인구","2022.09 월","5777","13154","6415","6739",
"문현1동","총인구","2022.10 월","5726","13066","6370","6696",
"문현1동","총인구","2022.11 월","5528","12670","6192","6478",
"문현1동","총인구","2022.12 월","5335","12229","5986","6243",
"문현1동","총인구","2023.01 월","5198","11922","5833","6089",
"문현1동","총인구","2023.02 월","5074","11665","5706","5959",
"문현1동","총인구","2023.03 월","5022","11550","5651","5899",
"문현1동","총인구","2023.04 월","4991","11480","5620","5860",
"문현1동","총인구","2023.05 월","4944","11379","5562","5817",
"문현1동","총인구","2023.06 월","4909","11291","5524","5767",
"문현1동","총인구","2023.07 월","4893","11241","5502","5739",
"문현1동","총인구","2023.08 월","4876","11202","5485","5717",
"문현1동","총인구","2023.09 월","4863","11169","5477","5692",
"문현1동","총인구","2023.10 월","4857","11141","5470","5671",
"문현1동","총인구","2023.11 월","4856","11108","5456","5652",
"문현1동","총인구","2023.12 월","4835","11045","5421","5624",
"문현1동","총인구","2024.01 월","4814","10998","5393","5605",
"문현1동","총인구","2024.02 월","4797","10941","5360","5581",
"문현1동","총인구","2024.03 월","4777","10904","5337","5567",
"문현1동","총인구","2024.04 월","4768","10874","5319","5555",
"문현1동","총인구","2024.05 월","4762","10844","5303","5541",
"문현1동","총인구","2024.06 월","4754","10807","5281","5526",
"문현1동","총인구","2024.07 월","4748","10798","5276","5522",
"문현1동","총인구","2024.08 월","4737","10770","5261","5509",
"문현1동","총인구","2024.09 월","4714","10716","5228","5488",
"문현1동","총인구","2024.10 월","4708","10677","5204","5473",
"문현1동","총인구","2024.11 월","4703","10666","5203","5463",
"문현1동","총인구","2024.12 월","4698","10647","5196","5451",
"문현2동","총인구","2020.01 월","5084","9181","4588","4593",
"문현2동","총인구","2020.02 월","5087","9138","4557","4581",
"문현2동","총인구","2020.03 월","5080","9091","4531","4560",
"문현2동","총인구","2020.04 월","5079","9079","4534","4545",
"문현2동","총인구","2020.05 월","5104","9079","4527","4552",
"문현2동","총인구","2020.06 월","5126","9070","4526","4544",
"문현2동","총인구","2020.07 월","5152","9089","4540","4549",
"문현2동","총인구","2020.08 월","5153","9038","4516","4522",
"문현2동","총인구","2020.09 월","5126","9000","4497","4503",
"문현2동","총인구","2020.10 월","5130","8997","4498","4499",
"문현2동","총인구","2020.11 월","5128","8949","4470","4479",
"문현2동","총인구","2020.12 월","5138","8909","4436","4473",
"문현2동","총인구","2021.01 월","5133","8870","4404","4466",
"문현2동","총인구","2021.02 월","5154","8880","4397","4483",
"문현2동","총인구","2021.03 월","5037","8731","4320","4411",
"문현2동","총인구","2021.04 월","5024","8710","4307","4403",
"문현2동","총인구","2021.05 월","5050","8722","4315","4407",
"문현2동","총인구","2021.06 월","5056","8728","4325","4403",
"문현2동","총인구","2021.07 월","5044","8691","4293","4398",
"문현2동","총인구","2021.08 월","5044","8667","4271","4396",
"문현2동","총인구","2021.09 월","5049","8671","4274","4397",
"문현2동","총인구","2021.10 월","5076","8710","4290","4420",
"문현2동","총인구","2021.11 월","5061","8669","4267","4402",
"문현2동","총인구","2021.12 월","5046","8635","4242","4393",
"문현2동","총인구","2022.01 월","5041","8608","4233","4375",
"문현2동","총인구","2022.02 월","5039","8565","4219","4346",
"문현2동","총인구","2022.03 월","5041","8530","4207","4323",
"문현2동","총인구","2022.04 월","5040","8507","4188","4319",
"문현2동","총인구","2022.05 월","5097","8548","4215","4333",
"문현2동","총인구","2022.06 월","5093","8524","4206","4318",
"문현2동","총인구","2022.07 월","5099","8498","4202","4296",
"문현2동","총인구","2022.08 월","5127","8495","4199","4296",
"문현2동","총인구","2022.09 월","5098","8448","4181","4267",
"문현2동","총인구","2022.10 월","5062","8392","4158","4234",
"문현2동","총인구","2022.11 월","5032","8330","4125","4205",
"문현2동","총인구","2022.12 월","5012","8285","4111","4174",
"문현2동","총인구","2023.01 월","4997","8270","4111","4159",
"문현2동","총인구","2023.02 월","4956","8194","4072","4122",
"문현2동","총인구","2023.03 월","4948","8172","4060","4112",
"문현2동","총인구","2023.04 월","4942","8154","4047","4107",
"문현2동","총인구","2023.05 월","4937","8115","4028","4087",
"문현2동","총인구","2023.06 월","4911","8060","4005","4055",
"문현2동","총인구","2023.07 월","4903","8043","4000","4043",
"문현2동","총인구","2023.08 월","4894","8023","3987","4036",
"문현2동","총인구","2023.09 월","4880","7988","3980","4008",
"문현2동","총인구","2023.10 월","4875","7967","3968","3999",
"문현2동","총인구","2023.11 월","4870","7959","3968","3991",
"문현2동","총인구","2023.12 월","4881","7979","3988","3991",
"문현2동","총인구","2024.01 월","4926","8110","4035","4075",
"문현2동","총인구","2024.02 월","5024","8323","4140","4183",
"문현2동","총인구","2024.03 월","5061","8379","4172","4207",
"문현2동","총인구","2024.04 월","5095","8454","4209","4245",
"문현2동","총인구","2024.05 월","5092","8449","4205","4244",
"문현2동","총인구","2024.06 월","5076","8423","4196","4227",
"문현2동","총인구","2024.07 월","5073","8412","4191","4221",
"문현2동","총인구","2024.08 월","5056","8373","4160","4213",
"문현2동","총인구","2024.09 월","5051","8365","4146","4219",
"문현2동","총인구","2024.10 월","5041","8334","4123","4211",
"문현2동","총인구","2024.11 월","5029","8324","4121","4203",
"문현2동","총인구","2024.12 월","5022","8327","4128","4199",
"문현3동","총인구","2020.01 월","6013","14704","7165","7539",
"문현3동","총인구","2020.02 월","6007","14661","7122","7539",
"문현3동","총인구","2020.03 월","6020","14653","7103","7550",
"문현3동","총인구","2020.04 월","6025","14687","7114","7573",
"문현3동","총인구","2020.05 월","6044","14695","7124","7571",
"문현3동","총인구","2020.06 월","6054","14700","7126","7574",
"문현3동","총인구","2020.07 월","6094","14769","7152","7617",
"문현3동","총인구","2020.08 월","6302","15319","7428","7891",
"문현3동","총인구","2020.09 월","6422","15599","7562","8037",
"문현3동","총인구","2020.10 월","6506","15793","7668","8125",
"문현3동","총인구","2020.11 월","6571","15916","7718","8198",
"문현3동","총인구","2020.12 월","6609","16005","7753","8252",
"문현3동","총인구","2021.01 월","6626","16025","7761","8264",
"문현3동","총인구","2021.02 월","6641","16030","7762","8268",
"문현3동","총인구","2021.03 월","6609","16011","7759","8252",
"문현3동","총인구","2021.04 월","6610","15953","7725","8228",
"문현3동","총인구","2021.05 월","6598","15894","7697","8197",
"문현3동","총인구","2021.06 월","6608","15891","7701","8190",
"문현3동","총인구","2021.07 월","6617","15876","7696","8180",
"문현3동","총인구","2021.08 월","6622","15864","7692","8172",
"문현3동","총인구","2021.09 월","6609","15818","7667","8151",
"문현3동","총인구","2021.10 월","6621","15811","7657","8154",
"문현3동","총인구","2021.11 월","6621","15793","7643","8150",
"문현3동","총인구","2021.12 월","6606","15715","7597","8118",
"문현3동","총인구","2022.01 월","6598","15680","7578","8102",
"문현3동","총인구","2022.02 월","6594","15665","7576","8089",
"문현3동","총인구","2022.03 월","6782","16044","7776","8268",
"문현3동","총인구","2022.04 월","6928","16398","7966","8432",
"문현3동","총인구","2022.05 월","7015","16555","8049","8506",
"문현3동","총인구","2022.06 월","7033","16604","8075","8529",
"문현3동","총인구","2022.07 월","7064","16680","8103","8577",
"문현3동","총인구","2022.08 월","7085","16720","8119","8601",
"문현3동","총인구","2022.09 월","7074","16686","8089","8597",
"문현3동","총인구","2022.10 월","7077","16671","8086","8585",
"문현3동","총인구","2022.11 월","7100","16756","8131","8625",
"문현3동","총인구","2022.12 월","7121","16800","8147","8653",
"문현3동","총인구","2023.01 월","7130","16826","8167","8659",
"문현3동","총인구","2023.02 월","7128","16810","8156","8654",
"문현3동","총인구","2023.03 월","7112","16788","8137","8651",
"문현3동","총인구","2023.04 월","7122","16797","8141","8656",
"문현3동","총인구","2023.05 월","7115","16766","8125","8641",
"문현3동","총인구","2023.06 월","7108","16705","8100","8605",
"문현3동","총인구","2023.07 월","7085","16632","8061","8571",
"문현3동","총인구","2023.08 월","7074","16596","8038","8558",
"문현3동","총인구","2023.09 월","7064","16559","8019","8540",
"문현3동","총인구","2023.10 월","7056","16543","8013","8530",
"문현3동","총인구","2023.11 월","7055","16515","7999","8516",
"문현3동","총인구","2023.12 월","7053","16496","7995","8501",
"문현3동","총인구","2024.01 월","7045","16470","7984","8486",
"문현3동","총인구","2024.02 월","7038","16425","7960","8465",
"문현3동","총인구","2024.03 월","7037","16393","7942","8451",
"문현3동","총인구","2024.04 월","7024","16341","7936","8405",
"문현3동","총인구","2024.05 월","7030","16352","7948","8404",
"문현3동","총인구","2024.06 월","7020","16331","7940","8391",
"문현3동","총인구","2024.07 월","7027","16308","7915","8393",
"문현3동","총인구","2024.08 월","7013","16287","7895","8392",
"문현3동","총인구","2024.09 월","7008","16274","7896","8378",
"문현3동","총인구","2024.10 월","6999","16237","7876","8361",
"문현3동","총인구","2024.11 월","6994","16233","7872","8361",
"문현3동","총인구","2024.12 월","7002","16217","7857","8360",
"문현4동","총인구","2020.01 월","4421","9725","4785","4940",
"문현4동","총인구","2020.02 월","4423","9718","4790","4928",
"문현4동","총인구","2020.03 월","4394","9645","4752","4893",
"문현4동","총인구","2020.04 월","4352","9524","4684","4840",
"문현4동","총인구","2020.05 월","4325","9448","4642","4806",
"문현4동","총인구","2020.06 월","4281","9325","4567","4758",
"문현4동","총인구","2020.07 월","4258","9238","4528","4710",
"문현4동","총인구","2020.08 월","4216","9101","4449","4652",
"문현4동","총인구","2020.09 월","4185","9022","4413","4609",
"문현4동","총인구","2020.10 월","4161","8954","4381","4573",
"문현4동","총인구","2020.11 월","4134","8870","4338","4532",
"문현4동","총인구","2020.12 월","4114","8843","4329","4514",
"문현4동","총인구","2021.01 월","4108","8798","4303","4495",
"문현4동","총인구","2021.02 월","4108","8758","4287","4471",
"문현4동","총인구","2021.03 월","4091","8709","4275","4434",
"문현4동","총인구","2021.04 월","4094","8705","4266","4439",
"문현4동","총인구","2021.05 월","4089","8684","4247","4437",
"문현4동","총인구","2021.06 월","4083","8658","4233","4425",
"문현4동","총인구","2021.07 월","4075","8621","4216","4405",
"문현4동","총인구","2021.08 월","4073","8597","4204","4393",
"문현4동","총인구","2021.09 월","4062","8554","4185","4369",
"문현4동","총인구","2021.10 월","4045","8483","4145","4338",
"문현4동","총인구","2021.11 월","4022","8429","4111","4318",
"문현4동","총인구","2021.12 월","3997","8348","4066","4282",
"문현4동","총인구","2022.01 월","3974","8288","4029","4259",
"문현4동","총인구","2022.02 월","3947","8220","3996","4224",
"문현4동","총인구","2022.03 월","3935","8172","3969","4203",
"문현4동","총인구","2022.04 월","3925","8136","3946","4190",
"문현4동","총인구","2022.05 월","3911","8095","3923","4172",
"문현4동","총인구","2022.06 월","3901","8071","3911","4160",
"문현4동","총인구","2022.07 월","3893","8037","3896","4141",
"문현4동","총인구","2022.08 월","3890","8023","3894","4129",
"문현4동","총인구","2022.09 월","3853","7973","3871","4102",
"문현4동","총인구","2022.10 월","3836","7922","3849","4073",
"문현4동","총인구","2022.11 월","3971","8240","4011","4229",
"문현4동","총인구","2022.12 월","4133","8573","4181","4392",
"문현4동","총인구","2023.01 월","4206","8738","4255","4483",
"문현4동","총인구","2023.02 월","4255","8842","4302","4540",
"문현4동","총인구","2023.03 월","4299","8946","4353","4593",
"문현4동","총인구","2023.04 월","4338","9009","4382","4627",
"문현4동","총인구","2023.05 월","4367","9035","4397","4638",
"문현4동","총인구","2023.06 월","4377","9048","4399","4649",
"문현4동","총인구","2023.07 월","4388","9052","4390","4662",
"문현4동","총인구","2023.08 월","4386","9048","4394","4654",
"문현4동","총인구","2023.09 월","4381","9032","4376","4656",
"문현4동","총인구","2023.10 월","4369","8998","4364","4634",
"문현4동","총인구","2023.11 월","4354","8960","4349","4611",
"문현4동","총인구","2023.12 월","4344","8943","4342","4601",
"문현4동","총인구","2024.01 월","4331","8903","4316","4587",
"문현4동","총인구","2024.02 월","4322","8883","4314","4569",
"문현4동","총인구","2024.03 월","4317","8873","4307","4566",
"문현4동","총인구","2024.04 월","4317","8851","4290","4561",
"문현4동","총인구","2024.05 월","4331","8851","4302","4549",
"문현4동","총인구","2024.06 월","4340","8869","4327","4542",
"문현4동","총인구","2024.07 월","4329","8856","4318","4538",
"문현4동","총인구","2024.08 월","4309","8799","4289","4510",
"문현4동","총인구","2024.09 월","4307","8789","4286","4503",
"문현4동","총인구","2024.10 월","4298","8782","4285","4497",
"문현4동","총인구","2024.11 월","4290","8754","4268","4486",
"문현4동","총인구","2024.12 월","4282","8741","4266","4475",
"북구","총인구","2020.01 월","120406","293482","145311","148171",
"북구","총인구","2020.02 월","120435","292797","144945","147852",
"북구","총인구","2020.03 월","120496","292106","144564","147542",
"북구","총인구","2020.04 월","120449","291527","144265","147262",
"북구","총인구","2020.05 월","120663","291433","144186","147247",
"북구","총인구","2020.06 월","120694","290808","143863","146945",
"북구","총인구","2020.07 월","120706","290157","143561","146596",
"북구","총인구","2020.08 월","120652","289260","143072","146188",
"북구","총인구","2020.09 월","120703","288689","142787","145902",
"북구","총인구","2020.10 월","120604","287861","142375","145486",
"북구","총인구","2020.11 월","120665","287203","142052","145151",
"북구","총인구","2020.12 월","120668","286291","141605","144686",
"북구","총인구","2021.01 월","120728","285787","141324","144463",
"북구","총인구","2021.02 월","120741","285105","140890","144215",
"북구","총인구","2021.03 월","120370","284127","140402","143725",
"북구","총인구","2021.04 월","120807","284334","140532","143802",
"북구","총인구","2021.05 월","121596","285389","141065","144324",
"북구","총인구","2021.06 월","122023","285847","141260","144587",
"북구","총인구","2021.07 월","122336","285928","141260","144668",
"북구","총인구","2021.08 월","122676","286121","141315","144806",
"북구","총인구","2021.09 월","122950","286138","141259","144879",
"북구","총인구","2021.10 월","123090","285961","141185","144776",
"북구","총인구","2021.11 월","123283","285767","141023","144744",
"북구","총인구","2021.12 월","123316","285390","140791","144599",
"북구","총인구","2022.01 월","123247","284705","140402","144303",
"북구","총인구","2022.02 월","123263","283878","139985","143893",
"북구","총인구","2022.03 월","123286","283300","139680","143620",
"북구","총인구","2022.04 월","123330","282955","139491","143464",
"북구","총인구","2022.05 월","123469","282753","139382","143371",
"북구","총인구","2022.06 월","123579","282625","139282","143343",
"북구","총인구","2022.07 월","123626","282381","139124","143257",
"북구","총인구","2022.08 월","123788","282230","139034","143196",
"북구","총인구","2022.09 월","123761","282072","138909","143163",
"북구","총인구","2022.10 월","123831","281871","138758","143113",
"북구","총인구","2022.11 월","123693","281408","138496","142912",
"북구","총인구","2022.12 월","123569","280940","138213","142727",
"북구","총인구","2023.01 월","123569","280662","138026","142636",
"북구","총인구","2023.02 월","123568","280121","137747","142374",
"북구","총인구","2023.03 월","123573","279814","137586","142228",
"북구","총인구","2023.04 월","123532","279440","137379","142061",
"북구","총인구","2023.05 월","123510","279074","137171","141903",
"북구","총인구","2023.06 월","123558","278784","137057","141727",
"북구","총인구","2023.07 월","123504","278417","136868","141549",
"북구","총인구","2023.08 월","123417","277800","136572","141228",
"북구","총인구","2023.09 월","123253","277099","136201","140898",
"북구","총인구","2023.10 월","123164","276638","135987","140651",
"북구","총인구","2023.11 월","123077","276258","135815","140443",
"북구","총인구","2023.12 월","123082","275773","135532","140241",
"북구","총인구","2024.01 월","123062","275137","135207","139930",
"북구","총인구","2024.02 월","123020","274504","134877","139627",
"북구","총인구","2024.03 월","123025","274204","134713","139491",
"북구","총인구","2024.04 월","122975","273798","134460","139338",
"북구","총인구","2024.05 월","123027","273532","134325","139207",
"북구","총인구","2024.06 월","122992","273139","134074","139065",
"북구","총인구","2024.07 월","122927","272645","133819","138826",
"북구","총인구","2024.08 월","122867","272155","133562","138593",
"북구","총인구","2024.09 월","122794","271835","133370","138465",
"북구","총인구","2024.10 월","122603","271054","132994","138060",
"북구","총인구","2024.11 월","122417","270431","132658","137773",
"북구","총인구","2024.12 월","122360","270127","132522","137605",
"구포1동","총인구","2020.01 월","7423","15229","7690","7539",
"구포1동","총인구","2020.02 월","7438","15238","7694","7544",
"구포1동","총인구","2020.03 월","7431","15229","7696","7533",
"구포1동","총인구","2020.04 월","7419","15155","7653","7502",
"구포1동","총인구","2020.05 월","7443","15135","7644","7491",
"구포1동","총인구","2020.06 월","7438","15059","7617","7442",
"구포1동","총인구","2020.07 월","7450","15041","7610","7431",
"구포1동","총인구","2020.08 월","7451","14987","7578","7409",
"구포1동","총인구","2020.09 월","7462","15002","7584","7418",
"구포1동","총인구","2020.10 월","7462","14988","7561","7427",
"구포1동","총인구","2020.11 월","7450","14945","7540","7405",
"구포1동","총인구","2020.12 월","7454","14907","7521","7386",
"구포1동","총인구","2021.01 월","7437","14845","7489","7356",
"구포1동","총인구","2021.02 월","7443","14807","7471","7336",
"구포1동","총인구","2021.03 월","7402","14722","7440","7282",
"구포1동","총인구","2021.04 월","7379","14658","7419","7239",
"구포1동","총인구","2021.05 월","7363","14599","7381","7218",
"구포1동","총인구","2021.06 월","7371","14566","7370","7196",
"구포1동","총인구","2021.07 월","7713","15359","7781","7578",
"구포1동","총인구","2021.08 월","7917","15890","8026","7864",
"구포1동","총인구","2021.09 월","7988","16037","8081","7956",
"구포1동","총인구","2021.10 월","8035","16125","8118","8007",
"구포1동","총인구","2021.11 월","8066","16177","8128","8049",
"구포1동","총인구","2021.12 월","8141","16252","8176","8076",
"구포1동","총인구","2022.01 월","8153","16268","8166","8102",
"구포1동","총인구","2022.02 월","8175","16262","8144","8118",
"구포1동","총인구","2022.03 월","8211","16296","8164","8132",
"구포1동","총인구","2022.04 월","8239","16341","8183","8158",
"구포1동","총인구","2022.05 월","8247","16327","8172","8155",
"구포1동","총인구","2022.06 월","8247","16294","8156","8138",
"구포1동","총인구","2022.07 월","8274","16345","8175","8170",
"구포1동","총인구","2022.08 월","8270","16294","8147","8147",
"구포1동","총인구","2022.09 월","8251","16250","8124","8126",
"구포1동","총인구","2022.10 월","8258","16250","8112","8138",
"구포1동","총인구","2022.11 월","8228","16168","8068","8100",
"구포1동","총인구","2022.12 월","8206","16095","8018","8077",
"구포1동","총인구","2023.01 월","8205","16086","8009","8077",
"구포1동","총인구","2023.02 월","8215","16047","7995","8052",
"구포1동","총인구","2023.03 월","8218","16046","8004","8042",
"구포1동","총인구","2023.04 월","8212","16051","8005","8046",
"구포1동","총인구","2023.05 월","8174","15993","7970","8023",
"구포1동","총인구","2023.06 월","8153","15932","7931","8001",
"구포1동","총인구","2023.07 월","8154","15926","7944","7982",
"구포1동","총인구","2023.08 월","8134","15853","7920","7933",
"구포1동","총인구","2023.09 월","8113","15806","7908","7898",
"구포1동","총인구","2023.10 월","8101","15773","7884","7889",
"구포1동","총인구","2023.11 월","8089","15737","7868","7869",
"구포1동","총인구","2023.12 월","8070","15666","7831","7835",
"구포1동","총인구","2024.01 월","8057","15589","7806","7783",
"구포1동","총인구","2024.02 월","8043","15543","7787","7756",
"구포1동","총인구","2024.03 월","8042","15495","7746","7749",
"구포1동","총인구","2024.04 월","8020","15443","7724","7719",
"구포1동","총인구","2024.05 월","8009","15411","7708","7703",
"구포1동","총인구","2024.06 월","8005","15371","7694","7677",
"구포1동","총인구","2024.07 월","8001","15323","7669","7654",
"구포1동","총인구","2024.08 월","8004","15322","7676","7646",
"구포1동","총인구","2024.09 월","7999","15299","7655","7644",
"구포1동","총인구","2024.10 월","7997","15296","7646","7650",
"구포1동","총인구","2024.11 월","7970","15242","7623","7619",
"구포1동","총인구","2024.12 월","7959","15202","7612","7590",
"구포2동","총인구","2020.01 월","11916","27047","13884","13163",
"구포2동","총인구","2020.02 월","11910","26976","13865","13111",
"구포2동","총인구","2020.03 월","11916","26895","13835","13060",
"구포2동","총인구","2020.04 월","11906","26845","13798","13047",
"구포2동","총인구","2020.05 월","11924","26856","13795","13061",
"구포2동","총인구","2020.06 월","11952","26827","13764","13063",
"구포2동","총인구","2020.07 월","11963","26797","13760","13037",
"구포2동","총인구","2020.08 월","11967","26741","13725","13016",
"구포2동","총인구","2020.09 월","11974","26656","13680","12976",
"구포2동","총인구","2020.10 월","11968","26580","13638","12942",
"구포2동","총인구","2020.11 월","11966","26501","13604","12897",
"구포2동","총인구","2020.12 월","11983","26480","13587","12893",
"구포2동","총인구","2021.01 월","11977","26385","13524","12861",
"구포2동","총인구","2021.02 월","11968","26286","13461","12825",
"구포2동","총인구","2021.03 월","11854","26126","13383","12743",
"구포2동","총인구","2021.04 월","11845","26067","13348","12719",
"구포2동","총인구","2021.05 월","11830","25993","13306","12687",
"구포2동","총인구","2021.06 월","11847","25965","13288","12677",
"구포2동","총인구","2021.07 월","11774","25701","13129","12572",
"구포2동","총인구","2021.08 월","11761","25556","13064","12492",
"구포2동","총인구","2021.09 월","11775","25548","13049","12499",
"구포2동","총인구","2021.10 월","11800","25513","13038","12475",
"구포2동","총인구","2021.11 월","11811","25498","13018","12480",
"구포2동","총인구","2021.12 월","11793","25438","12995","12443",
"구포2동","총인구","2022.01 월","11790","25359","12951","12408",
"구포2동","총인구","2022.02 월","11812","25319","12919","12400",
"구포2동","총인구","2022.03 월","11803","25256","12870","12386",
"구포2동","총인구","2022.04 월","11807","25229","12852","12377",
"구포2동","총인구","2022.05 월","11776","25147","12795","12352",
"구포2동","총인구","2022.06 월","11772","25102","12768","12334",
"구포2동","총인구","2022.07 월","11771","25048","12748","12300",
"구포2동","총인구","2022.08 월","11768","24998","12715","12283",
"구포2동","총인구","2022.09 월","11735","24905","12672","12233",
"구포2동","총인구","2022.10 월","11753","24867","12655","12212",
"구포2동","총인구","2022.11 월","11745","24818","12626","12192",
"구포2동","총인구","2022.12 월","11705","24719","12573","12146",
"구포2동","총인구","2023.01 월","11701","24666","12543","12123",
"구포2동","총인구","2023.02 월","11690","24596","12523","12073",
"구포2동","총인구","2023.03 월","11648","24512","12480","12032",
"구포2동","총인구","2023.04 월","11623","24441","12448","11993",
"구포2동","총인구","2023.05 월","11620","24429","12438","11991",
"구포2동","총인구","2023.06 월","11629","24391","12425","11966",
"구포2동","총인구","2023.07 월","11599","24310","12383","11927",
"구포2동","총인구","2023.08 월","11579","24207","12346","11861",
"구포2동","총인구","2023.09 월","11558","24132","12310","11822",
"구포2동","총인구","2023.10 월","11554","24061","12286","11775",
"구포2동","총인구","2023.11 월","11539","24016","12270","11746",
"구포2동","총인구","2023.12 월","11522","23947","12238","11709",
"구포2동","총인구","2024.01 월","11524","23902","12222","11680",
"구포2동","총인구","2024.02 월","11520","23845","12189","11656",
"구포2동","총인구","2024.03 월","11510","23808","12164","11644",
"구포2동","총인구","2024.04 월","11507","23786","12143","11643",
"구포2동","총인구","2024.05 월","11527","23744","12120","11624",
"구포2동","총인구","2024.06 월","11524","23695","12073","11622",
"구포2동","총인구","2024.07 월","11508","23642","12048","11594",
"구포2동","총인구","2024.08 월","11472","23525","11992","11533",
"구포2동","총인구","2024.09 월","11457","23478","11970","11508",
"구포2동","총인구","2024.10 월","11429","23419","11929","11490",
"구포2동","총인구","2024.11 월","11414","23392","11910","11482",
"구포2동","총인구","2024.12 월","11396","23365","11902","11463",
"구포3동","총인구","2020.01 월","9296","22320","11569","10751",
"구포3동","총인구","2020.02 월","9286","22237","11536","10701",
"구포3동","총인구","2020.03 월","9257","22102","11467","10635",
"구포3동","총인구","2020.04 월","9214","21898","11361","10537",
"구포3동","총인구","2020.05 월","9240","21853","11346","10507",
"구포3동","총인구","2020.06 월","9242","21806","11313","10493",
"구포3동","총인구","2020.07 월","9232","21762","11304","10458",
"구포3동","총인구","2020.08 월","9223","21671","11254","10417",
"구포3동","총인구","2020.09 월","9240","21623","11218","10405",
"구포3동","총인구","2020.10 월","9236","21576","11187","10389",
"구포3동","총인구","2020.11 월","9245","21549","11178","10371",
"구포3동","총인구","2020.12 월","9255","21502","11160","10342",
"구포3동","총인구","2021.01 월","9282","21484","11146","10338",
"구포3동","총인구","2021.02 월","9274","21385","11096","10289",
"구포3동","총인구","2021.03 월","9253","21269","11033","10236",
"구포3동","총인구","2021.04 월","9245","21196","11001","10195",
"구포3동","총인구","2021.05 월","9265","21149","10980","10169",
"구포3동","총인구","2021.06 월","9254","21090","10944","10146",
"구포3동","총인구","2021.07 월","9214","20910","10841","10069",
"구포3동","총인구","2021.08 월","9212","20804","10790","10014",
"구포3동","총인구","2021.09 월","9220","20745","10766","9979",
"구포3동","총인구","2021.10 월","9235","20701","10754","9947",
"구포3동","총인구","2021.11 월","9249","20683","10752","9931",
"구포3동","총인구","2021.12 월","9262","20663","10733","9930",
"구포3동","총인구","2022.01 월","9274","20611","10701","9910",
"구포3동","총인구","2022.02 월","9248","20491","10647","9844",
"구포3동","총인구","2022.03 월","9249","20437","10627","9810",
"구포3동","총인구","2022.04 월","9237","20359","10586","9773",
"구포3동","총인구","2022.05 월","9245","20307","10567","9740",
"구포3동","총인구","2022.06 월","9254","20275","10554","9721",
"구포3동","총인구","2022.07 월","9247","20236","10518","9718",
"구포3동","총인구","2022.08 월","9250","20180","10491","9689",
"구포3동","총인구","2022.09 월","9218","20106","10443","9663",
"구포3동","총인구","2022.10 월","9213","20059","10411","9648",
"구포3동","총인구","2022.11 월","9187","20018","10387","9631",
"구포3동","총인구","2022.12 월","9157","19970","10349","9621",
"구포3동","총인구","2023.01 월","9151","19909","10308","9601",
"구포3동","총인구","2023.02 월","9125","19803","10270","9533",
"구포3동","총인구","2023.03 월","9131","19736","10239","9497",
"구포3동","총인구","2023.04 월","9147","19722","10231","9491",
"구포3동","총인구","2023.05 월","9123","19677","10198","9479",
"구포3동","총인구","2023.06 월","9135","19644","10174","9470",
"구포3동","총인구","2023.07 월","9125","19586","10137","9449",
"구포3동","총인구","2023.08 월","9099","19542","10122","9420",
"구포3동","총인구","2023.09 월","9086","19475","10074","9401",
"구포3동","총인구","2023.10 월","9061","19422","10066","9356",
"구포3동","총인구","2023.11 월","9052","19373","10052","9321",
"구포3동","총인구","2023.12 월","9004","19237","9963","9274",
"구포3동","총인구","2024.01 월","8964","19150","9898","9252",
"구포3동","총인구","2024.02 월","8938","19050","9843","9207",
"구포3동","총인구","2024.03 월","8931","19072","9875","9197",
"구포3동","총인구","2024.04 월","8932","19032","9856","9176",
"구포3동","총인구","2024.05 월","8931","19001","9835","9166",
"구포3동","총인구","2024.06 월","8924","18978","9814","9164",
"구포3동","총인구","2024.07 월","8906","18897","9776","9121",
"구포3동","총인구","2024.08 월","8899","18826","9740","9086",
"구포3동","총인구","2024.09 월","8902","18830","9743","9087",
"구포3동","총인구","2024.10 월","8886","18764","9714","9050",
"구포3동","총인구","2024.11 월","8845","18656","9649","9007",
"구포3동","총인구","2024.12 월","8822","18577","9600","8977",
"금곡동","총인구","2020.01 월","18121","40234","19522","20712",
"금곡동","총인구","2020.02 월","18115","40054","19446","20608",
"금곡동","총인구","2020.03 월","18114","39964","19401","20563",
"금곡동","총인구","2020.04 월","18126","39908","19379","20529",
"금곡동","총인구","2020.05 월","18121","39865","19330","20535",
"금곡동","총인구","2020.06 월","18126","39760","19268","20492",
"금곡동","총인구","2020.07 월","18129","39657","19206","20451",
"금곡동","총인구","2020.08 월","18124","39532","19125","20407",
"금곡동","총인구","2020.09 월","18135","39463","19106","20357",
"금곡동","총인구","2020.10 월","18118","39303","19033","20270",
"금곡동","총인구","2020.11 월","18179","39326","19044","20282",
"금곡동","총인구","2020.12 월","18168","39164","18958","20206",
"금곡동","총인구","2021.01 월","18200","39146","18958","20188",
"금곡동","총인구","2021.02 월","18188","39068","18904","20164",
"금곡동","총인구","2021.03 월","18184","38984","18872","20112",
"금곡동","총인구","2021.04 월","18185","38769","18771","19998",
"금곡동","총인구","2021.05 월","18158","38609","18698","19911",
"금곡동","총인구","2021.06 월","18165","38564","18667","19897",
"금곡동","총인구","2021.07 월","18146","38468","18601","19867",
"금곡동","총인구","2021.08 월","18145","38379","18539","19840",
"금곡동","총인구","2021.09 월","18157","38349","18515","19834",
"금곡동","총인구","2021.10 월","18172","38303","18473","19830",
"금곡동","총인구","2021.11 월","18173","38237","18436","19801",
"금곡동","총인구","2021.12 월","18148","38120","18397","19723",
"금곡동","총인구","2022.01 월","18129","38019","18354","19665",
"금곡동","총인구","2022.02 월","18128","37930","18322","19608",
"금곡동","총인구","2022.03 월","18119","37822","18283","19539",
"금곡동","총인구","2022.04 월","18111","37791","18265","19526",
"금곡동","총인구","2022.05 월","18106","37733","18224","19509",
"금곡동","총인구","2022.06 월","18085","37640","18175","19465",
"금곡동","총인구","2022.07 월","18057","37531","18120","19411",
"금곡동","총인구","2022.08 월","17984","37323","18016","19307",
"금곡동","총인구","2022.09 월","17962","37218","17943","19275",
"금곡동","총인구","2022.10 월","17927","37101","17894","19207",
"금곡동","총인구","2022.11 월","17894","36972","17832","19140",
"금곡동","총인구","2022.12 월","17890","36902","17788","19114",
"금곡동","총인구","2023.01 월","17873","36873","17789","19084",
"금곡동","총인구","2023.02 월","17874","36774","17725","19049",
"금곡동","총인구","2023.03 월","17871","36745","17699","19046",
"금곡동","총인구","2023.04 월","17858","36656","17659","18997",
"금곡동","총인구","2023.05 월","17857","36531","17592","18939",
"금곡동","총인구","2023.06 월","17856","36468","17569","18899",
"금곡동","총인구","2023.07 월","17853","36389","17533","18856",
"금곡동","총인구","2023.08 월","17836","36330","17527","18803",
"금곡동","총인구","2023.09 월","17819","36215","17466","18749",
"금곡동","총인구","2023.10 월","17804","36130","17417","18713",
"금곡동","총인구","2023.11 월","17791","36069","17380","18689",
"금곡동","총인구","2023.12 월","17763","35930","17317","18613",
"금곡동","총인구","2024.01 월","17730","35763","17228","18535",
"금곡동","총인구","2024.02 월","17707","35608","17146","18462",
"금곡동","총인구","2024.03 월","17710","35542","17098","18444",
"금곡동","총인구","2024.04 월","17714","35502","17071","18431",
"금곡동","총인구","2024.05 월","17713","35460","17040","18420",
"금곡동","총인구","2024.06 월","17697","35386","17009","18377",
"금곡동","총인구","2024.07 월","17677","35315","16947","18368",
"금곡동","총인구","2024.08 월","17676","35255","16921","18334",
"금곡동","총인구","2024.09 월","17655","35183","16897","18286",
"금곡동","총인구","2024.10 월","17642","35061","16830","18231",
"금곡동","총인구","2024.11 월","17602","34959","16786","18173",
"금곡동","총인구","2024.12 월","17599","34936","16776","18160",
"화명1동","총인구","2020.01 월","14562","43914","21634","22280",
"화명1동","총인구","2020.02 월","14558","43825","21568","22257",
"화명1동","총인구","2020.03 월","14562","43686","21490","22196",
"화명1동","총인구","2020.04 월","14593","43669","21493","22176",
"화명1동","총인구","2020.05 월","14606","43650","21466","22184",
"화명1동","총인구","2020.06 월","14600","43536","21408","22128",
"화명1동","총인구","2020.07 월","14607","43410","21357","22053",
"화명1동","총인구","2020.08 월","14595","43287","21296","21991",
"화명1동","총인구","2020.09 월","14573","43141","21220","21921",
"화명1동","총인구","2020.10 월","14559","43042","21167","21875",
"화명1동","총인구","2020.11 월","14558","42905","21104","21801",
"화명1동","총인구","2020.12 월","14523","42710","21003","21707",
"화명1동","총인구","2021.01 월","14515","42680","20962","21718",
"화명1동","총인구","2021.02 월","14515","42565","20899","21666",
"화명1동","총인구","2021.03 월","14484","42442","20827","21615",
"화명1동","총인구","2021.04 월","14438","42249","20751","21498",
"화명1동","총인구","2021.05 월","14462","42227","20741","21486",
"화명1동","총인구","2021.06 월","14461","42144","20698","21446",
"화명1동","총인구","2021.07 월","14464","42063","20643","21420",
"화명1동","총인구","2021.08 월","14480","41994","20610","21384",
"화명1동","총인구","2021.09 월","14488","41977","20587","21390",
"화명1동","총인구","2021.10 월","14483","41878","20552","21326",
"화명1동","총인구","2021.11 월","14480","41801","20490","21311",
"화명1동","총인구","2021.12 월","14477","41726","20416","21310",
"화명1동","총인구","2022.01 월","14445","41553","20324","21229",
"화명1동","총인구","2022.02 월","14418","41371","20243","21128",
"화명1동","총인구","2022.03 월","14416","41253","20184","21069",
"화명1동","총인구","2022.04 월","14411","41188","20138","21050",
"화명1동","총인구","2022.05 월","14415","41112","20099","21013",
"화명1동","총인구","2022.06 월","14420","41103","20092","21011",
"화명1동","총인구","2022.07 월","14410","41080","20075","21005",
"화명1동","총인구","2022.08 월","14385","40940","19989","20951",
"화명1동","총인구","2022.09 월","14371","40865","19950","20915",
"화명1동","총인구","2022.10 월","14350","40754","19893","20861",
"화명1동","총인구","2022.11 월","14335","40710","19850","20860",
"화명1동","총인구","2022.12 월","14328","40667","19821","20846",
"화명1동","총인구","2023.01 월","14327","40635","19793","20842",
"화명1동","총인구","2023.02 월","14315","40540","19736","20804",
"화명1동","총인구","2023.03 월","14321","40513","19752","20761",
"화명1동","총인구","2023.04 월","14314","40480","19723","20757",
"화명1동","총인구","2023.05 월","14330","40500","19731","20769",
"화명1동","총인구","2023.06 월","14338","40462","19717","20745",
"화명1동","총인구","2023.07 월","14344","40469","19729","20740",
"화명1동","총인구","2023.08 월","14351","40436","19695","20741",
"화명1동","총인구","2023.09 월","14337","40363","19650","20713",
"화명1동","총인구","2023.10 월","14351","40372","19658","20714",
"화명1동","총인구","2023.11 월","14357","40357","19648","20709",
"화명1동","총인구","2023.12 월","14326","40235","19600","20635",
"화명1동","총인구","2024.01 월","14289","40022","19518","20504",
"화명1동","총인구","2024.02 월","14269","39849","19437","20412",
"화명1동","총인구","2024.03 월","14264","39769","19413","20356",
"화명1동","총인구","2024.04 월","14266","39728","19380","20348",
"화명1동","총인구","2024.05 월","14274","39700","19379","20321",
"화명1동","총인구","2024.06 월","14267","39639","19330","20309",
"화명1동","총인구","2024.07 월","14270","39578","19307","20271",
"화명1동","총인구","2024.08 월","14247","39468","19240","20228",
"화명1동","총인구","2024.09 월","14252","39485","19247","20238",
"화명1동","총인구","2024.10 월","14240","39394","19211","20183",
"화명1동","총인구","2024.11 월","14234","39314","19150","20164",
"화명1동","총인구","2024.12 월","14261","39335","19151","20184",
"화명2동","총인구","2020.01 월","6195","16045","7846","8199",
"화명2동","총인구","2020.02 월","6195","16007","7813","8194",
"화명2동","총인구","2020.03 월","6190","15948","7786","8162",
"화명2동","총인구","2020.04 월","6169","15881","7760","8121",
"화명2동","총인구","2020.05 월","6169","15823","7720","8103",
"화명2동","총인구","2020.06 월","6168","15773","7684","8089",
"화명2동","총인구","2020.07 월","6160","15722","7663","8059",
"화명2동","총인구","2020.08 월","6186","15704","7638","8066",
"화명2동","총인구","2020.09 월","6190","15654","7615","8039",
"화명2동","총인구","2020.10 월","6181","15606","7598","8008",
"화명2동","총인구","2020.11 월","6192","15552","7568","7984",
"화명2동","총인구","2020.12 월","6190","15505","7555","7950",
"화명2동","총인구","2021.01 월","6186","15444","7534","7910",
"화명2동","총인구","2021.02 월","6195","15417","7514","7903",
"화명2동","총인구","2021.03 월","6227","15531","7564","7967",
"화명2동","총인구","2021.04 월","6545","16346","7966","8380",
"화명2동","총인구","2021.05 월","6663","16647","8115","8532",
"화명2동","총인구","2021.06 월","6744","16841","8210","8631",
"화명2동","총인구","2021.07 월","6788","16899","8245","8654",
"화명2동","총인구","2021.08 월","6847","16969","8280","8689",
"화명2동","총인구","2021.09 월","6951","17036","8308","8728",
"화명2동","총인구","2021.10 월","6982","17120","8351","8769",
"화명2동","총인구","2021.11 월","7017","17155","8366","8789",
"화명2동","총인구","2021.12 월","7029","17186","8366","8820",
"화명2동","총인구","2022.01 월","7038","17195","8361","8834",
"화명2동","총인구","2022.02 월","7036","17126","8326","8800",
"화명2동","총인구","2022.03 월","7046","17118","8309","8809",
"화명2동","총인구","2022.04 월","7038","17100","8303","8797",
"화명2동","총인구","2022.05 월","7049","17104","8320","8784",
"화명2동","총인구","2022.06 월","7067","17112","8316","8796",
"화명2동","총인구","2022.07 월","7079","17116","8311","8805",
"화명2동","총인구","2022.08 월","7185","17383","8457","8926",
"화명2동","총인구","2022.09 월","7220","17469","8508","8961",
"화명2동","총인구","2022.10 월","7262","17554","8540","9014",
"화명2동","총인구","2022.11 월","7267","17550","8540","9010",
"화명2동","총인구","2022.12 월","7279","17583","8555","9028",
"화명2동","총인구","2023.01 월","7278","17551","8531","9020",
"화명2동","총인구","2023.02 월","7294","17558","8530","9028",
"화명2동","총인구","2023.03 월","7303","17558","8531","9027",
"화명2동","총인구","2023.04 월","7296","17540","8518","9022",
"화명2동","총인구","2023.05 월","7308","17542","8513","9029",
"화명2동","총인구","2023.06 월","7323","17531","8501","9030",
"화명2동","총인구","2023.07 월","7310","17488","8475","9013",
"화명2동","총인구","2023.08 월","7328","17456","8456","9000",
"화명2동","총인구","2023.09 월","7324","17441","8445","8996",
"화명2동","총인구","2023.10 월","7321","17419","8424","8995",
"화명2동","총인구","2023.11 월","7306","17398","8407","8991",
"화명2동","총인구","2023.12 월","7305","17374","8398","8976",
"화명2동","총인구","2024.01 월","7304","17324","8384","8940",
"화명2동","총인구","2024.02 월","7316","17315","8372","8943",
"화명2동","총인구","2024.03 월","7311","17288","8357","8931",
"화명2동","총인구","2024.04 월","7298","17244","8338","8906",
"화명2동","총인구","2024.05 월","7293","17222","8322","8900",
"화명2동","총인구","2024.06 월","7289","17205","8306","8899",
"화명2동","총인구","2024.07 월","7276","17153","8288","8865",
"화명2동","총인구","2024.08 월","7279","17122","8280","8842",
"화명2동","총인구","2024.09 월","7262","17073","8254","8819",
"화명2동","총인구","2024.10 월","7247","16960","8206","8754",
"화명2동","총인구","2024.11 월","7236","16894","8182","8712",
"화명2동","총인구","2024.12 월","7245","16870","8171","8699",
"화명3동","총인구","2020.01 월","10642","31069","15186","15883",
"화명3동","총인구","2020.02 월","10625","30926","15111","15815",
"화명3동","총인구","2020.03 월","10626","30830","15057","15773",
"화명3동","총인구","2020.04 월","10640","30829","15061","15768",
"화명3동","총인구","2020.05 월","10671","30871","15093","15778",
"화명3동","총인구","2020.06 월","10686","30864","15101","15763",
"화명3동","총인구","2020.07 월","10700","30861","15097","15764",
"화명3동","총인구","2020.08 월","10697","30779","15066","15713",
"화명3동","총인구","2020.09 월","10721","30777","15057","15720",
"화명3동","총인구","2020.10 월","10695","30666","15011","15655",
"화명3동","총인구","2020.11 월","10695","30593","14971","15622",
"화명3동","총인구","2020.12 월","10703","30499","14930","15569",
"화명3동","총인구","2021.01 월","10695","30410","14894","15516",
"화명3동","총인구","2021.02 월","10740","30388","14886","15502",
"화명3동","총인구","2021.03 월","10749","30301","14834","15467",
"화명3동","총인구","2021.04 월","10745","30164","14768","15396",
"화명3동","총인구","2021.05 월","10729","30050","14715","15335",
"화명3동","총인구","2021.06 월","10726","30002","14696","15306",
"화명3동","총인구","2021.07 월","10725","29938","14666","15272",
"화명3동","총인구","2021.08 월","10775","29982","14680","15302",
"화명3동","총인구","2021.09 월","10806","29990","14679","15311",
"화명3동","총인구","2021.10 월","10817","29962","14651","15311",
"화명3동","총인구","2021.11 월","10821","29899","14611","15288",
"화명3동","총인구","2021.12 월","10795","29863","14587","15276",
"화명3동","총인구","2022.01 월","10774","29764","14522","15242",
"화명3동","총인구","2022.02 월","10772","29644","14464","15180",
"화명3동","총인구","2022.03 월","10790","29592","14438","15154",
"화명3동","총인구","2022.04 월","10784","29508","14406","15102",
"화명3동","총인구","2022.05 월","10772","29447","14367","15080",
"화명3동","총인구","2022.06 월","10782","29433","14360","15073",
"화명3동","총인구","2022.07 월","10784","29376","14345","15031",
"화명3동","총인구","2022.08 월","10782","29320","14322","14998",
"화명3동","총인구","2022.09 월","10788","29304","14304","15000",
"화명3동","총인구","2022.10 월","10775","29218","14252","14966",
"화명3동","총인구","2022.11 월","10746","29145","14221","14924",
"화명3동","총인구","2022.12 월","10717","29047","14171","14876",
"화명3동","총인구","2023.01 월","10711","29002","14143","14859",
"화명3동","총인구","2023.02 월","10711","28897","14093","14804",
"화명3동","총인구","2023.03 월","10721","28879","14078","14801",
"화명3동","총인구","2023.04 월","10719","28848","14057","14791",
"화명3동","총인구","2023.05 월","10728","28839","14055","14784",
"화명3동","총인구","2023.06 월","10748","28873","14080","14793",
"화명3동","총인구","2023.07 월","10746","28828","14053","14775",
"화명3동","총인구","2023.08 월","10747","28785","14033","14752",
"화명3동","총인구","2023.09 월","10738","28734","14005","14729",
"화명3동","총인구","2023.10 월","10746","28738","14016","14722",
"화명3동","총인구","2023.11 월","10753","28766","14043","14723",
"화명3동","총인구","2023.12 월","10726","28665","13977","14688",
"화명3동","총인구","2024.01 월","10706","28554","13923","14631",
"화명3동","총인구","2024.02 월","10667","28453","13889","14564",
"화명3동","총인구","2024.03 월","10679","28389","13845","14544",
"화명3동","총인구","2024.04 월","10675","28307","13801","14506",
"화명3동","총인구","2024.05 월","10684","28298","13798","14500",
"화명3동","총인구","2024.06 월","10696","28308","13794","14514",
"화명3동","총인구","2024.07 월","10708","28298","13785","14513",
"화명3동","총인구","2024.08 월","10730","28304","13765","14539",
"화명3동","총인구","2024.09 월","10735","28280","13745","14535",
"화명3동","총인구","2024.10 월","10710","28199","13720","14479",
"화명3동","총인구","2024.11 월","10735","28209","13719","14490",
"화명3동","총인구","2024.12 월","10729","28211","13738","14473",
"덕천1동","총인구","2020.01 월","6823","13541","6669","6872",
"덕천1동","총인구","2020.02 월","6810","13460","6615","6845",
"덕천1동","총인구","2020.03 월","6803","13422","6593","6829",
"덕천1동","총인구","2020.04 월","6770","13328","6550","6778",
"덕천1동","총인구","2020.05 월","6765","13306","6544","6762",
"덕천1동","총인구","2020.06 월","6692","13114","6454","6660",
"덕천1동","총인구","2020.07 월","6591","12853","6331","6522",
"덕천1동","총인구","2020.08 월","6518","12653","6216","6437",
"덕천1동","총인구","2020.09 월","6499","12577","6191","6386",
"덕천1동","총인구","2020.10 월","6488","12525","6160","6365",
"덕천1동","총인구","2020.11 월","6479","12461","6125","6336",
"덕천1동","총인구","2020.12 월","6457","12387","6093","6294",
"덕천1동","총인구","2021.01 월","6445","12331","6058","6273",
"덕천1동","총인구","2021.02 월","6423","12238","6006","6232",
"덕천1동","총인구","2021.03 월","6385","12153","5971","6182",
"덕천1동","총인구","2021.04 월","6355","12040","5914","6126",
"덕천1동","총인구","2021.05 월","6312","11883","5836","6047",
"덕천1동","총인구","2021.06 월","6261","11710","5758","5952",
"덕천1동","총인구","2021.07 월","6164","11447","5636","5811",
"덕천1동","총인구","2021.08 월","6138","11364","5591","5773",
"덕천1동","총인구","2021.09 월","6114","11306","5564","5742",
"덕천1동","총인구","2021.10 월","6105","11270","5545","5725",
"덕천1동","총인구","2021.11 월","6099","11219","5519","5700",
"덕천1동","총인구","2021.12 월","6077","11175","5504","5671",
"덕천1동","총인구","2022.01 월","6088","11174","5500","5674",
"덕천1동","총인구","2022.02 월","6116","11160","5495","5665",
"덕천1동","총인구","2022.03 월","6100","11107","5463","5644",
"덕천1동","총인구","2022.04 월","6102","11088","5441","5647",
"덕천1동","총인구","2022.05 월","6074","11016","5409","5607",
"덕천1동","총인구","2022.06 월","6057","10971","5380","5591",
"덕천1동","총인구","2022.07 월","6040","10907","5339","5568",
"덕천1동","총인구","2022.08 월","6120","11033","5402","5631",
"덕천1동","총인구","2022.09 월","6282","11447","5618","5829",
"덕천1동","총인구","2022.10 월","6374","11640","5713","5927",
"덕천1동","총인구","2022.11 월","6426","11749","5771","5978",
"덕천1동","총인구","2022.12 월","6456","11813","5794","6019",
"덕천1동","총인구","2023.01 월","6457","11806","5787","6019",
"덕천1동","총인구","2023.02 월","6462","11836","5803","6033",
"덕천1동","총인구","2023.03 월","6501","11899","5832","6067",
"덕천1동","총인구","2023.04 월","6538","11927","5847","6080",
"덕천1동","총인구","2023.05 월","6579","11964","5864","6100",
"덕천1동","총인구","2023.06 월","6613","12015","5897","6118",
"덕천1동","총인구","2023.07 월","6610","12012","5881","6131",
"덕천1동","총인구","2023.08 월","6617","12010","5878","6132",
"덕천1동","총인구","2023.09 월","6601","11952","5844","6108",
"덕천1동","총인구","2023.10 월","6609","11946","5841","6105",
"덕천1동","총인구","2023.11 월","6602","11924","5824","6100",
"덕천1동","총인구","2023.12 월","6836","12414","6076","6338",
"덕천1동","총인구","2024.01 월","7060","12925","6319","6606",
"덕천1동","총인구","2024.02 월","7143","13124","6424","6700",
"덕천1동","총인구","2024.03 월","7173","13206","6461","6745",
"덕천1동","총인구","2024.04 월","7202","13279","6480","6799",
"덕천1동","총인구","2024.05 월","7233","13352","6516","6836",
"덕천1동","총인구","2024.06 월","7257","13396","6542","6854",
"덕천1동","총인구","2024.07 월","7276","13422","6556","6866",
"덕천1동","총인구","2024.08 월","7267","13408","6537","6871",
"덕천1동","총인구","2024.09 월","7255","13399","6529","6870",
"덕천1동","총인구","2024.10 월","7249","13404","6542","6862",
"덕천1동","총인구","2024.11 월","7240","13386","6524","6862",
"덕천1동","총인구","2024.12 월","7229","13371","6523","6848",
"덕천2동","총인구","2020.01 월","6574","12776","6327","6449",
"덕천2동","총인구","2020.02 월","6575","12737","6311","6426",
"덕천2동","총인구","2020.03 월","6588","12698","6290","6408",
"덕천2동","총인구","2020.04 월","6595","12700","6291","6409",
"덕천2동","총인구","2020.05 월","6652","12733","6321","6412",
"덕천2동","총인구","2020.06 월","6676","12717","6321","6396",
"덕천2동","총인구","2020.07 월","6705","12766","6336","6430",
"덕천2동","총인구","2020.08 월","6700","12713","6306","6407",
"덕천2동","총인구","2020.09 월","6709","12696","6305","6391",
"덕천2동","총인구","2020.10 월","6703","12651","6283","6368",
"덕천2동","총인구","2020.11 월","6690","12592","6257","6335",
"덕천2동","총인구","2020.12 월","6700","12530","6230","6300",
"덕천2동","총인구","2021.01 월","6723","12524","6222","6302",
"덕천2동","총인구","2021.02 월","6702","12456","6180","6276",
"덕천2동","총인구","2021.03 월","6669","12399","6149","6250",
"덕천2동","총인구","2021.04 월","6666","12369","6136","6233",
"덕천2동","총인구","2021.05 월","6651","12334","6127","6207",
"덕천2동","총인구","2021.06 월","6643","12287","6102","6185",
"덕천2동","총인구","2021.07 월","6639","12230","6073","6157",
"덕천2동","총인구","2021.08 월","6644","12193","6059","6134",
"덕천2동","총인구","2021.09 월","6644","12200","6062","6138",
"덕천2동","총인구","2021.10 월","6644","12164","6035","6129",
"덕천2동","총인구","2021.11 월","6657","12167","6043","6124",
"덕천2동","총인구","2021.12 월","6660","12113","6007","6106",
"덕천2동","총인구","2022.01 월","6637","12077","5992","6085",
"덕천2동","총인구","2022.02 월","6639","12032","5964","6068",
"덕천2동","총인구","2022.03 월","6624","11982","5935","6047",
"덕천2동","총인구","2022.04 월","6637","11969","5927","6042",
"덕천2동","총인구","2022.05 월","6643","11949","5934","6015",
"덕천2동","총인구","2022.06 월","6653","11943","5930","6013",
"덕천2동","총인구","2022.07 월","6648","11905","5909","5996",
"덕천2동","총인구","2022.08 월","6644","11870","5907","5963",
"덕천2동","총인구","2022.09 월","6592","11768","5835","5933",
"덕천2동","총인구","2022.10 월","6580","11716","5804","5912",
"덕천2동","총인구","2022.11 월","6570","11699","5802","5897",
"덕천2동","총인구","2022.12 월","6567","11677","5813","5864",
"덕천2동","총인구","2023.01 월","6571","11670","5812","5858",
"덕천2동","총인구","2023.02 월","6599","11673","5818","5855",
"덕천2동","총인구","2023.03 월","6593","11646","5792","5854",
"덕천2동","총인구","2023.04 월","6568","11598","5768","5830",
"덕천2동","총인구","2023.05 월","6562","11582","5757","5825",
"덕천2동","총인구","2023.06 월","6547","11523","5740","5783",
"덕천2동","총인구","2023.07 월","6529","11473","5713","5760",
"덕천2동","총인구","2023.08 월","6535","11447","5698","5749",
"덕천2동","총인구","2023.09 월","6533","11420","5693","5727",
"덕천2동","총인구","2023.10 월","6530","11411","5688","5723",
"덕천2동","총인구","2023.11 월","6550","11415","5686","5729",
"덕천2동","총인구","2023.12 월","6518","11340","5640","5700",
"덕천2동","총인구","2024.01 월","6488","11276","5599","5677",
"덕천2동","총인구","2024.02 월","6502","11237","5578","5659",
"덕천2동","총인구","2024.03 월","6492","11240","5585","5655",
"덕천2동","총인구","2024.04 월","6489","11203","5570","5633",
"덕천2동","총인구","2024.05 월","6479","11136","5544","5592",
"덕천2동","총인구","2024.06 월","6476","11117","5533","5584",
"덕천2동","총인구","2024.07 월","6474","11089","5522","5567",
"덕천2동","총인구","2024.08 월","6468","11079","5508","5571",
"덕천2동","총인구","2024.09 월","6445","11040","5484","5556",
"덕천2동","총인구","2024.10 월","6428","10995","5466","5529",
"덕천2동","총인구","2024.11 월","6418","10952","5450","5502",
"덕천2동","총인구","2024.12 월","6411","10933","5435","5498",
"덕천3동","총인구","2020.01 월","5708","11448","5586","5862",
"덕천3동","총인구","2020.02 월","5712","11428","5578","5850",
"덕천3동","총인구","2020.03 월","5711","11384","5554","5830",
"덕천3동","총인구","2020.04 월","5714","11368","5552","5816",
"덕천3동","총인구","2020.05 월","5716","11345","5547","5798",
"덕천3동","총인구","2020.06 월","5731","11371","5548","5823",
"덕천3동","총인구","2020.07 월","5736","11352","5539","5813",
"덕천3동","총인구","2020.08 월","5758","11351","5544","5807",
"덕천3동","총인구","2020.09 월","5764","11321","5527","5794",
"덕천3동","총인구","2020.10 월","5747","11272","5502","5770",
"덕천3동","총인구","2020.11 월","5734","11199","5467","5732",
"덕천3동","총인구","2020.12 월","5743","11178","5450","5728",
"덕천3동","총인구","2021.01 월","5752","11148","5443","5705",
"덕천3동","총인구","2021.02 월","5758","11143","5436","5707",
"덕천3동","총인구","2021.03 월","5687","11031","5393","5638",
"덕천3동","총인구","2021.04 월","5685","10986","5365","5621",
"덕천3동","총인구","2021.05 월","5662","10889","5323","5566",
"덕천3동","총인구","2021.06 월","5662","10910","5327","5583",
"덕천3동","총인구","2021.07 월","5663","10883","5313","5570",
"덕천3동","총인구","2021.08 월","5652","10870","5306","5564",
"덕천3동","총인구","2021.09 월","5650","10838","5296","5542",
"덕천3동","총인구","2021.10 월","5646","10833","5299","5534",
"덕천3동","총인구","2021.11 월","5652","10839","5298","5541",
"덕천3동","총인구","2021.12 월","5660","10820","5287","5533",
"덕천3동","총인구","2022.01 월","5660","10813","5276","5537",
"덕천3동","총인구","2022.02 월","5648","10775","5261","5514",
"덕천3동","총인구","2022.03 월","5638","10735","5240","5495",
"덕천3동","총인구","2022.04 월","5631","10695","5223","5472",
"덕천3동","총인구","2022.05 월","5623","10671","5212","5459",
"덕천3동","총인구","2022.06 월","5614","10647","5191","5456",
"덕천3동","총인구","2022.07 월","5600","10615","5175","5440",
"덕천3동","총인구","2022.08 월","5601","10607","5162","5445",
"덕천3동","총인구","2022.09 월","5579","10563","5140","5423",
"덕천3동","총인구","2022.10 월","5581","10553","5135","5418",
"덕천3동","총인구","2022.11 월","5572","10513","5107","5406",
"덕천3동","총인구","2022.12 월","5562","10475","5079","5396",
"덕천3동","총인구","2023.01 월","5563","10450","5068","5382",
"덕천3동","총인구","2023.02 월","5574","10452","5064","5388",
"덕천3동","총인구","2023.03 월","5557","10417","5039","5378",
"덕천3동","총인구","2023.04 월","5546","10373","5018","5355",
"덕천3동","총인구","2023.05 월","5538","10341","5001","5340",
"덕천3동","총인구","2023.06 월","5534","10343","4998","5345",
"덕천3동","총인구","2023.07 월","5531","10334","5004","5330",
"덕천3동","총인구","2023.08 월","5524","10297","4986","5311",
"덕천3동","총인구","2023.09 월","5512","10256","4961","5295",
"덕천3동","총인구","2023.10 월","5496","10213","4934","5279",
"덕천3동","총인구","2023.11 월","5491","10190","4926","5264",
"덕천3동","총인구","2023.12 월","5486","10140","4906","5234",
"덕천3동","총인구","2024.01 월","5452","10056","4857","5199",
"덕천3동","총인구","2024.02 월","5431","10010","4838","5172",
"덕천3동","총인구","2024.03 월","5418","9959","4816","5143",
"덕천3동","총인구","2024.04 월","5407","9920","4802","5118",
"덕천3동","총인구","2024.05 월","5416","9914","4804","5110",
"덕천3동","총인구","2024.06 월","5401","9877","4790","5087",
"덕천3동","총인구","2024.07 월","5399","9858","4795","5063",
"덕천3동","총인구","2024.08 월","5397","9843","4793","5050",
"덕천3동","총인구","2024.09 월","5400","9835","4786","5049",
"덕천3동","총인구","2024.10 월","5395","9837","4784","5053",
"덕천3동","총인구","2024.11 월","5373","9791","4753","5038",
"덕천3동","총인구","2024.12 월","5373","9778","4742","5036",
"만덕1동","총인구","2020.01 월","5126","12434","6119","6315",
"만덕1동","총인구","2020.02 월","5186","12627","6220","6407",
"만덕1동","총인구","2020.03 월","5243","12747","6255","6492",
"만덕1동","총인구","2020.04 월","5259","12791","6267","6524",
"만덕1동","총인구","2020.05 월","5290","12864","6305","6559",
"만덕1동","총인구","2020.06 월","5298","12887","6320","6567",
"만덕1동","총인구","2020.07 월","5314","12908","6322","6586",
"만덕1동","총인구","2020.08 월","5316","12907","6326","6581",
"만덕1동","총인구","2020.09 월","5312","12878","6307","6571",
"만덕1동","총인구","2020.10 월","5328","12898","6317","6581",
"만덕1동","총인구","2020.11 월","5344","12907","6324","6583",
"만덕1동","총인구","2020.12 월","5347","12892","6315","6577",
"만덕1동","총인구","2021.01 월","5357","12904","6325","6579",
"만덕1동","총인구","2021.02 월","5364","12883","6310","6573",
"만덕1동","총인구","2021.03 월","5308","12797","6261","6536",
"만덕1동","총인구","2021.04 월","5559","13260","6497","6763",
"만덕1동","총인구","2021.05 월","6441","15204","7456","7748",
"만덕1동","총인구","2021.06 월","6866","16152","7906","8246",
"만덕1동","총인구","2021.07 월","7012","16472","8069","8403",
"만덕1동","총인구","2021.08 월","7073","16608","8130","8478",
"만덕1동","총인구","2021.09 월","7086","16626","8137","8489",
"만덕1동","총인구","2021.10 월","7096","16666","8179","8487",
"만덕1동","총인구","2021.11 월","7158","16708","8199","8509",
"만덕1동","총인구","2021.12 월","7165","16729","8197","8532",
"만덕1동","총인구","2022.01 월","7162","16722","8194","8528",
"만덕1동","총인구","2022.02 월","7173","16711","8192","8519",
"만덕1동","총인구","2022.03 월","7180","16726","8199","8527",
"만덕1동","총인구","2022.04 월","7193","16732","8204","8528",
"만덕1동","총인구","2022.05 월","7188","16711","8182","8529",
"만덕1동","총인구","2022.06 월","7201","16739","8187","8552",
"만덕1동","총인구","2022.07 월","7198","16720","8183","8537",
"만덕1동","총인구","2022.08 월","7206","16733","8183","8550",
"만덕1동","총인구","2022.09 월","7188","16706","8160","8546",
"만덕1동","총인구","2022.10 월","7167","16688","8149","8539",
"만덕1동","총인구","2022.11 월","7154","16660","8127","8533",
"만덕1동","총인구","2022.12 월","7158","16663","8125","8538",
"만덕1동","총인구","2023.01 월","7163","16686","8132","8554",
"만덕1동","총인구","2023.02 월","7159","16698","8140","8558",
"만덕1동","총인구","2023.03 월","7162","16697","8132","8565",
"만덕1동","총인구","2023.04 월","7158","16679","8127","8552",
"만덕1동","총인구","2023.05 월","7140","16625","8105","8520",
"만덕1동","총인구","2023.06 월","7124","16571","8084","8487",
"만덕1동","총인구","2023.07 월","7143","16591","8095","8496",
"만덕1동","총인구","2023.08 월","7141","16556","8069","8487",
"만덕1동","총인구","2023.09 월","7138","16542","8071","8471",
"만덕1동","총인구","2023.10 월","7133","16513","8061","8452",
"만덕1동","총인구","2023.11 월","7106","16467","8036","8431",
"만덕1동","총인구","2023.12 월","7104","16413","8006","8407",
"만덕1동","총인구","2024.01 월","7104","16358","7974","8384",
"만덕1동","총인구","2024.02 월","7109","16364","7964","8400",
"만덕1동","총인구","2024.03 월","7096","16341","7949","8392",
"만덕1동","총인구","2024.04 월","7093","16325","7940","8385",
"만덕1동","총인구","2024.05 월","7083","16285","7924","8361",
"만덕1동","총인구","2024.06 월","7086","16268","7911","8357",
"만덕1동","총인구","2024.07 월","7069","16245","7895","8350",
"만덕1동","총인구","2024.08 월","7067","16240","7899","8341",
"만덕1동","총인구","2024.09 월","7064","16201","7878","8323",
"만덕1동","총인구","2024.10 월","7059","16179","7862","8317",
"만덕1동","총인구","2024.11 월","7065","16171","7865","8306",
"만덕1동","총인구","2024.12 월","7055","16144","7846","8298",
"만덕2동","총인구","2020.01 월","10631","27848","13685","14163",
"만덕2동","총인구","2020.02 월","10622","27780","13643","14137",
"만덕2동","총인구","2020.03 월","10632","27734","13614","14120",
"만덕2동","총인구","2020.04 월","10620","27695","13584","14111",
"만덕2동","총인구","2020.05 월","10636","27698","13583","14115",
"만덕2동","총인구","2020.06 월","10639","27664","13571","14093",
"만덕2동","총인구","2020.07 월","10650","27625","13559","14066",
"만덕2동","총인구","2020.08 월","10654","27610","13557","14053",
"만덕2동","총인구","2020.09 월","10660","27585","13541","14044",
"만덕2동","총인구","2020.10 월","10651","27479","13503","13976",
"만덕2동","총인구","2020.11 월","10658","27400","13455","13945",
"만덕2동","총인구","2020.12 월","10673","27325","13415","13910",
"만덕2동","총인구","2021.01 월","10680","27262","13372","13890",
"만덕2동","총인구","2021.02 월","10704","27297","13375","13922",
"만덕2동","총인구","2021.03 월","10698","27240","13340","13900",
"만덕2동","총인구","2021.04 월","10689","27143","13285","13858",
"만덕2동","총인구","2021.05 월","10618","26818","13148","13670",
"만덕2동","총인구","2021.06 월","10591","26685","13090","13595",
"만덕2동","총인구","2021.07 월","10590","26635","13051","13584",
"만덕2동","총인구","2021.08 월","10593","26615","13038","13577",
"만덕2동","총인구","2021.09 월","10614","26635","13038","13597",
"만덕2동","총인구","2021.10 월","10621","26608","13031","13577",
"만덕2동","총인구","2021.11 월","10645","26614","13041","13573",
"만덕2동","총인구","2021.12 월","10660","26581","13027","13554",
"만덕2동","총인구","2022.01 월","10650","26479","12980","13499",
"만덕2동","총인구","2022.02 월","10643","26412","12944","13468",
"만덕2동","총인구","2022.03 월","10662","26393","12924","13469",
"만덕2동","총인구","2022.04 월","10693","26427","12948","13479",
"만덕2동","총인구","2022.05 월","10890","26744","13103","13641",
"만덕2동","총인구","2022.06 월","10994","26927","13193","13734",
"만덕2동","총인구","2022.07 월","11078","27079","13261","13818",
"만덕2동","총인구","2022.08 월","11145","27151","13288","13863",
"만덕2동","총인구","2022.09 월","11154","27148","13299","13849",
"만덕2동","총인구","2022.10 월","11166","27134","13285","13849",
"만덕2동","총인구","2022.11 월","11164","27137","13273","13864",
"만덕2동","총인구","2022.12 월","11136","27076","13246","13830",
"만덕2동","총인구","2023.01 월","11160","27103","13259","13844",
"만덕2동","총인구","2023.02 월","11143","27048","13212","13836",
"만덕2동","총인구","2023.03 월","11151","27016","13187","13829",
"만덕2동","총인구","2023.04 월","11158","26989","13175","13814",
"만덕2동","총인구","2023.05 월","11161","26974","13166","13808",
"만덕2동","총인구","2023.06 월","11165","26983","13177","13806",
"만덕2동","총인구","2023.07 월","11170","26974","13168","13806",
"만덕2동","총인구","2023.08 월","11162","26917","13130","13787",
"만덕2동","총인구","2023.09 월","11135","26806","13070","13736",
"만덕2동","총인구","2023.10 월","11118","26763","13049","13714",
"만덕2동","총인구","2023.11 월","11111","26720","13039","13681",
"만덕2동","총인구","2023.12 월","11102","26633","12985","13648",
"만덕2동","총인구","2024.01 월","11087","26551","12934","13617",
"만덕2동","총인구","2024.02 월","11090","26507","12905","13602",
"만덕2동","총인구","2024.03 월","11110","26517","12908","13609",
"만덕2동","총인구","2024.04 월","11084","26481","12880","13601",
"만덕2동","총인구","2024.05 월","11088","26458","12867","13591",
"만덕2동","총인구","2024.06 월","11081","26384","12835","13549",
"만덕2동","총인구","2024.07 월","11074","26317","12798","13519",
"만덕2동","총인구","2024.08 월","11077","26300","12788","13512",
"만덕2동","총인구","2024.09 월","11076","26252","12759","13493",
"만덕2동","총인구","2024.10 월","11041","26138","12698","13440",
"만덕2동","총인구","2024.11 월","11028","26121","12690","13431",
"만덕2동","총인구","2024.12 월","11019","26096","12685","13411",
"만덕3동","총인구","2020.01 월","7389","19577","9594","9983",
"만덕3동","총인구","2020.02 월","7403","19502","9545","9957",
"만덕3동","총인구","2020.03 월","7423","19467","9526","9941",
"만덕3동","총인구","2020.04 월","7424","19460","9516","9944",
"만덕3동","총인구","2020.05 월","7430","19434","9492","9942",
"만덕3동","총인구","2020.06 월","7446","19430","9494","9936",
"만덕3동","총인구","2020.07 월","7469","19403","9477","9926",
"만덕3동","총인구","2020.08 월","7463","19325","9441","9884",
"만덕3동","총인구","2020.09 월","7464","19316","9436","9880",
"만덕3동","총인구","2020.10 월","7468","19275","9415","9860",
"만덕3동","총인구","2020.11 월","7475","19273","9415","9858",
"만덕3동","총인구","2020.12 월","7472","19212","9388","9824",
"만덕3동","총인구","2021.01 월","7479","19224","9397","9827",
"만덕3동","총인구","2021.02 월","7467","19172","9352","9820",
"만덕3동","총인구","2021.03 월","7470","19132","9335","9797",
"만덕3동","총인구","2021.04 월","7471","19087","9311","9776",
"만덕3동","총인구","2021.05 월","7442","18987","9239","9748",
"만덕3동","총인구","2021.06 월","7432","18931","9204","9727",
"만덕3동","총인구","2021.07 월","7444","18923","9212","9711",
"만덕3동","총인구","2021.08 월","7439","18897","9202","9695",
"만덕3동","총인구","2021.09 월","7457","18851","9177","9674",
"만덕3동","총인구","2021.10 월","7454","18818","9159","9659",
"만덕3동","총인구","2021.11 월","7455","18770","9122","9648",
"만덕3동","총인구","2021.12 월","7449","18724","9099","9625",
"만덕3동","총인구","2022.01 월","7447","18671","9081","9590",
"만덕3동","총인구","2022.02 월","7455","18645","9064","9581",
"만덕3동","총인구","2022.03 월","7448","18583","9044","9539",
"만덕3동","총인구","2022.04 월","7447","18528","9015","9513",
"만덕3동","총인구","2022.05 월","7441","18485","8998","9487",
"만덕3동","총인구","2022.06 월","7433","18439","8980","9459",
"만덕3동","총인구","2022.07 월","7440","18423","8965","9458",
"만덕3동","총인구","2022.08 월","7448","18398","8955","9443",
"만덕3동","총인구","2022.09 월","7421","18323","8913","9410",
"만덕3동","총인구","2022.10 월","7425","18337","8915","9422",
"만덕3동","총인구","2022.11 월","7405","18269","8892","9377",
"만덕3동","총인구","2022.12 월","7408","18253","8881","9372",
"만덕3동","총인구","2023.01 월","7409","18225","8852","9373",
"만덕3동","총인구","2023.02 월","7407","18199","8838","9361",
"만덕3동","총인구","2023.03 월","7396","18150","8821","9329",
"만덕3동","총인구","2023.04 월","7395","18136","8803","9333",
"만덕3동","총인구","2023.05 월","7390","18077","8781","9296",
"만덕3동","총인구","2023.06 월","7393","18048","8764","9284",
"만덕3동","총인구","2023.07 월","7390","18037","8753","9284",
"만덕3동","총인구","2023.08 월","7364","17964","8712","9252",
"만덕3동","총인구","2023.09 월","7359","17957","8704","9253",
"만덕3동","총인구","2023.10 월","7340","17877","8663","9214",
"만덕3동","총인구","2023.11 월","7330","17826","8636","9190",
"만덕3동","총인구","2023.12 월","7320","17779","8595","9184",
"만덕3동","총인구","2024.01 월","7297","17667","8545","9122",
"만덕3동","총인구","2024.02 월","7285","17599","8505","9094",
"만덕3동","총인구","2024.03 월","7289","17578","8496","9082",
"만덕3동","총인구","2024.04 월","7288","17548","8475","9073",
"만덕3동","총인구","2024.05 월","7297","17551","8468","9083",
"만덕3동","총인구","2024.06 월","7289","17515","8443","9072",
"만덕3동","총인구","2024.07 월","7289","17508","8433","9075",
"만덕3동","총인구","2024.08 월","7284","17463","8423","9040",
"만덕3동","총인구","2024.09 월","7292","17480","8423","9057",
"만덕3동","총인구","2024.10 월","7280","17408","8386","9022",
"만덕3동","총인구","2024.11 월","7257","17344","8357","8987",
"만덕3동","총인구","2024.12 월","7262","17309","8341","8968",
"해운대구","총인구","2020.01 월","168851","411497","198570","212927",
"해운대구","총인구","2020.02 월","168916","410898","198269","212629",
"해운대구","총인구","2020.03 월","169141","410223","197881","212342",
"해운대구","총인구","2020.04 월","169357","410242","197838","212404",
"해운대구","총인구","2020.05 월","169532","409307","197310","211997",
"해운대구","총인구","2020.06 월","169825","408732","196993","211739",
"해운대구","총인구","2020.07 월","170255","408611","196894","211717",
"해운대구","총인구","2020.08 월","170290","407804","196437","211367",
"해운대구","총인구","2020.09 월","170518","407443","196191","211252",
"해운대구","총인구","2020.10 월","170815","407484","196175","211309",
"해운대구","총인구","2020.11 월","171099","407182","196040","211142",
"해운대구","총인구","2020.12 월","171376","406818","195883","210935",
"해운대구","총인구","2021.01 월","171528","406349","195600","210749",
"해운대구","총인구","2021.02 월","171770","405922","195335","210587",
"해운대구","총인구","2021.03 월","171352","404748","194836","209912",
"해운대구","총인구","2021.04 월","171558","404514","194679","209835",
"해운대구","총인구","2021.05 월","171558","403908","194388","209520",
"해운대구","총인구","2021.06 월","171791","403635","194245","209390",
"해운대구","총인구","2021.07 월","171911","403262","194033","209229",
"해운대구","총인구","2021.08 월","172076","402709","193728","208981",
"해운대구","총인구","2021.09 월","172237","402554","193562","208992",
"해운대구","총인구","2021.10 월","172349","402195","193432","208763",
"해운대구","총인구","2021.11 월","172455","401778","193218","208560",
"해운대구","총인구","2021.12 월","172397","401131","192901","208230",
"해운대구","총인구","2022.01 월","172327","400488","192518","207970",
"해운대구","총인구","2022.02 월","172279","399486","191987","207499",
"해운대구","총인구","2022.03 월","172227","398483","191470","207013",
"해운대구","총인구","2022.04 월","172217","397957","191257","206700",
"해운대구","총인구","2022.05 월","172126","396931","190686","206245",
"해운대구","총인구","2022.06 월","171960","396120","190250","205870",
"해운대구","총인구","2022.07 월","172005","395601","189985","205616",
"해운대구","총인구","2022.08 월","171837","394626","189458","205168",
"해운대구","총인구","2022.09 월","170998","393151","188716","204435",
"해운대구","총인구","2022.10 월","170828","392763","188511","204252",
"해운대구","총인구","2022.11 월","170637","392291","188227","204064",
"해운대구","총인구","2022.12 월","170435","391763","187958","203805",
"해운대구","총인구","2023.01 월","170261","391279","187735","203544",
"해운대구","총인구","2023.02 월","170331","390489","187324","203165",
"해운대구","총인구","2023.03 월","170251","389843","186999","202844",
"해운대구","총인구","2023.04 월","170185","389361","186762","202599",
"해운대구","총인구","2023.05 월","170221","389117","186620","202497",
"해운대구","총인구","2023.06 월","170143","388452","186312","202140",
"해운대구","총인구","2023.07 월","170207","388123","186156","201967",
"해운대구","총인구","2023.08 월","170087","387499","185774","201725",
"해운대구","총인구","2023.09 월","170022","387193","185613","201580",
"해운대구","총인구","2023.10 월","169820","386622","185305","201317",
"해운대구","총인구","2023.11 월","169633","386185","185131","201054",
"해운대구","총인구","2023.12 월","169532","385618","184825","200793",
"해운대구","총인구","2024.01 월","169375","385015","184495","200520",
"해운대구","총인구","2024.02 월","169282","383960","183992","199968",
"해운대구","총인구","2024.03 월","169193","383255","183668","199587",
"해운대구","총인구","2024.04 월","169165","382904","183484","199420",
"해운대구","총인구","2024.05 월","169067","382370","183235","199135",
"해운대구","총인구","2024.06 월","169102","382082","183092","198990",
"해운대구","총인구","2024.07 월","169499","382425","183237","199188",
"해운대구","총인구","2024.08 월","169707","382543","183303","199240",
"해운대구","총인구","2024.09 월","169827","382498","183319","199179",
"해운대구","총인구","2024.10 월","169697","382102","183148","198954",
"해운대구","총인구","2024.11 월","169675","381964","183019","198945",
"해운대구","총인구","2024.12 월","169821","381936","182995","198941",
"우1동","총인구","2020.01 월","10902","23860","11452","12408",
"우1동","총인구","2020.02 월","10942","23911","11454","12457",
"우1동","총인구","2020.03 월","10987","23926","11455","12471",
"우1동","총인구","2020.04 월","10995","23903","11437","12466",
"우1동","총인구","2020.05 월","11014","23881","11434","12447",
"우1동","총인구","2020.06 월","10998","23823","11420","12403",
"우1동","총인구","2020.07 월","10995","23787","11397","12390",
"우1동","총인구","2020.08 월","11015","23769","11371","12398",
"우1동","총인구","2020.09 월","10984","23689","11327","12362",
"우1동","총인구","2020.10 월","10945","23563","11256","12307",
"우1동","총인구","2020.11 월","10954","23512","11222","12290",
"우1동","총인구","2020.12 월","10962","23453","11167","12286",
"우1동","총인구","2021.01 월","10955","23354","11110","12244",
"우1동","총인구","2021.02 월","10951","23268","11084","12184",
"우1동","총인구","2021.03 월","10960","23276","11088","12188",
"우1동","총인구","2021.04 월","10983","23240","11060","12180",
"우1동","총인구","2021.05 월","10900","23076","11003","12073",
"우1동","총인구","2021.06 월","10911","23046","10984","12062",
"우1동","총인구","2021.07 월","10923","23034","10975","12059",
"우1동","총인구","2021.08 월","10929","22979","10944","12035",
"우1동","총인구","2021.09 월","10942","22970","10927","12043",
"우1동","총인구","2021.10 월","10928","22923","10911","12012",
"우1동","총인구","2021.11 월","10940","22927","10907","12020",
"우1동","총인구","2021.12 월","10903","22844","10869","11975",
"우1동","총인구","2022.01 월","10897","22811","10850","11961",
"우1동","총인구","2022.02 월","10887","22718","10808","11910",
"우1동","총인구","2022.03 월","10876","22622","10753","11869",
"우1동","총인구","2022.04 월","10861","22645","10772","11873",
"우1동","총인구","2022.05 월","10856","22593","10740","11853",
"우1동","총인구","2022.06 월","10821","22519","10707","11812",
"우1동","총인구","2022.07 월","10812","22477","10674","11803",
"우1동","총인구","2022.08 월","10806","22378","10614","11764",
"우1동","총인구","2022.09 월","10638","22125","10478","11647",
"우1동","총인구","2022.10 월","10587","22016","10437","11579",
"우1동","총인구","2022.11 월","10611","22176","10509","11667",
"우1동","총인구","2022.12 월","10682","22405","10622","11783",
"우1동","총인구","2023.01 월","10716","22490","10654","11836",
"우1동","총인구","2023.02 월","10741","22528","10656","11872",
"우1동","총인구","2023.03 월","10771","22610","10713","11897",
"우1동","총인구","2023.04 월","10770","22625","10734","11891",
"우1동","총인구","2023.05 월","10785","22720","10788","11932",
"우1동","총인구","2023.06 월","10772","22681","10772","11909",
"우1동","총인구","2023.07 월","10804","22722","10781","11941",
"우1동","총인구","2023.08 월","10824","22714","10774","11940",
"우1동","총인구","2023.09 월","10818","22681","10751","11930",
"우1동","총인구","2023.10 월","10824","22641","10739","11902",
"우1동","총인구","2023.11 월","10822","22636","10735","11901",
"우1동","총인구","2023.12 월","10808","22611","10712","11899",
"우1동","총인구","2024.01 월","10764","22465","10645","11820",
"우1동","총인구","2024.02 월","10748","22378","10599","11779",
"우1동","총인구","2024.03 월","10748","22354","10567","11787",
"우1동","총인구","2024.04 월","10740","22351","10565","11786",
"우1동","총인구","2024.05 월","10728","22314","10542","11772",
"우1동","총인구","2024.06 월","10797","22516","10645","11871",
"우1동","총인구","2024.07 월","10948","22904","10844","12060",
"우1동","총인구","2024.08 월","11090","23252","11013","12239",
"우1동","총인구","2024.09 월","11187","23478","11111","12367",
"우1동","총인구","2024.10 월","11278","23678","11230","12448",
"우1동","총인구","2024.11 월","11329","23827","11301","12526",
"우1동","총인구","2024.12 월","11401","23957","11360","12597",
"우2동","총인구","2020.01 월","11736","31815","15245","16570",
"우2동","총인구","2020.02 월","11701","31727","15210","16517",
"우2동","총인구","2020.03 월","11703","31628","15181","16447",
"우2동","총인구","2020.04 월","11727","31676","15191","16485",
"우2동","총인구","2020.05 월","11728","31599","15146","16453",
"우2동","총인구","2020.06 월","11742","31566","15102","16464",
"우2동","총인구","2020.07 월","11782","31562","15071","16491",
"우2동","총인구","2020.08 월","11810","31586","15083","16503",
"우2동","총인구","2020.09 월","11821","31502","15061","16441",
"우2동","총인구","2020.10 월","11849","31568","15079","16489",
"우2동","총인구","2020.11 월","11882","31563","15058","16505",
"우2동","총인구","2020.12 월","11922","31563","15041","16522",
"우2동","총인구","2021.01 월","11946","31631","15071","16560",
"우2동","총인구","2021.02 월","11979","31678","15094","16584",
"우2동","총인구","2021.03 월","11953","31566","15058","16508",
"우2동","총인구","2021.04 월","11972","31568","15044","16524",
"우2동","총인구","2021.05 월","11883","31372","14957","16415",
"우2동","총인구","2021.06 월","11891","31327","14943","16384",
"우2동","총인구","2021.07 월","11886","31295","14927","16368",
"우2동","총인구","2021.08 월","11875","31194","14879","16315",
"우2동","총인구","2021.09 월","11862","31166","14862","16304",
"우2동","총인구","2021.10 월","11870","31100","14834","16266",
"우2동","총인구","2021.11 월","11846","31012","14792","16220",
"우2동","총인구","2021.12 월","11855","30996","14782","16214",
"우2동","총인구","2022.01 월","11853","31024","14774","16250",
"우2동","총인구","2022.02 월","11831","30906","14711","16195",
"우2동","총인구","2022.03 월","11867","30894","14701","16193",
"우2동","총인구","2022.04 월","11924","30969","14724","16245",
"우2동","총인구","2022.05 월","11958","30950","14717","16233",
"우2동","총인구","2022.06 월","11975","30996","14748","16248",
"우2동","총인구","2022.07 월","11984","30987","14734","16253",
"우2동","총인구","2022.08 월","11977","30941","14712","16229",
"우2동","총인구","2022.09 월","11934","30878","14702","16176",
"우2동","총인구","2022.10 월","11912","30809","14669","16140",
"우2동","총인구","2022.11 월","11900","30758","14641","16117",
"우2동","총인구","2022.12 월","11880","30687","14596","16091",
"우2동","총인구","2023.01 월","11860","30670","14583","16087",
"우2동","총인구","2023.02 월","11860","30624","14536","16088",
"우2동","총인구","2023.03 월","11862","30589","14521","16068",
"우2동","총인구","2023.04 월","11868","30567","14504","16063",
"우2동","총인구","2023.05 월","11872","30585","14512","16073",
"우2동","총인구","2023.06 월","11868","30574","14491","16083",
"우2동","총인구","2023.07 월","11885","30590","14493","16097",
"우2동","총인구","2023.08 월","11884","30544","14476","16068",
"우2동","총인구","2023.09 월","11895","30539","14476","16063",
"우2동","총인구","2023.10 월","11886","30484","14442","16042",
"우2동","총인구","2023.11 월","11886","30481","14443","16038",
"우2동","총인구","2023.12 월","11887","30428","14415","16013",
"우2동","총인구","2024.01 월","11887","30510","14493","16017",
"우2동","총인구","2024.02 월","11872","30374","14427","15947",
"우2동","총인구","2024.03 월","11884","30344","14418","15926",
"우2동","총인구","2024.04 월","11873","30336","14407","15929",
"우2동","총인구","2024.05 월","11873","30312","14395","15917",
"우2동","총인구","2024.06 월","11886","30303","14381","15922",
"우2동","총인구","2024.07 월","11869","30177","14303","15874",
"우2동","총인구","2024.08 월","11847","30101","14262","15839",
"우2동","총인구","2024.09 월","11838","30042","14248","15794",
"우2동","총인구","2024.10 월","11843","30035","14244","15791",
"우2동","총인구","2024.11 월","11820","29968","14225","15743",
"우2동","총인구","2024.12 월","11839","30014","14264","15750",
"우3동","총인구","2020.01 월","10565","29122","13731","15391",
"우3동","총인구","2020.02 월","10592","29177","13765","15412",
"우3동","총인구","2020.03 월","10624","29201","13777","15424",
"우3동","총인구","2020.04 월","10658","29262","13806","15456",
"우3동","총인구","2020.05 월","10677","29232","13789","15443",
"우3동","총인구","2020.06 월","10695","29197","13784","15413",
"우3동","총인구","2020.07 월","10726","29243","13796","15447",
"우3동","총인구","2020.08 월","10735","29199","13768","15431",
"우3동","총인구","2020.09 월","10764","29247","13791","15456",
"우3동","총인구","2020.10 월","10787","29313","13847","15466",
"우3동","총인구","2020.11 월","10797","29315","13865","15450",
"우3동","총인구","2020.12 월","10830","29378","13922","15456",
"우3동","총인구","2021.01 월","10857","29455","13977","15478",
"우3동","총인구","2021.02 월","10891","29491","14013","15478",
"우3동","총인구","2021.03 월","10899","29467","14003","15464",
"우3동","총인구","2021.04 월","10910","29462","13997","15465",
"우3동","총인구","2021.05 월","10935","29506","14001","15505",
"우3동","총인구","2021.06 월","10942","29484","13991","15493",
"우3동","총인구","2021.07 월","10958","29542","14017","15525",
"우3동","총인구","2021.08 월","10971","29514","13995","15519",
"우3동","총인구","2021.09 월","10979","29560","14006","15554",
"우3동","총인구","2021.10 월","10984","29618","14039","15579",
"우3동","총인구","2021.11 월","11003","29652","14053","15599",
"우3동","총인구","2021.12 월","10989","29594","14023","15571",
"우3동","총인구","2022.01 월","10979","29536","13984","15552",
"우3동","총인구","2022.02 월","10940","29411","13915","15496",
"우3동","총인구","2022.03 월","10932","29354","13902","15452",
"우3동","총인구","2022.04 월","10942","29349","13906","15443",
"우3동","총인구","2022.05 월","10934","29268","13873","15395",
"우3동","총인구","2022.06 월","10950","29278","13874","15404",
"우3동","총인구","2022.07 월","10948","29255","13858","15397",
"우3동","총인구","2022.08 월","10950","29227","13844","15383",
"우3동","총인구","2022.09 월","10923","29185","13819","15366",
"우3동","총인구","2022.10 월","10915","29219","13828","15391",
"우3동","총인구","2022.11 월","10916","29210","13819","15391",
"우3동","총인구","2022.12 월","10901","29166","13791","15375",
"우3동","총인구","2023.01 월","10892","29150","13793","15357",
"우3동","총인구","2023.02 월","10890","29051","13746","15305",
"우3동","총인구","2023.03 월","10880","28964","13705","15259",
"우3동","총인구","2023.04 월","10876","28932","13691","15241",
"우3동","총인구","2023.05 월","10863","28905","13662","15243",
"우3동","총인구","2023.06 월","10854","28826","13629","15197",
"우3동","총인구","2023.07 월","10846","28757","13604","15153",
"우3동","총인구","2023.08 월","10841","28729","13580","15149",
"우3동","총인구","2023.09 월","10848","28768","13598","15170",
"우3동","총인구","2023.10 월","10856","28761","13581","15180",
"우3동","총인구","2023.11 월","10865","28787","13601","15186",
"우3동","총인구","2023.12 월","10873","28781","13589","15192",
"우3동","총인구","2024.01 월","10879","28802","13601","15201",
"우3동","총인구","2024.02 월","10882","28747","13575","15172",
"우3동","총인구","2024.03 월","10879","28722","13575","15147",
"우3동","총인구","2024.04 월","10865","28699","13564","15135",
"우3동","총인구","2024.05 월","10881","28700","13560","15140",
"우3동","총인구","2024.06 월","10894","28703","13564","15139",
"우3동","총인구","2024.07 월","10903","28723","13573","15150",
"우3동","총인구","2024.08 월","10916","28740","13581","15159",
"우3동","총인구","2024.09 월","10924","28755","13597","15158",
"우3동","총인구","2024.10 월","10926","28757","13611","15146",
"우3동","총인구","2024.11 월","10929","28798","13623","15175",
"우3동","총인구","2024.12 월","10918","28763","13603","15160",
"중1동","총인구","2020.01 월","10191","24096","11673","12423",
"중1동","총인구","2020.02 월","10377","24521","11895","12626",
"중1동","총인구","2020.03 월","10472","24740","11988","12752",
"중1동","총인구","2020.04 월","10593","24945","12070","12875",
"중1동","총인구","2020.05 월","10653","24996","12069","12927",
"중1동","총인구","2020.06 월","10716","25080","12095","12985",
"중1동","총인구","2020.07 월","10820","25252","12176","13076",
"중1동","총인구","2020.08 월","10858","25265","12175","13090",
"중1동","총인구","2020.09 월","11020","25626","12337","13289",
"중1동","총인구","2020.10 월","11284","26286","12648","13638",
"중1동","총인구","2020.11 월","11441","26656","12845","13811",
"중1동","총인구","2020.12 월","11566","27023","13057","13966",
"중1동","총인구","2021.01 월","11613","27208","13151","14057",
"중1동","총인구","2021.02 월","11679","27295","13174","14121",
"중1동","총인구","2021.03 월","11669","27345","13194","14151",
"중1동","총인구","2021.04 월","11725","27437","13241","14196",
"중1동","총인구","2021.05 월","11793","27476","13267","14209",
"중1동","총인구","2021.06 월","11941","27802","13421","14381",
"중1동","총인구","2021.07 월","12030","27983","13511","14472",
"중1동","총인구","2021.08 월","12078","28077","13561","14516",
"중1동","총인구","2021.09 월","12119","28113","13567","14546",
"중1동","총인구","2021.10 월","12144","28155","13581","14574",
"중1동","총인구","2021.11 월","12197","28235","13615","14620",
"중1동","총인구","2021.12 월","12241","28318","13627","14691",
"중1동","총인구","2022.01 월","12263","28342","13651","14691",
"중1동","총인구","2022.02 월","12365","28475","13701","14774",
"중1동","총인구","2022.03 월","12402","28493","13696","14797",
"중1동","총인구","2022.04 월","12403","28482","13710","14772",
"중1동","총인구","2022.05 월","12395","28472","13699","14773",
"중1동","총인구","2022.06 월","12391","28419","13668","14751",
"중1동","총인구","2022.07 월","12403","28416","13673","14743",
"중1동","총인구","2022.08 월","12401","28356","13625","14731",
"중1동","총인구","2022.09 월","12348","28255","13573","14682",
"중1동","총인구","2022.10 월","12349","28189","13530","14659",
"중1동","총인구","2022.11 월","12340","28161","13497","14664",
"중1동","총인구","2022.12 월","12311","28067","13428","14639",
"중1동","총인구","2023.01 월","12288","27994","13397","14597",
"중1동","총인구","2023.02 월","12281","27975","13405","14570",
"중1동","총인구","2023.03 월","12281","27959","13399","14560",
"중1동","총인구","2023.04 월","12276","27930","13392","14538",
"중1동","총인구","2023.05 월","12293","27944","13415","14529",
"중1동","총인구","2023.06 월","12299","27933","13405","14528",
"중1동","총인구","2023.07 월","12301","27929","13383","14546",
"중1동","총인구","2023.08 월","12282","27945","13390","14555",
"중1동","총인구","2023.09 월","12245","27882","13363","14519",
"중1동","총인구","2023.10 월","12226","27860","13359","14501",
"중1동","총인구","2023.11 월","12228","27891","13371","14520",
"중1동","총인구","2023.12 월","12228","27854","13342","14512",
"중1동","총인구","2024.01 월","12278","27897","13343","14554",
"중1동","총인구","2024.02 월","12291","27878","13358","14520",
"중1동","총인구","2024.03 월","12296","27815","13329","14486",
"중1동","총인구","2024.04 월","12329","27850","13334","14516",
"중1동","총인구","2024.05 월","12337","27873","13332","14541",
"중1동","총인구","2024.06 월","12337","27827","13295","14532",
"중1동","총인구","2024.07 월","12353","27807","13281","14526",
"중1동","총인구","2024.08 월","12337","27765","13277","14488",
"중1동","총인구","2024.09 월","12330","27724","13267","14457",
"중1동","총인구","2024.10 월","12291","27619","13209","14410",
"중1동","총인구","2024.11 월","12312","27718","13239","14479",
"중1동","총인구","2024.12 월","12336","27758","13244","14514",
"중2동","총인구","2020.01 월","7236","16293","7806","8487",
"중2동","총인구","2020.02 월","7246","16294","7808","8486",
"중2동","총인구","2020.03 월","7241","16251","7771","8480",
"중2동","총인구","2020.04 월","7250","16278","7783","8495",
"중2동","총인구","2020.05 월","7246","16210","7744","8466",
"중2동","총인구","2020.06 월","7257","16173","7721","8452",
"중2동","총인구","2020.07 월","7251","16154","7723","8431",
"중2동","총인구","2020.08 월","7276","16183","7715","8468",
"중2동","총인구","2020.09 월","7279","16169","7709","8460",
"중2동","총인구","2020.10 월","7303","16167","7706","8461",
"중2동","총인구","2020.11 월","7323","16178","7709","8469",
"중2동","총인구","2020.12 월","7341","16218","7730","8488",
"중2동","총인구","2021.01 월","7378","16258","7747","8511",
"중2동","총인구","2021.02 월","7404","16298","7753","8545",
"중2동","총인구","2021.03 월","7408","16292","7749","8543",
"중2동","총인구","2021.04 월","7419","16285","7748","8537",
"중2동","총인구","2021.05 월","7426","16298","7753","8545",
"중2동","총인구","2021.06 월","7441","16289","7747","8542",
"중2동","총인구","2021.07 월","7469","16295","7750","8545",
"중2동","총인구","2021.08 월","7466","16245","7729","8516",
"중2동","총인구","2021.09 월","7465","16217","7736","8481",
"중2동","총인구","2021.10 월","7487","16225","7737","8488",
"중2동","총인구","2021.11 월","7511","16256","7759","8497",
"중2동","총인구","2021.12 월","7536","16290","7788","8502",
"중2동","총인구","2022.01 월","7528","16259","7779","8480",
"중2동","총인구","2022.02 월","7514","16239","7773","8466",
"중2동","총인구","2022.03 월","7502","16215","7751","8464",
"중2동","총인구","2022.04 월","7495","16192","7747","8445",
"중2동","총인구","2022.05 월","7483","16136","7706","8430",
"중2동","총인구","2022.06 월","7485","16137","7710","8427",
"중2동","총인구","2022.07 월","7515","16179","7731","8448",
"중2동","총인구","2022.08 월","7510","16179","7736","8443",
"중2동","총인구","2022.09 월","7425","16019","7659","8360",
"중2동","총인구","2022.10 월","7412","15980","7631","8349",
"중2동","총인구","2022.11 월","7405","15952","7621","8331",
"중2동","총인구","2022.12 월","7369","15891","7603","8288",
"중2동","총인구","2023.01 월","7364","15918","7620","8298",
"중2동","총인구","2023.02 월","7372","15885","7609","8276",
"중2동","총인구","2023.03 월","7342","15803","7572","8231",
"중2동","총인구","2023.04 월","7332","15730","7523","8207",
"중2동","총인구","2023.05 월","7315","15695","7494","8201",
"중2동","총인구","2023.06 월","7309","15669","7482","8187",
"중2동","총인구","2023.07 월","7305","15655","7479","8176",
"중2동","총인구","2023.08 월","7278","15580","7438","8142",
"중2동","총인구","2023.09 월","7260","15545","7407","8138",
"중2동","총인구","2023.10 월","7259","15543","7424","8119",
"중2동","총인구","2023.11 월","7269","15560","7436","8124",
"중2동","총인구","2023.12 월","7272","15613","7473","8140",
"중2동","총인구","2024.01 월","7258","15552","7438","8114",
"중2동","총인구","2024.02 월","7245","15537","7439","8098",
"중2동","총인구","2024.03 월","7257","15560","7446","8114",
"중2동","총인구","2024.04 월","7255","15570","7454","8116",
"중2동","총인구","2024.05 월","7242","15528","7434","8094",
"중2동","총인구","2024.06 월","7252","15533","7431","8102",
"중2동","총인구","2024.07 월","7277","15575","7453","8122",
"중2동","총인구","2024.08 월","7283","15558","7441","8117",
"중2동","총인구","2024.09 월","7301","15585","7456","8129",
"중2동","총인구","2024.10 월","7292","15552","7447","8105",
"중2동","총인구","2024.11 월","7291","15508","7425","8083",
"중2동","총인구","2024.12 월","7302","15518","7422","8096",
"좌1동","총인구","2020.01 월","7550","18660","8747","9913",
"좌1동","총인구","2020.02 월","7575","18635","8735","9900",
"좌1동","총인구","2020.03 월","7591","18598","8724","9874",
"좌1동","총인구","2020.04 월","7590","18586","8715","9871",
"좌1동","총인구","2020.05 월","7586","18552","8699","9853",
"좌1동","총인구","2020.06 월","7614","18552","8713","9839",
"좌1동","총인구","2020.07 월","7626","18517","8686","9831",
"좌1동","총인구","2020.08 월","7618","18490","8662","9828",
"좌1동","총인구","2020.09 월","7628","18457","8639","9818",
"좌1동","총인구","2020.10 월","7643","18431","8613","9818",
"좌1동","총인구","2020.11 월","7636","18389","8602","9787",
"좌1동","총인구","2020.12 월","7670","18393","8593","9800",
"좌1동","총인구","2021.01 월","7681","18390","8602","9788",
"좌1동","총인구","2021.02 월","7705","18389","8610","9779",
"좌1동","총인구","2021.03 월","7705","18328","8573","9755",
"좌1동","총인구","2021.04 월","7727","18342","8577","9765",
"좌1동","총인구","2021.05 월","7745","18352","8583","9769",
"좌1동","총인구","2021.06 월","7761","18328","8567","9761",
"좌1동","총인구","2021.07 월","7780","18263","8538","9725",
"좌1동","총인구","2021.08 월","7804","18268","8535","9733",
"좌1동","총인구","2021.09 월","7815","18261","8519","9742",
"좌1동","총인구","2021.10 월","7814","18243","8509","9734",
"좌1동","총인구","2021.11 월","7820","18253","8507","9746",
"좌1동","총인구","2021.12 월","7811","18221","8485","9736",
"좌1동","총인구","2022.01 월","7805","18168","8444","9724",
"좌1동","총인구","2022.02 월","7829","18157","8433","9724",
"좌1동","총인구","2022.03 월","7806","18095","8387","9708",
"좌1동","총인구","2022.04 월","7808","18044","8362","9682",
"좌1동","총인구","2022.05 월","7806","17987","8348","9639",
"좌1동","총인구","2022.06 월","7802","17987","8349","9638",
"좌1동","총인구","2022.07 월","7810","17939","8336","9603",
"좌1동","총인구","2022.08 월","7803","17907","8329","9578",
"좌1동","총인구","2022.09 월","7753","17811","8289","9522",
"좌1동","총인구","2022.10 월","7742","17788","8280","9508",
"좌1동","총인구","2022.11 월","7741","17772","8264","9508",
"좌1동","총인구","2022.12 월","7732","17747","8259","9488",
"좌1동","총인구","2023.01 월","7718","17746","8254","9492",
"좌1동","총인구","2023.02 월","7744","17735","8235","9500",
"좌1동","총인구","2023.03 월","7737","17695","8228","9467",
"좌1동","총인구","2023.04 월","7746","17688","8228","9460",
"좌1동","총인구","2023.05 월","7744","17666","8225","9441",
"좌1동","총인구","2023.06 월","7737","17643","8212","9431",
"좌1동","총인구","2023.07 월","7755","17659","8227","9432",
"좌1동","총인구","2023.08 월","7742","17598","8207","9391",
"좌1동","총인구","2023.09 월","7736","17574","8192","9382",
"좌1동","총인구","2023.10 월","7723","17546","8181","9365",
"좌1동","총인구","2023.11 월","7719","17525","8168","9357",
"좌1동","총인구","2023.12 월","7726","17515","8158","9357",
"좌1동","총인구","2024.01 월","7718","17519","8158","9361",
"좌1동","총인구","2024.02 월","7736","17491","8136","9355",
"좌1동","총인구","2024.03 월","7740","17460","8122","9338",
"좌1동","총인구","2024.04 월","7721","17410","8103","9307",
"좌1동","총인구","2024.05 월","7729","17409","8111","9298",
"좌1동","총인구","2024.06 월","7725","17365","8107","9258",
"좌1동","총인구","2024.07 월","7728","17322","8087","9235",
"좌1동","총인구","2024.08 월","7720","17282","8070","9212",
"좌1동","총인구","2024.09 월","7719","17277","8074","9203",
"좌1동","총인구","2024.10 월","7681","17230","8032","9198",
"좌1동","총인구","2024.11 월","7683","17191","8000","9191",
"좌1동","총인구","2024.12 월","7686","17195","8001","9194",
"좌2동","총인구","2020.01 월","13781","33087","15300","17787",
"좌2동","총인구","2020.02 월","13790","33016","15292","17724",
"좌2동","총인구","2020.03 월","13792","32899","15204","17695",
"좌2동","총인구","2020.04 월","13783","32836","15174","17662",
"좌2동","총인구","2020.05 월","13791","32789","15154","17635",
"좌2동","총인구","2020.06 월","13827","32756","15153","17603",
"좌2동","총인구","2020.07 월","13858","32751","15150","17601",
"좌2동","총인구","2020.08 월","13865","32654","15093","17561",
"좌2동","총인구","2020.09 월","13860","32610","15071","17539",
"좌2동","총인구","2020.10 월","13877","32554","15042","17512",
"좌2동","총인구","2020.11 월","13901","32524","15031","17493",
"좌2동","총인구","2020.12 월","13918","32495","15017","17478",
"좌2동","총인구","2021.01 월","13945","32476","15010","17466",
"좌2동","총인구","2021.02 월","14001","32497","14991","17506",
"좌2동","총인구","2021.03 월","14019","32495","14988","17507",
"좌2동","총인구","2021.04 월","14041","32531","15003","17528",
"좌2동","총인구","2021.05 월","14069","32531","15004","17527",
"좌2동","총인구","2021.06 월","14064","32429","14961","17468",
"좌2동","총인구","2021.07 월","14081","32415","14961","17454",
"좌2동","총인구","2021.08 월","14089","32383","14955","17428",
"좌2동","총인구","2021.09 월","14126","32396","14932","17464",
"좌2동","총인구","2021.10 월","14146","32369","14912","17457",
"좌2동","총인구","2021.11 월","14181","32370","14911","17459",
"좌2동","총인구","2021.12 월","14180","32323","14910","17413",
"좌2동","총인구","2022.01 월","14192","32294","14897","17397",
"좌2동","총인구","2022.02 월","14217","32214","14866","17348",
"좌2동","총인구","2022.03 월","14204","32080","14816","17264",
"좌2동","총인구","2022.04 월","14223","32077","14827","17250",
"좌2동","총인구","2022.05 월","14210","31986","14784","17202",
"좌2동","총인구","2022.06 월","14186","31893","14745","17148",
"좌2동","총인구","2022.07 월","14221","31893","14733","17160",
"좌2동","총인구","2022.08 월","14220","31804","14688","17116",
"좌2동","총인구","2022.09 월","14176","31659","14618","17041",
"좌2동","총인구","2022.10 월","14166","31638","14601","17037",
"좌2동","총인구","2022.11 월","14158","31606","14593","17013",
"좌2동","총인구","2022.12 월","14157","31539","14576","16963",
"좌2동","총인구","2023.01 월","14170","31544","14573","16971",
"좌2동","총인구","2023.02 월","14169","31461","14530","16931",
"좌2동","총인구","2023.03 월","14164","31392","14491","16901",
"좌2동","총인구","2023.04 월","14159","31330","14452","16878",
"좌2동","총인구","2023.05 월","14158","31278","14411","16867",
"좌2동","총인구","2023.06 월","14148","31210","14404","16806",
"좌2동","총인구","2023.07 월","14172","31208","14406","16802",
"좌2동","총인구","2023.08 월","14178","31180","14377","16803",
"좌2동","총인구","2023.09 월","14173","31152","14373","16779",
"좌2동","총인구","2023.10 월","14131","31077","14327","16750",
"좌2동","총인구","2023.11 월","14085","31019","14303","16716",
"좌2동","총인구","2023.12 월","14110","30995","14285","16710",
"좌2동","총인구","2024.01 월","14117","30959","14270","16689",
"좌2동","총인구","2024.02 월","14105","30867","14201","16666",
"좌2동","총인구","2024.03 월","14108","30836","14167","16669",
"좌2동","총인구","2024.04 월","14119","30801","14163","16638",
"좌2동","총인구","2024.05 월","14115","30776","14171","16605",
"좌2동","총인구","2024.06 월","14108","30726","14138","16588",
"좌2동","총인구","2024.07 월","14121","30672","14106","16566",
"좌2동","총인구","2024.08 월","14100","30574","14055","16519",
"좌2동","총인구","2024.09 월","14095","30531","14035","16496",
"좌2동","총인구","2024.10 월","14076","30482","14005","16477",
"좌2동","총인구","2024.11 월","14082","30481","13999","16482",
"좌2동","총인구","2024.12 월","14110","30502","14020","16482",
"좌3동","총인구","2020.01 월","6369","17049","8065","8984",
"좌3동","총인구","2020.02 월","6373","17035","8048","8987",
"좌3동","총인구","2020.03 월","6383","17020","8046","8974",
"좌3동","총인구","2020.04 월","6375","16968","8007","8961",
"좌3동","총인구","2020.05 월","6371","16899","7973","8926",
"좌3동","총인구","2020.06 월","6383","16832","7938","8894",
"좌3동","총인구","2020.07 월","6386","16766","7911","8855",
"좌3동","총인구","2020.08 월","6398","16722","7880","8842",
"좌3동","총인구","2020.09 월","6396","16661","7839","8822",
"좌3동","총인구","2020.10 월","6397","16637","7829","8808",
"좌3동","총인구","2020.11 월","6384","16550","7785","8765",
"좌3동","총인구","2020.12 월","6380","16466","7754","8712",
"좌3동","총인구","2021.01 월","6380","16436","7740","8696",
"좌3동","총인구","2021.02 월","6390","16416","7724","8692",
"좌3동","총인구","2021.03 월","6385","16359","7691","8668",
"좌3동","총인구","2021.04 월","6398","16346","7680","8666",
"좌3동","총인구","2021.05 월","6419","16372","7695","8677",
"좌3동","총인구","2021.06 월","6427","16354","7674","8680",
"좌3동","총인구","2021.07 월","6432","16357","7678","8679",
"좌3동","총인구","2021.08 월","6450","16369","7680","8689",
"좌3동","총인구","2021.09 월","6470","16388","7679","8709",
"좌3동","총인구","2021.10 월","6459","16354","7668","8686",
"좌3동","총인구","2021.11 월","6453","16337","7666","8671",
"좌3동","총인구","2021.12 월","6445","16295","7646","8649",
"좌3동","총인구","2022.01 월","6446","16273","7632","8641",
"좌3동","총인구","2022.02 월","6441","16220","7620","8600",
"좌3동","총인구","2022.03 월","6436","16183","7607","8576",
"좌3동","총인구","2022.04 월","6437","16135","7572","8563",
"좌3동","총인구","2022.05 월","6431","16109","7564","8545",
"좌3동","총인구","2022.06 월","6418","16022","7526","8496",
"좌3동","총인구","2022.07 월","6424","15980","7506","8474",
"좌3동","총인구","2022.08 월","6425","15937","7480","8457",
"좌3동","총인구","2022.09 월","6415","15896","7459","8437",
"좌3동","총인구","2022.10 월","6409","15858","7438","8420",
"좌3동","총인구","2022.11 월","6391","15814","7426","8388",
"좌3동","총인구","2022.12 월","6372","15771","7427","8344",
"좌3동","총인구","2023.01 월","6377","15762","7422","8340",
"좌3동","총인구","2023.02 월","6380","15735","7400","8335",
"좌3동","총인구","2023.03 월","6376","15703","7375","8328",
"좌3동","총인구","2023.04 월","6373","15677","7346","8331",
"좌3동","총인구","2023.05 월","6376","15678","7351","8327",
"좌3동","총인구","2023.06 월","6382","15639","7330","8309",
"좌3동","총인구","2023.07 월","6375","15586","7304","8282",
"좌3동","총인구","2023.08 월","6365","15541","7274","8267",
"좌3동","총인구","2023.09 월","6367","15546","7278","8268",
"좌3동","총인구","2023.10 월","6370","15528","7254","8274",
"좌3동","총인구","2023.11 월","6377","15525","7261","8264",
"좌3동","총인구","2023.12 월","6373","15508","7255","8253",
"좌3동","총인구","2024.01 월","6351","15422","7198","8224",
"좌3동","총인구","2024.02 월","6344","15367","7171","8196",
"좌3동","총인구","2024.03 월","6339","15352","7166","8186",
"좌3동","총인구","2024.04 월","6349","15363","7177","8186",
"좌3동","총인구","2024.05 월","6350","15337","7156","8181",
"좌3동","총인구","2024.06 월","6359","15321","7143","8178",
"좌3동","총인구","2024.07 월","6359","15306","7140","8166",
"좌3동","총인구","2024.08 월","6346","15253","7113","8140",
"좌3동","총인구","2024.09 월","6334","15225","7106","8119",
"좌3동","총인구","2024.10 월","6329","15192","7085","8107",
"좌3동","총인구","2024.11 월","6317","15134","7048","8086",
"좌3동","총인구","2024.12 월","6332","15128","7036","8092",
"좌4동","총인구","2020.01 월","8543","24222","11588","12634",
"좌4동","총인구","2020.02 월","8524","24084","11494","12590",
"좌4동","총인구","2020.03 월","8530","24007","11466","12541",
"좌4동","총인구","2020.04 월","8525","23974","11450","12524",
"좌4동","총인구","2020.05 월","8515","23879","11401","12478",
"좌4동","총인구","2020.06 월","8527","23835","11367","12468",
"좌4동","총인구","2020.07 월","8525","23772","11324","12448",
"좌4동","총인구","2020.08 월","8497","23675","11294","12381",
"좌4동","총인구","2020.09 월","8507","23614","11262","12352",
"좌4동","총인구","2020.10 월","8484","23533","11219","12314",
"좌4동","총인구","2020.11 월","8490","23469","11160","12309",
"좌4동","총인구","2020.12 월","8516","23509","11184","12325",
"좌4동","총인구","2021.01 월","8571","23490","11166","12324",
"좌4동","총인구","2021.02 월","8604","23497","11177","12320",
"좌4동","총인구","2021.03 월","8612","23463","11162","12301",
"좌4동","총인구","2021.04 월","8614","23431","11141","12290",
"좌4동","총인구","2021.05 월","8625","23417","11133","12284",
"좌4동","총인구","2021.06 월","8627","23385","11104","12281",
"좌4동","총인구","2021.07 월","8623","23378","11094","12284",
"좌4동","총인구","2021.08 월","8645","23335","11062","12273",
"좌4동","총인구","2021.09 월","8643","23326","11057","12269",
"좌4동","총인구","2021.10 월","8640","23310","11049","12261",
"좌4동","총인구","2021.11 월","8632","23243","11016","12227",
"좌4동","총인구","2021.12 월","8641","23216","11010","12206",
"좌4동","총인구","2022.01 월","8634","23181","11008","12173",
"좌4동","총인구","2022.02 월","8627","23122","10960","12162",
"좌4동","총인구","2022.03 월","8621","23067","10933","12134",
"좌4동","총인구","2022.04 월","8622","23034","10930","12104",
"좌4동","총인구","2022.05 월","8620","22987","10899","12088",
"좌4동","총인구","2022.06 월","8620","22958","10877","12081",
"좌4동","총인구","2022.07 월","8622","22934","10881","12053",
"좌4동","총인구","2022.08 월","8596","22864","10831","12033",
"좌4동","총인구","2022.09 월","8585","22835","10811","12024",
"좌4동","총인구","2022.10 월","8573","22799","10793","12006",
"좌4동","총인구","2022.11 월","8559","22759","10780","11979",
"좌4동","총인구","2022.12 월","8548","22742","10768","11974",
"좌4동","총인구","2023.01 월","8524","22668","10740","11928",
"좌4동","총인구","2023.02 월","8524","22571","10687","11884",
"좌4동","총인구","2023.03 월","8514","22500","10651","11849",
"좌4동","총인구","2023.04 월","8524","22503","10645","11858",
"좌4동","총인구","2023.05 월","8527","22474","10642","11832",
"좌4동","총인구","2023.06 월","8536","22452","10633","11819",
"좌4동","총인구","2023.07 월","8538","22436","10619","11817",
"좌4동","총인구","2023.08 월","8544","22418","10601","11817",
"좌4동","총인구","2023.09 월","8552","22415","10607","11808",
"좌4동","총인구","2023.10 월","8539","22387","10587","11800",
"좌4동","총인구","2023.11 월","8532","22358","10579","11779",
"좌4동","총인구","2023.12 월","8522","22297","10551","11746",
"좌4동","총인구","2024.01 월","8521","22258","10541","11717",
"좌4동","총인구","2024.02 월","8540","22242","10526","11716",
"좌4동","총인구","2024.03 월","8531","22183","10504","11679",
"좌4동","총인구","2024.04 월","8543","22184","10491","11693",
"좌4동","총인구","2024.05 월","8529","22121","10465","11656",
"좌4동","총인구","2024.06 월","8536","22114","10472","11642",
"좌4동","총인구","2024.07 월","8527","22050","10428","11622",
"좌4동","총인구","2024.08 월","8522","22010","10416","11594",
"좌4동","총인구","2024.09 월","8536","21996","10403","11593",
"좌4동","총인구","2024.10 월","8534","21977","10388","11589",
"좌4동","총인구","2024.11 월","8532","21969","10390","11579",
"좌4동","총인구","2024.12 월","8534","21969","10393","11576",
"송정동","총인구","2020.01 월","5001","10496","5071","5425",
"송정동","총인구","2020.02 월","4966","10414","5034","5380",
"송정동","총인구","2020.03 월","4962","10343","5002","5341",
"송정동","총인구","2020.04 월","4947","10301","4983","5318",
"송정동","총인구","2020.05 월","4930","10228","4948","5280",
"송정동","총인구","2020.06 월","4933","10196","4932","5264",
"송정동","총인구","2020.07 월","4952","10187","4937","5250",
"송정동","총인구","2020.08 월","4966","10187","4935","5252",
"송정동","총인구","2020.09 월","4964","10160","4925","5235",
"송정동","총인구","2020.10 월","4957","10099","4885","5214",
"송정동","총인구","2020.11 월","4973","10093","4879","5214",
"송정동","총인구","2020.12 월","4992","10091","4874","5217",
"송정동","총인구","2021.01 월","5007","10115","4887","5228",
"송정동","총인구","2021.02 월","4999","10064","4865","5199",
"송정동","총인구","2021.03 월","5021","10075","4873","5202",
"송정동","총인구","2021.04 월","5037","10084","4884","5200",
"송정동","총인구","2021.05 월","5044","10060","4861","5199",
"송정동","총인구","2021.06 월","5064","10059","4857","5202",
"송정동","총인구","2021.07 월","5060","10038","4843","5195",
"송정동","총인구","2021.08 월","5080","10008","4824","5184",
"송정동","총인구","2021.09 월","5096","10036","4840","5196",
"송정동","총인구","2021.10 월","5097","10018","4829","5189",
"송정동","총인구","2021.11 월","5084","9967","4804","5163",
"송정동","총인구","2021.12 월","5100","10014","4829","5185",
"송정동","총인구","2022.01 월","5108","10011","4835","5176",
"송정동","총인구","2022.02 월","5114","10019","4830","5189",
"송정동","총인구","2022.03 월","5105","9987","4811","5176",
"송정동","총인구","2022.04 월","5104","9981","4807","5174",
"송정동","총인구","2022.05 월","5089","9926","4772","5154",
"송정동","총인구","2022.06 월","5063","9859","4748","5111",
"송정동","총인구","2022.07 월","5062","9850","4743","5107",
"송정동","총인구","2022.08 월","5056","9835","4743","5092",
"송정동","총인구","2022.09 월","5005","9728","4680","5048",
"송정동","총인구","2022.10 월","5021","9735","4685","5050",
"송정동","총인구","2022.11 월","5025","9737","4688","5049",
"송정동","총인구","2022.12 월","5012","9709","4671","5038",
"송정동","총인구","2023.01 월","5003","9670","4661","5009",
"송정동","총인구","2023.02 월","5001","9657","4658","4999",
"송정동","총인구","2023.03 월","4997","9654","4651","5003",
"송정동","총인구","2023.04 월","4990","9638","4652","4986",
"송정동","총인구","2023.05 월","4967","9597","4636","4961",
"송정동","총인구","2023.06 월","4955","9561","4620","4941",
"송정동","총인구","2023.07 월","4948","9563","4631","4932",
"송정동","총인구","2023.08 월","4951","9549","4620","4929",
"송정동","총인구","2023.09 월","4958","9560","4621","4939",
"송정동","총인구","2023.10 월","4937","9521","4605","4916",
"송정동","총인구","2023.11 월","4939","9513","4604","4909",
"송정동","총인구","2023.12 월","4923","9470","4581","4889",
"송정동","총인구","2024.01 월","4941","9494","4591","4903",
"송정동","총인구","2024.02 월","4933","9454","4576","4878",
"송정동","총인구","2024.03 월","4917","9438","4575","4863",
"송정동","총인구","2024.04 월","4910","9406","4556","4850",
"송정동","총인구","2024.05 월","4899","9376","4539","4837",
"송정동","총인구","2024.06 월","4889","9355","4518","4837",
"송정동","총인구","2024.07 월","4877","9297","4492","4805",
"송정동","총인구","2024.08 월","4875","9272","4470","4802",
"송정동","총인구","2024.09 월","4888","9310","4490","4820",
"송정동","총인구","2024.10 월","4876","9296","4478","4818",
"송정동","총인구","2024.11 월","4861","9255","4450","4805",
"송정동","총인구","2024.12 월","4856","9250","4446","4804",
"반여1동","총인구","2020.01 월","12953","35948","17824","18124",
"반여1동","총인구","2020.02 월","12902","35747","17742","18005",
"반여1동","총인구","2020.03 월","12943","35741","17763","17978",
"반여1동","총인구","2020.04 월","13029","35887","17823","18064",
"반여1동","총인구","2020.05 월","13090","35877","17806","18071",
"반여1동","총인구","2020.06 월","13128","35912","17817","18095",
"반여1동","총인구","2020.07 월","13165","35851","17802","18049",
"반여1동","총인구","2020.08 월","13167","35792","17776","18016",
"반여1동","총인구","2020.09 월","13192","35765","17729","18036",
"반여1동","총인구","2020.10 월","13183","35753","17706","18047",
"반여1동","총인구","2020.11 월","13187","35668","17680","17988",
"반여1동","총인구","2020.12 월","13176","35557","17629","17928",
"반여1동","총인구","2021.01 월","13151","35406","17524","17882",
"반여1동","총인구","2021.02 월","13144","35330","17470","17860",
"반여1동","총인구","2021.03 월","13123","35225","17425","17800",
"반여1동","총인구","2021.04 월","13109","35172","17396","17776",
"반여1동","총인구","2021.05 월","13111","35118","17359","17759",
"반여1동","총인구","2021.06 월","13125","35073","17326","17747",
"반여1동","총인구","2021.07 월","13113","34980","17269","17711",
"반여1동","총인구","2021.08 월","13107","34917","17229","17688",
"반여1동","총인구","2021.09 월","13118","34882","17189","17693",
"반여1동","총인구","2021.10 월","13123","34888","17203","17685",
"반여1동","총인구","2021.11 월","13118","34818","17173","17645",
"반여1동","총인구","2021.12 월","13113","34743","17138","17605",
"반여1동","총인구","2022.01 월","13082","34619","17061","17558",
"반여1동","총인구","2022.02 월","13043","34459","16957","17502",
"반여1동","총인구","2022.03 월","13027","34341","16897","17444",
"반여1동","총인구","2022.04 월","13016","34268","16860","17408",
"반여1동","총인구","2022.05 월","13002","34175","16831","17344",
"반여1동","총인구","2022.06 월","12998","34124","16790","17334",
"반여1동","총인구","2022.07 월","12982","34062","16756","17306",
"반여1동","총인구","2022.08 월","13001","34036","16730","17306",
"반여1동","총인구","2022.09 월","13145","34435","16928","17507",
"반여1동","총인구","2022.10 월","13256","34727","17074","17653",
"반여1동","총인구","2022.11 월","13304","34779","17088","17691",
"반여1동","총인구","2022.12 월","13332","34834","17116","17718",
"반여1동","총인구","2023.01 월","13319","34810","17096","17714",
"반여1동","총인구","2023.02 월","13349","34792","17087","17705",
"반여1동","총인구","2023.03 월","13363","34802","17091","17711",
"반여1동","총인구","2023.04 월","13378","34812","17098","17714",
"반여1동","총인구","2023.05 월","13398","34816","17104","17712",
"반여1동","총인구","2023.06 월","13399","34766","17089","17677",
"반여1동","총인구","2023.07 월","13402","34711","17047","17664",
"반여1동","총인구","2023.08 월","13401","34701","17037","17664",
"반여1동","총인구","2023.09 월","13420","34739","17037","17702",
"반여1동","총인구","2023.10 월","13422","34716","17019","17697",
"반여1동","총인구","2023.11 월","13404","34684","16996","17688",
"반여1동","총인구","2023.12 월","13415","34640","16988","17652",
"반여1동","총인구","2024.01 월","13407","34589","16954","17635",
"반여1동","총인구","2024.02 월","13395","34481","16902","17579",
"반여1동","총인구","2024.03 월","13390","34406","16870","17536",
"반여1동","총인구","2024.04 월","13399","34392","16857","17535",
"반여1동","총인구","2024.05 월","13406","34367","16829","17538",
"반여1동","총인구","2024.06 월","13410","34322","16806","17516",
"반여1동","총인구","2024.07 월","13663","34949","17139","17810",
"반여1동","총인구","2024.08 월","13859","35445","17382","18063",
"반여1동","총인구","2024.09 월","13917","35543","17422","18121",
"반여1동","총인구","2024.10 월","13947","35591","17434","18157",
"반여1동","총인구","2024.11 월","13955","35622","17451","18171",
"반여1동","총인구","2024.12 월","13969","35662","17470","18192",
"반여2동","총인구","2020.01 월","7003","13858","6725","7133",
"반여2동","총인구","2020.02 월","7015","13834","6716","7118",
"반여2동","총인구","2020.03 월","7018","13796","6709","7087",
"반여2동","총인구","2020.04 월","7007","13771","6703","7068",
"반여2동","총인구","2020.05 월","6996","13707","6662","7045",
"반여2동","총인구","2020.06 월","6984","13654","6629","7025",
"반여2동","총인구","2020.07 월","6987","13603","6603","7000",
"반여2동","총인구","2020.08 월","6970","13519","6562","6957",
"반여2동","총인구","2020.09 월","6981","13529","6556","6973",
"반여2동","총인구","2020.10 월","6990","13521","6553","6968",
"반여2동","총인구","2020.11 월","6994","13457","6521","6936",
"반여2동","총인구","2020.12 월","6997","13402","6478","6924",
"반여2동","총인구","2021.01 월","6968","13315","6442","6873",
"반여2동","총인구","2021.02 월","6936","13225","6397","6828",
"반여2동","총인구","2021.03 월","6861","13061","6338","6723",
"반여2동","총인구","2021.04 월","6854","13017","6316","6701",
"반여2동","총인구","2021.05 월","6864","12986","6294","6692",
"반여2동","총인구","2021.06 월","6850","12943","6277","6666",
"반여2동","총인구","2021.07 월","6838","12891","6252","6639",
"반여2동","총인구","2021.08 월","6839","12854","6240","6614",
"반여2동","총인구","2021.09 월","6846","12858","6240","6618",
"반여2동","총인구","2021.10 월","6856","12820","6220","6600",
"반여2동","총인구","2021.11 월","6875","12800","6214","6586",
"반여2동","총인구","2021.12 월","6862","12757","6198","6559",
"반여2동","총인구","2022.01 월","6851","12715","6156","6559",
"반여2동","총인구","2022.02 월","6848","12687","6155","6532",
"반여2동","총인구","2022.03 월","6843","12646","6150","6496",
"반여2동","총인구","2022.04 월","6838","12607","6135","6472",
"반여2동","총인구","2022.05 월","6805","12549","6089","6460",
"반여2동","총인구","2022.06 월","6798","12514","6057","6457",
"반여2동","총인구","2022.07 월","6801","12477","6037","6440",
"반여2동","총인구","2022.08 월","6789","12452","6024","6428",
"반여2동","총인구","2022.09 월","6748","12379","5992","6387",
"반여2동","총인구","2022.10 월","6726","12311","5956","6355",
"반여2동","총인구","2022.11 월","6739","12295","5954","6341",
"반여2동","총인구","2022.12 월","6722","12272","5938","6334",
"반여2동","총인구","2023.01 월","6710","12243","5928","6315",
"반여2동","총인구","2023.02 월","6697","12191","5906","6285",
"반여2동","총인구","2023.03 월","6682","12151","5889","6262",
"반여2동","총인구","2023.04 월","6660","12087","5859","6228",
"반여2동","총인구","2023.05 월","6641","12038","5835","6203",
"반여2동","총인구","2023.06 월","6633","12020","5833","6187",
"반여2동","총인구","2023.07 월","6637","12025","5844","6181",
"반여2동","총인구","2023.08 월","6633","12000","5835","6165",
"반여2동","총인구","2023.09 월","6622","11941","5809","6132",
"반여2동","총인구","2023.10 월","6601","11884","5784","6100",
"반여2동","총인구","2023.11 월","6592","11831","5759","6072",
"반여2동","총인구","2023.12 월","6578","11815","5747","6068",
"반여2동","총인구","2024.01 월","6567","11785","5718","6067",
"반여2동","총인구","2024.02 월","6554","11750","5700","6050",
"반여2동","총인구","2024.03 월","6544","11684","5666","6018",
"반여2동","총인구","2024.04 월","6519","11637","5649","5988",
"반여2동","총인구","2024.05 월","6501","11608","5642","5966",
"반여2동","총인구","2024.06 월","6486","11589","5634","5955",
"반여2동","총인구","2024.07 월","6476","11521","5608","5913",
"반여2동","총인구","2024.08 월","6482","11510","5606","5904",
"반여2동","총인구","2024.09 월","6480","11469","5585","5884",
"반여2동","총인구","2024.10 월","6457","11414","5548","5866",
"반여2동","총인구","2024.11 월","6454","11402","5550","5852",
"반여2동","총인구","2024.12 월","6458","11385","5541","5844",
"반여3동","총인구","2020.01 월","4754","9515","4651","4864",
"반여3동","총인구","2020.02 월","4740","9465","4630","4835",
"반여3동","총인구","2020.03 월","4750","9441","4603","4838",
"반여3동","총인구","2020.04 월","4743","9378","4570","4808",
"반여3동","총인구","2020.05 월","4732","9325","4546","4779",
"반여3동","총인구","2020.06 월","4735","9278","4528","4750",
"반여3동","총인구","2020.07 월","4718","9243","4514","4729",
"반여3동","총인구","2020.08 월","4711","9232","4506","4726",
"반여3동","총인구","2020.09 월","4716","9185","4488","4697",
"반여3동","총인구","2020.10 월","4716","9147","4472","4675",
"반여3동","총인구","2020.11 월","4720","9120","4461","4659",
"반여3동","총인구","2020.12 월","4708","9062","4432","4630",
"반여3동","총인구","2021.01 월","4702","9011","4412","4599",
"반여3동","총인구","2021.02 월","4709","9010","4416","4594",
"반여3동","총인구","2021.03 월","4630","8890","4358","4532",
"반여3동","총인구","2021.04 월","4614","8847","4336","4511",
"반여3동","총인구","2021.05 월","4628","8848","4331","4517",
"반여3동","총인구","2021.06 월","4612","8796","4315","4481",
"반여3동","총인구","2021.07 월","4606","8762","4297","4465",
"반여3동","총인구","2021.08 월","4601","8718","4273","4445",
"반여3동","총인구","2021.09 월","4610","8679","4245","4434",
"반여3동","총인구","2021.10 월","4621","8677","4252","4425",
"반여3동","총인구","2021.11 월","4620","8648","4239","4409",
"반여3동","총인구","2021.12 월","4614","8602","4215","4387",
"반여3동","총인구","2022.01 월","4617","8564","4185","4379",
"반여3동","총인구","2022.02 월","4615","8535","4163","4372",
"반여3동","총인구","2022.03 월","4604","8501","4151","4350",
"반여3동","총인구","2022.04 월","4589","8444","4130","4314",
"반여3동","총인구","2022.05 월","4582","8392","4104","4288",
"반여3동","총인구","2022.06 월","4580","8369","4095","4274",
"반여3동","총인구","2022.07 월","4590","8372","4101","4271",
"반여3동","총인구","2022.08 월","4597","8370","4095","4275",
"반여3동","총인구","2022.09 월","4570","8318","4077","4241",
"반여3동","총인구","2022.10 월","4567","8310","4077","4233",
"반여3동","총인구","2022.11 월","4546","8273","4055","4218",
"반여3동","총인구","2022.12 월","4554","8264","4047","4217",
"반여3동","총인구","2023.01 월","4544","8233","4025","4208",
"반여3동","총인구","2023.02 월","4548","8209","4008","4201",
"반여3동","총인구","2023.03 월","4536","8181","3989","4192",
"반여3동","총인구","2023.04 월","4530","8154","3976","4178",
"반여3동","총인구","2023.05 월","4517","8128","3953","4175",
"반여3동","총인구","2023.06 월","4502","8096","3931","4165",
"반여3동","총인구","2023.07 월","4478","8047","3900","4147",
"반여3동","총인구","2023.08 월","4476","8039","3891","4148",
"반여3동","총인구","2023.09 월","4466","8009","3877","4132",
"반여3동","총인구","2023.10 월","4453","7994","3866","4128",
"반여3동","총인구","2023.11 월","4442","7949","3849","4100",
"반여3동","총인구","2023.12 월","4433","7907","3820","4087",
"반여3동","총인구","2024.01 월","4414","7862","3794","4068",
"반여3동","총인구","2024.02 월","4403","7834","3777","4057",
"반여3동","총인구","2024.03 월","4379","7807","3768","4039",
"반여3동","총인구","2024.04 월","4376","7783","3759","4024",
"반여3동","총인구","2024.05 월","4360","7734","3723","4011",
"반여3동","총인구","2024.06 월","4346","7694","3701","3993",
"반여3동","총인구","2024.07 월","4356","7665","3688","3977",
"반여3동","총인구","2024.08 월","4343","7619","3671","3948",
"반여3동","총인구","2024.09 월","4331","7570","3644","3926",
"반여3동","총인구","2024.10 월","4314","7548","3628","3920",
"반여3동","총인구","2024.11 월","4305","7519","3615","3904",
"반여3동","총인구","2024.12 월","4307","7492","3608","3884",
"반여4동","총인구","2020.01 월","6009","16676","8232","8444",
"반여4동","총인구","2020.02 월","5994","16659","8223","8436",
"반여4동","총인구","2020.03 월","6004","16639","8209","8430",
"반여4동","총인구","2020.04 월","6014","16656","8220","8436",
"반여4동","총인구","2020.05 월","6015","16620","8188","8432",
"반여4동","총인구","2020.06 월","6003","16559","8154","8405",
"반여4동","총인구","2020.07 월","6130","16775","8264","8511",
"반여4동","총인구","2020.08 월","6139","16748","8241","8507",
"반여4동","총인구","2020.09 월","6137","16710","8218","8492",
"반여4동","총인구","2020.10 월","6126","16632","8176","8456",
"반여4동","총인구","2020.11 월","6124","16614","8172","8442",
"반여4동","총인구","2020.12 월","6109","16536","8131","8405",
"반여4동","총인구","2021.01 월","6109","16502","8109","8393",
"반여4동","총인구","2021.02 월","6109","16446","8087","8359",
"반여4동","총인구","2021.03 월","6092","16378","8051","8327",
"반여4동","총인구","2021.04 월","6101","16369","8032","8337",
"반여4동","총인구","2021.05 월","6102","16353","8037","8316",
"반여4동","총인구","2021.06 월","6103","16301","8023","8278",
"반여4동","총인구","2021.07 월","6100","16260","7998","8262",
"반여4동","총인구","2021.08 월","6096","16253","8001","8252",
"반여4동","총인구","2021.09 월","6097","16242","7998","8244",
"반여4동","총인구","2021.10 월","6090","16197","7984","8213",
"반여4동","총인구","2021.11 월","6095","16176","7971","8205",
"반여4동","총인구","2021.12 월","6079","16123","7947","8176",
"반여4동","총인구","2022.01 월","6076","16099","7943","8156",
"반여4동","총인구","2022.02 월","6062","16039","7923","8116",
"반여4동","총인구","2022.03 월","6056","15993","7886","8107",
"반여4동","총인구","2022.04 월","6046","15950","7862","8088",
"반여4동","총인구","2022.05 월","6044","15904","7835","8069",
"반여4동","총인구","2022.06 월","6016","15843","7801","8042",
"반여4동","총인구","2022.07 월","5974","15747","7753","7994",
"반여4동","총인구","2022.08 월","5905","15594","7674","7920",
"반여4동","총인구","2022.09 월","5829","15428","7584","7844",
"반여4동","총인구","2022.10 월","5807","15374","7555","7819",
"반여4동","총인구","2022.11 월","5783","15343","7532","7811",
"반여4동","총인구","2022.12 월","5773","15308","7511","7797",
"반여4동","총인구","2023.01 월","5766","15275","7489","7786",
"반여4동","총인구","2023.02 월","5755","15224","7463","7761",
"반여4동","총인구","2023.03 월","5757","15199","7452","7747",
"반여4동","총인구","2023.04 월","5756","15159","7443","7716",
"반여4동","총인구","2023.05 월","5752","15117","7406","7711",
"반여4동","총인구","2023.06 월","5752","15091","7390","7701",
"반여4동","총인구","2023.07 월","5740","15040","7373","7667",
"반여4동","총인구","2023.08 월","5729","15010","7361","7649",
"반여4동","총인구","2023.09 월","5723","14990","7352","7638",
"반여4동","총인구","2023.10 월","5724","14996","7350","7646",
"반여4동","총인구","2023.11 월","5708","14938","7326","7612",
"반여4동","총인구","2023.12 월","5700","14913","7309","7604",
"반여4동","총인구","2024.01 월","5710","14914","7312","7602",
"반여4동","총인구","2024.02 월","5706","14871","7289","7582",
"반여4동","총인구","2024.03 월","5712","14847","7280","7567",
"반여4동","총인구","2024.04 월","5708","14822","7268","7554",
"반여4동","총인구","2024.05 월","5708","14805","7263","7542",
"반여4동","총인구","2024.06 월","5712","14778","7246","7532",
"반여4동","총인구","2024.07 월","5713","14737","7214","7523",
"반여4동","총인구","2024.08 월","5694","14675","7170","7505",
"반여4동","총인구","2024.09 월","5690","14667","7171","7496",
"반여4동","총인구","2024.10 월","5695","14624","7148","7476",
"반여4동","총인구","2024.11 월","5701","14621","7149","7472",
"반여4동","총인구","2024.12 월","5693","14563","7117","7446",
"반송1동","총인구","2020.01 월","8102","16006","8018","7988",
"반송1동","총인구","2020.02 월","8077","15901","7968","7933",
"반송1동","총인구","2020.03 월","8058","15814","7929","7885",
"반송1동","총인구","2020.04 월","8051","15735","7896","7839",
"반송1동","총인구","2020.05 월","8044","15573","7821","7752",
"반송1동","총인구","2020.06 월","8053","15537","7798","7739",
"반송1동","총인구","2020.07 월","8049","15467","7762","7705",
"반송1동","총인구","2020.08 월","8040","15366","7717","7649",
"반송1동","총인구","2020.09 월","8028","15283","7680","7603",
"반송1동","총인구","2020.10 월","8018","15205","7629","7576",
"반송1동","총인구","2020.11 월","8018","15162","7606","7556",
"반송1동","총인구","2020.12 월","8002","15079","7561","7518",
"반송1동","총인구","2021.01 월","7990","14985","7509","7476",
"반송1동","총인구","2021.02 월","7986","14945","7494","7451",
"반송1동","총인구","2021.03 월","7981","14913","7479","7434",
"반송1동","총인구","2021.04 월","7973","14899","7463","7436",
"반송1동","총인구","2021.05 월","7911","14770","7395","7375",
"반송1동","총인구","2021.06 월","7921","14763","7398","7365",
"반송1동","총인구","2021.07 월","7922","14688","7345","7343",
"반송1동","총인구","2021.08 월","7944","14667","7337","7330",
"반송1동","총인구","2021.09 월","7959","14673","7327","7346",
"반송1동","총인구","2021.10 월","7958","14652","7329","7323",
"반송1동","총인구","2021.11 월","7934","14576","7298","7278",
"반송1동","총인구","2021.12 월","7905","14516","7254","7262",
"반송1동","총인구","2022.01 월","7897","14467","7220","7247",
"반송1동","총인구","2022.02 월","7890","14419","7213","7206",
"반송1동","총인구","2022.03 월","7884","14331","7163","7168",
"반송1동","총인구","2022.04 월","7870","14325","7161","7164",
"반송1동","총인구","2022.05 월","7863","14259","7119","7140",
"반송1동","총인구","2022.06 월","7852","14221","7092","7129",
"반송1동","총인구","2022.07 월","7873","14215","7099","7116",
"반송1동","총인구","2022.08 월","7873","14174","7083","7091",
"반송1동","총인구","2022.09 월","7725","13982","6983","6999",
"반송1동","총인구","2022.10 월","7721","14069","7044","7025",
"반송1동","총인구","2022.11 월","7720","14043","7017","7026",
"반송1동","총인구","2022.12 월","7715","13995","7001","6994",
"반송1동","총인구","2023.01 월","7679","13928","6960","6968",
"반송1동","총인구","2023.02 월","7691","13881","6945","6936",
"반송1동","총인구","2023.03 월","7690","13852","6937","6915",
"반송1동","총인구","2023.04 월","7685","13883","6958","6925",
"반송1동","총인구","2023.05 월","7688","13849","6943","6906",
"반송1동","총인구","2023.06 월","7660","13761","6899","6862",
"반송1동","총인구","2023.07 월","7656","13716","6873","6843",
"반송1동","총인구","2023.08 월","7632","13648","6837","6811",
"반송1동","총인구","2023.09 월","7631","13644","6831","6813",
"반송1동","총인구","2023.10 월","7622","13703","6865","6838",
"반송1동","총인구","2023.11 월","7581","13621","6823","6798",
"반송1동","총인구","2023.12 월","7564","13571","6804","6767",
"반송1동","총인구","2024.01 월","7524","13498","6757","6741",
"반송1동","총인구","2024.02 월","7500","13410","6717","6693",
"반송1동","총인구","2024.03 월","7495","13360","6693","6667",
"반송1동","총인구","2024.04 월","7481","13330","6674","6656",
"반송1동","총인구","2024.05 월","7473","13349","6704","6645",
"반송1동","총인구","2024.06 월","7461","13340","6697","6643",
"반송1동","총인구","2024.07 월","7436","13276","6665","6611",
"반송1동","총인구","2024.08 월","7411","13199","6629","6570",
"반송1동","총인구","2024.09 월","7389","13141","6602","6539",
"반송1동","총인구","2024.10 월","7369","13249","6694","6555",
"반송1동","총인구","2024.11 월","7358","13205","6676","6529",
"반송1동","총인구","2024.12 월","7327","13161","6660","6501",
"반송2동","총인구","2020.01 월","12284","25290","12333","12957",
"반송2동","총인구","2020.02 월","12256","25172","12260","12912",
"반송2동","총인구","2020.03 월","12247","25068","12195","12873",
"반송2동","총인구","2020.04 월","12234","25027","12175","12852",
"반송2동","총인구","2020.05 월","12240","24970","12147","12823",
"반송2동","총인구","2020.06 월","12243","24899","12099","12800",
"반송2동","총인구","2020.07 월","12240","24844","12056","12788",
"반송2동","총인구","2020.08 월","12209","24725","11991","12734",
"반송2동","총인구","2020.09 월","12218","24682","11958","12724",
"반송2동","총인구","2020.10 월","12204","24596","11921","12675",
"반송2동","총인구","2020.11 월","12190","24545","11893","12652",
"반송2동","총인구","2020.12 월","12177","24409","11828","12581",
"반송2동","총인구","2021.01 월","12159","24274","11748","12526",
"반송2동","총인구","2021.02 월","12160","24193","11706","12487",
"반송2동","총인구","2021.03 월","12008","23967","11630","12337",
"반송2동","총인구","2021.04 월","12035","23933","11624","12309",
"반송2동","총인구","2021.05 월","12031","23846","11585","12261",
"반송2동","총인구","2021.06 월","12015","23782","11554","12228",
"반송2동","총인구","2021.07 월","11997","23708","11511","12197",
"반송2동","총인구","2021.08 월","11976","23622","11467","12155",
"반송2동","총인구","2021.09 월","11962","23555","11434","12121",
"반송2동","총인구","2021.10 월","11956","23494","11401","12093",
"반송2동","총인구","2021.11 월","11967","23447","11376","12071",
"반송2동","총인구","2021.12 월","11966","23412","11361","12051",
"반송2동","총인구","2022.01 월","11960","23336","11325","12011",
"반송2동","총인구","2022.02 월","11937","23249","11278","11971",
"반송2동","총인구","2022.03 월","11947","23172","11249","11923",
"반송2동","총인구","2022.04 월","11938","23076","11204","11872",
"반송2동","총인구","2022.05 월","11944","23002","11167","11835",
"반송2동","총인구","2022.06 월","11937","22941","11127","11814",
"반송2동","총인구","2022.07 월","11938","22897","11098","11799",
"반송2동","총인구","2022.08 월","11916","22818","11052","11766",
"반송2동","총인구","2022.09 월","11878","22711","11000","11711",
"반송2동","총인구","2022.10 월","11834","22636","10967","11669",
"반송2동","총인구","2022.11 월","11797","22529","10916","11613",
"반송2동","총인구","2022.12 월","11773","22471","10883","11588",
"반송2동","총인구","2023.01 월","11750","22402","10862","11540",
"반송2동","총인구","2023.02 월","11732","22324","10838","11486",
"반송2동","총인구","2023.03 월","11725","22279","10815","11464",
"반송2동","총인구","2023.04 월","11726","22226","10795","11431",
"반송2동","총인구","2023.05 월","11711","22150","10744","11406",
"반송2동","총인구","2023.06 월","11686","22072","10707","11365",
"반송2동","총인구","2023.07 월","11685","22021","10688","11333",
"반송2동","총인구","2023.08 월","11634","21912","10622","11290",
"반송2동","총인구","2023.09 월","11621","21868","10606","11262",
"반송2동","총인구","2023.10 월","11595","21801","10575","11226",
"반송2동","총인구","2023.11 월","11569","21746","10548","11198",
"반송2동","총인구","2023.12 월","11545","21689","10521","11168",
"반송2동","총인구","2024.01 월","11532","21626","10490","11136",
"반송2동","총인구","2024.02 월","11524","21561","10454","11107",
"반송2동","총인구","2024.03 월","11504","21517","10454","11063",
"반송2동","총인구","2024.04 월","11509","21476","10434","11042",
"반송2동","총인구","2024.05 월","11493","21423","10405","11018",
"반송2동","총인구","2024.06 월","11479","21377","10394","10983",
"반송2동","총인구","2024.07 월","11470","21306","10358","10948",
"반송2동","총인구","2024.08 월","11449","21233","10326","10907",
"반송2동","총인구","2024.09 월","11423","21137","10264","10873",
"반송2동","총인구","2024.10 월","11399","21045","10222","10823",
"반송2동","총인구","2024.11 월","11375","20965","10168","10797",
"반송2동","총인구","2024.12 월","11371","20896","10133","10763",
"재송1동","총인구","2020.01 월","14253","38709","19054","19655",
"재송1동","총인구","2020.02 월","14251","38618","18995","19623",
"재송1동","총인구","2020.03 월","14260","38516","18926","19590",
"재송1동","총인구","2020.04 월","14285","38548","18944","19604",
"재송1동","총인구","2020.05 월","14372","38611","18979","19632",
"재송1동","총인구","2020.06 월","14441","38651","19010","19641",
"재송1동","총인구","2020.07 월","14522","38732","19053","19679",
"재송1동","총인구","2020.08 월","14511","38718","19060","19658",
"재송1동","총인구","2020.09 월","14533","38717","19059","19658",
"재송1동","총인구","2020.10 월","14567","38715","19076","19639",
"재송1동","총인구","2020.11 월","14586","38692","19079","19613",
"재송1동","총인구","2020.12 월","14612","38617","19067","19550",
"재송1동","총인구","2021.01 월","14615","38550","19011","19539",
"재송1동","총인구","2021.02 월","14625","38483","18944","19539",
"재송1동","총인구","2021.03 월","14574","38378","18892","19486",
"재송1동","총인구","2021.04 월","14597","38331","18867","19464",
"재송1동","총인구","2021.05 월","14608","38350","18884","19466",
"재송1동","총인구","2021.06 월","14623","38317","18857","19460",
"재송1동","총인구","2021.07 월","14630","38293","18851","19442",
"재송1동","총인구","2021.08 월","14629","38246","18814","19432",
"재송1동","총인구","2021.09 월","14636","38208","18792","19416",
"재송1동","총인구","2021.10 월","14676","38178","18779","19399",
"재송1동","총인구","2021.11 월","14676","38142","18751","19391",
"재송1동","총인구","2021.12 월","14664","38016","18693","19323",
"재송1동","총인구","2022.01 월","14661","37952","18652","19300",
"재송1동","총인구","2022.02 월","14661","37868","18614","19254",
"재송1동","총인구","2022.03 월","14677","37870","18606","19264",
"재송1동","총인구","2022.04 월","14691","37849","18603","19246",
"재송1동","총인구","2022.05 월","14697","37814","18560","19254",
"재송1동","총인구","2022.06 월","14685","37723","18516","19207",
"재송1동","총인구","2022.07 월","14669","37664","18482","19182",
"재송1동","총인구","2022.08 월","14655","37569","18444","19125",
"재송1동","총인구","2022.09 월","14649","37527","18402","19125",
"재송1동","총인구","2022.10 월","14627","37455","18367","19088",
"재송1동","총인구","2022.11 월","14610","37434","18353","19081",
"재송1동","총인구","2022.12 월","14569","37359","18305","19054",
"재송1동","총인구","2023.01 월","14571","37312","18306","19006",
"재송1동","총인구","2023.02 월","14550","37188","18262","18926",
"재송1동","총인구","2023.03 월","14507","37060","18172","18888",
"재송1동","총인구","2023.04 월","14460","36976","18126","18850",
"재송1동","총인구","2023.05 월","14535","37068","18181","18887",
"재송1동","총인구","2023.06 월","14567","37113","18207","18906",
"재송1동","총인구","2023.07 월","14604","37171","18243","18928",
"재송1동","총인구","2023.08 월","14635","37174","18237","18937",
"재송1동","총인구","2023.09 월","14646","37191","18243","18948",
"재송1동","총인구","2023.10 월","14639","37121","18194","18927",
"재송1동","총인구","2023.11 월","14626","37121","18188","18933",
"재송1동","총인구","2023.12 월","14585","37040","18153","18887",
"재송1동","총인구","2024.01 월","14528","36952","18105","18847",
"재송1동","총인구","2024.02 월","14527","36888","18097","18791",
"재송1동","총인구","2024.03 월","14503","36787","18045","18742",
"재송1동","총인구","2024.04 월","14498","36753","18038","18715",
"재송1동","총인구","2024.05 월","14496","36680","18011","18669",
"재송1동","총인구","2024.06 월","14506","36640","18003","18637",
"재송1동","총인구","2024.07 월","14507","36621","17980","18641",
"재송1동","총인구","2024.08 월","14553","36654","18003","18651",
"재송1동","총인구","2024.09 월","14595","36724","18047","18677",
"재송1동","총인구","2024.10 월","14580","36612","17981","18631",
"재송1동","총인구","2024.11 월","14578","36623","17981","18642",
"재송1동","총인구","2024.12 월","14591","36644","17984","18660",
"재송2동","총인구","2020.01 월","11619","26795","13055","13740",
"재송2동","총인구","2020.02 월","11595","26688","13000","13688",
"재송2동","총인구","2020.03 월","11576","26595","12933","13662",
"재송2동","총인구","2020.04 월","11551","26511","12891","13620",
"재송2동","총인구","2020.05 월","11532","26359","12804","13555",
"재송2동","총인구","2020.06 월","11546","26232","12733","13499",
"재송2동","총인구","2020.07 월","11523","26105","12669","13436",
"재송2동","총인구","2020.08 월","11505","25974","12608","13366",
"재송2동","총인구","2020.09 월","11490","25837","12542","13295",
"재송2동","총인구","2020.10 월","11485","25764","12518","13246",
"재송2동","총인구","2020.11 월","11499","25675","12472","13203",
"재송2동","총인구","2020.12 월","11498","25567","12418","13149",
"재송2동","총인구","2021.01 월","11501","25493","12384","13109",
"재송2동","총인구","2021.02 월","11498","25397","12336","13061",
"재송2동","총인구","2021.03 월","11452","25270","12284","12986",
"재송2동","총인구","2021.04 월","11449","25220","12270","12950",
"재송2동","총인구","2021.05 월","11464","25177","12246","12931",
"재송2동","총인구","2021.06 월","11473","25157","12246","12911",
"재송2동","총인구","2021.07 월","11463","25080","12216","12864",
"재송2동","총인구","2021.08 월","11497","25060","12203","12857",
"재송2동","총인구","2021.09 월","11492","25024","12212","12812",
"재송2동","총인구","2021.10 월","11500","24974","12195","12779",
"재송2동","총인구","2021.11 월","11503","24919","12166","12753",
"재송2동","총인구","2021.12 월","11493","24851","12126","12725",
"재송2동","총인구","2022.01 월","11478","24837","12122","12715",
"재송2동","총인구","2022.02 월","11458","24749","12067","12682",
"재송2동","총인구","2022.03 월","11438","24639","12011","12628",
"재송2동","총인구","2022.04 월","11410","24530","11945","12585",
"재송2동","총인구","2022.05 월","11407","24422","11879","12543",
"재송2동","총인구","2022.06 월","11383","24317","11820","12497",
"재송2동","총인구","2022.07 월","11377","24257","11790","12467",
"재송2동","총인구","2022.08 월","11357","24185","11754","12431",
"재송2동","총인구","2022.09 월","11252","23980","11662","12318",
"재송2동","총인구","2022.10 월","11204","23850","11579","12271",
"재송2동","총인구","2022.11 월","11092","23650","11474","12176",
"재송2동","총인구","2022.12 월","11033","23536","11416","12120",
"재송2동","총인구","2023.01 월","11010","23464","11372","12092",
"재송2동","총인구","2023.02 월","11047","23458","11353","12105",
"재송2동","총인구","2023.03 월","11067","23450","11348","12102",
"재송2동","총인구","2023.04 월","11076","23444","11340","12104",
"재송2동","총인구","2023.05 월","11079","23409","11318","12091",
"재송2동","총인구","2023.06 월","11084","23345","11278","12067",
"재송2동","총인구","2023.07 월","11076","23287","11261","12026",
"재송2동","총인구","2023.08 월","11058","23217","11217","12000",
"재송2동","총인구","2023.09 월","11041","23149","11192","11957",
"재송2동","총인구","2023.10 월","11013","23059","11153","11906",
"재송2동","총인구","2023.11 월","10989","23000","11141","11859",
"재송2동","총인구","2023.12 월","10990","22971","11122","11849",
"재송2동","총인구","2024.01 월","10979","22911","11087","11824",
"재송2동","총인구","2024.02 월","10977","22830","11048","11782",
"재송2동","총인구","2024.03 월","10967","22783","11023","11760",
"재송2동","총인구","2024.04 월","10971","22741","10991","11750",
"재송2동","총인구","2024.05 월","10947","22658","10953","11705",
"재송2동","총인구","2024.06 월","10919","22579","10917","11662",
"재송2동","총인구","2024.07 월","10916","22517","10878","11639",
"재송2동","총인구","2024.08 월","10880","22401","10818","11583",
"재송2동","총인구","2024.09 월","10850","22324","10797","11527",
"재송2동","총인구","2024.10 월","10810","22201","10764","11437",
"재송2동","총인구","2024.11 월","10793","22158","10729","11429",
"재송2동","총인구","2024.12 월","10791","22079","10693","11386",
"사하구","총인구","2020.01 월","138670","325219","162775","162444",
"사하구","총인구","2020.02 월","138770","324510","162456","162054",
"사하구","총인구","2020.03 월","138864","323758","162020","161738",
"사하구","총인구","2020.04 월","138813","322960","161595","161365",
"사하구","총인구","2020.05 월","138962","322439","161281","161158",
"사하구","총인구","2020.06 월","139108","321916","161035","160881",
"사하구","총인구","2020.07 월","139163","321352","160716","160636",
"사하구","총인구","2020.08 월","139139","320351","160190","160161",
"사하구","총인구","2020.09 월","139047","319277","159550","159727",
"사하구","총인구","2020.10 월","138879","318198","158937","159261",
"사하구","총인구","2020.11 월","138906","317333","158470","158863",
"사하구","총인구","2020.12 월","138854","316226","157924","158302",
"사하구","총인구","2021.01 월","138852","315489","157568","157921",
"사하구","총인구","2021.02 월","139159","315140","157418","157722",
"사하구","총인구","2021.03 월","138478","313704","156712","156992",
"사하구","총인구","2021.04 월","138475","313036","156337","156699",
"사하구","총인구","2021.05 월","138530","312377","156022","156355",
"사하구","총인구","2021.06 월","138589","311859","155713","156146",
"사하구","총인구","2021.07 월","138547","311146","155337","155809",
"사하구","총인구","2021.08 월","138893","311154","155328","155826",
"사하구","총인구","2021.09 월","139174","311091","155259","155832",
"사하구","총인구","2021.10 월","139393","310836","155076","155760",
"사하구","총인구","2021.11 월","139558","310651","154977","155674",
"사하구","총인구","2021.12 월","139604","310195","154681","155514",
"사하구","총인구","2022.01 월","139856","310108","154597","155511",
"사하구","총인구","2022.02 월","140385","310274","154680","155594",
"사하구","총인구","2022.03 월","140594","309924","154517","155407",
"사하구","총인구","2022.04 월","140807","309718","154399","155319",
"사하구","총인구","2022.05 월","140991","309583","154369","155214",
"사하구","총인구","2022.06 월","141003","309199","154125","155074",
"사하구","총인구","2022.07 월","141082","308777","153906","154871",
"사하구","총인구","2022.08 월","141176","308286","153638","154648",
"사하구","총인구","2022.09 월","140869","307465","153183","154282",
"사하구","총인구","2022.10 월","140904","307196","153035","154161",
"사하구","총인구","2022.11 월","140839","306893","152924","153969",
"사하구","총인구","2022.12 월","140778","306511","152728","153783",
"사하구","총인구","2023.01 월","140814","306473","152722","153751",
"사하구","총인구","2023.02 월","141291","306635","152804","153831",
"사하구","총인구","2023.03 월","141398","306547","152712","153835",
"사하구","총인구","2023.04 월","141450","306358","152578","153780",
"사하구","총인구","2023.05 월","141510","306147","152407","153740",
"사하구","총인구","2023.06 월","141455","305761","152255","153506",
"사하구","총인구","2023.07 월","141438","305316","152061","153255",
"사하구","총인구","2023.08 월","141279","304768","151770","152998",
"사하구","총인구","2023.09 월","141165","304469","151624","152845",
"사하구","총인구","2023.10 월","140951","303886","151409","152477",
"사하구","총인구","2023.11 월","140857","303412","151132","152280",
"사하구","총인구","2023.12 월","140764","302947","150934","152013",
"사하구","총인구","2024.01 월","140523","302178","150553","151625",
"사하구","총인구","2024.02 월","140577","301477","150253","151224",
"사하구","총인구","2024.03 월","140621","301091","150049","151042",
"사하구","총인구","2024.04 월","140503","300597","149807","150790",
"사하구","총인구","2024.05 월","140513","300161","149656","150505",
"사하구","총인구","2024.06 월","140424","299692","149390","150302",
"사하구","총인구","2024.07 월","140375","299290","149216","150074",
"사하구","총인구","2024.08 월","140252","298679","148889","149790",
"사하구","총인구","2024.09 월","140206","298316","148642","149674",
"사하구","총인구","2024.10 월","140404","298318","148634","149684",
"사하구","총인구","2024.11 월","140610","298418","148681","149737",
"사하구","총인구","2024.12 월","140631","298201","148601","149600",
"괴정1동","총인구","2020.01 월","8750","20716","10002","10714",
"괴정1동","총인구","2020.02 월","8773","20725","10013","10712",
"괴정1동","총인구","2020.03 월","8773","20697","10004","10693",
"괴정1동","총인구","2020.04 월","8763","20634","9977","10657",
"괴정1동","총인구","2020.05 월","8760","20583","9956","10627",
"괴정1동","총인구","2020.06 월","8739","20512","9918","10594",
"괴정1동","총인구","2020.07 월","8755","20516","9904","10612",
"괴정1동","총인구","2020.08 월","8743","20455","9877","10578",
"괴정1동","총인구","2020.09 월","8751","20423","9853","10570",
"괴정1동","총인구","2020.10 월","8748","20340","9802","10538",
"괴정1동","총인구","2020.11 월","8758","20308","9783","10525",
"괴정1동","총인구","2020.12 월","8783","20246","9753","10493",
"괴정1동","총인구","2021.01 월","8810","20251","9754","10497",
"괴정1동","총인구","2021.02 월","8795","20093","9677","10416",
"괴정1동","총인구","2021.03 월","8722","19972","9610","10362",
"괴정1동","총인구","2021.04 월","8733","19956","9609","10347",
"괴정1동","총인구","2021.05 월","8734","19900","9585","10315",
"괴정1동","총인구","2021.06 월","8721","19849","9567","10282",
"괴정1동","총인구","2021.07 월","8695","19778","9528","10250",
"괴정1동","총인구","2021.08 월","8691","19765","9509","10256",
"괴정1동","총인구","2021.09 월","8700","19738","9490","10248",
"괴정1동","총인구","2021.10 월","8728","19749","9486","10263",
"괴정1동","총인구","2021.11 월","8713","19670","9436","10234",
"괴정1동","총인구","2021.12 월","8722","19647","9427","10220",
"괴정1동","총인구","2022.01 월","8719","19549","9378","10171",
"괴정1동","총인구","2022.02 월","8697","19446","9322","10124",
"괴정1동","총인구","2022.03 월","8678","19370","9269","10101",
"괴정1동","총인구","2022.04 월","8669","19318","9248","10070",
"괴정1동","총인구","2022.05 월","8680","19293","9237","10056",
"괴정1동","총인구","2022.06 월","8673","19255","9204","10051",
"괴정1동","총인구","2022.07 월","8686","19243","9204","10039",
"괴정1동","총인구","2022.08 월","8670","19157","9157","10000",
"괴정1동","총인구","2022.09 월","8643","19074","9118","9956",
"괴정1동","총인구","2022.10 월","8627","19015","9093","9922",
"괴정1동","총인구","2022.11 월","8632","18988","9081","9907",
"괴정1동","총인구","2022.12 월","8634","18965","9076","9889",
"괴정1동","총인구","2023.01 월","8591","18843","9007","9836",
"괴정1동","총인구","2023.02 월","8602","18778","8959","9819",
"괴정1동","총인구","2023.03 월","8607","18726","8938","9788",
"괴정1동","총인구","2023.04 월","8597","18688","8918","9770",
"괴정1동","총인구","2023.05 월","8594","18636","8875","9761",
"괴정1동","총인구","2023.06 월","8576","18603","8866","9737",
"괴정1동","총인구","2023.07 월","8581","18549","8833","9716",
"괴정1동","총인구","2023.08 월","8574","18511","8813","9698",
"괴정1동","총인구","2023.09 월","8565","18468","8792","9676",
"괴정1동","총인구","2023.10 월","8542","18401","8767","9634",
"괴정1동","총인구","2023.11 월","8532","18332","8728","9604",
"괴정1동","총인구","2023.12 월","8505","18282","8705","9577",
"괴정1동","총인구","2024.01 월","8489","18230","8695","9535",
"괴정1동","총인구","2024.02 월","8496","18225","8685","9540",
"괴정1동","총인구","2024.03 월","8482","18163","8648","9515",
"괴정1동","총인구","2024.04 월","8444","18068","8611","9457",
"괴정1동","총인구","2024.05 월","8441","18025","8590","9435",
"괴정1동","총인구","2024.06 월","8412","17957","8556","9401",
"괴정1동","총인구","2024.07 월","8404","17946","8551","9395",
"괴정1동","총인구","2024.08 월","8408","17946","8538","9408",
"괴정1동","총인구","2024.09 월","8427","17930","8523","9407",
"괴정1동","총인구","2024.10 월","8402","17842","8476","9366",
"괴정1동","총인구","2024.11 월","8381","17769","8431","9338",
"괴정1동","총인구","2024.12 월","8364","17729","8400","9329",
"괴정2동","총인구","2020.01 월","6319","14899","7320","7579",
"괴정2동","총인구","2020.02 월","6319","14840","7285","7555",
"괴정2동","총인구","2020.03 월","6329","14855","7297","7558",
"괴정2동","총인구","2020.04 월","6324","14787","7269","7518",
"괴정2동","총인구","2020.05 월","6327","14740","7252","7488",
"괴정2동","총인구","2020.06 월","6329","14688","7227","7461",
"괴정2동","총인구","2020.07 월","6329","14636","7196","7440",
"괴정2동","총인구","2020.08 월","6342","14653","7200","7453",
"괴정2동","총인구","2020.09 월","6328","14596","7172","7424",
"괴정2동","총인구","2020.10 월","6310","14512","7127","7385",
"괴정2동","총인구","2020.11 월","6289","14443","7075","7368",
"괴정2동","총인구","2020.12 월","6298","14413","7068","7345",
"괴정2동","총인구","2021.01 월","6298","14381","7059","7322",
"괴정2동","총인구","2021.02 월","6302","14302","7007","7295",
"괴정2동","총인구","2021.03 월","6262","14244","6990","7254",
"괴정2동","총인구","2021.04 월","6252","14208","6966","7242",
"괴정2동","총인구","2021.05 월","6250","14148","6926","7222",
"괴정2동","총인구","2021.06 월","6262","14148","6929","7219",
"괴정2동","총인구","2021.07 월","6277","14175","6935","7240",
"괴정2동","총인구","2021.08 월","6285","14147","6911","7236",
"괴정2동","총인구","2021.09 월","6293","14118","6903","7215",
"괴정2동","총인구","2021.10 월","6306","14113","6897","7216",
"괴정2동","총인구","2021.11 월","6309","14116","6898","7218",
"괴정2동","총인구","2021.12 월","6306","14092","6897","7195",
"괴정2동","총인구","2022.01 월","6515","14612","7144","7468",
"괴정2동","총인구","2022.02 월","6721","15137","7385","7752",
"괴정2동","총인구","2022.03 월","6821","15305","7460","7845",
"괴정2동","총인구","2022.04 월","6907","15440","7512","7928",
"괴정2동","총인구","2022.05 월","6961","15540","7556","7984",
"괴정2동","총인구","2022.06 월","6993","15594","7586","8008",
"괴정2동","총인구","2022.07 월","7019","15641","7598","8043",
"괴정2동","총인구","2022.08 월","7029","15636","7602","8034",
"괴정2동","총인구","2022.09 월","7018","15603","7570","8033",
"괴정2동","총인구","2022.10 월","7016","15593","7566","8027",
"괴정2동","총인구","2022.11 월","7015","15569","7548","8021",
"괴정2동","총인구","2022.12 월","7015","15546","7534","8012",
"괴정2동","총인구","2023.01 월","6997","15500","7498","8002",
"괴정2동","총인구","2023.02 월","6989","15473","7493","7980",
"괴정2동","총인구","2023.03 월","6976","15403","7454","7949",
"괴정2동","총인구","2023.04 월","6977","15408","7451","7957",
"괴정2동","총인구","2023.05 월","6987","15406","7459","7947",
"괴정2동","총인구","2023.06 월","6979","15367","7437","7930",
"괴정2동","총인구","2023.07 월","6977","15364","7427","7937",
"괴정2동","총인구","2023.08 월","6967","15348","7414","7934",
"괴정2동","총인구","2023.09 월","6963","15342","7410","7932",
"괴정2동","총인구","2023.10 월","6949","15301","7387","7914",
"괴정2동","총인구","2023.11 월","6935","15286","7383","7903",
"괴정2동","총인구","2023.12 월","6932","15264","7375","7889",
"괴정2동","총인구","2024.01 월","6906","15177","7326","7851",
"괴정2동","총인구","2024.02 월","6906","15125","7303","7822",
"괴정2동","총인구","2024.03 월","6893","15044","7260","7784",
"괴정2동","총인구","2024.04 월","6875","14994","7231","7763",
"괴정2동","총인구","2024.05 월","6880","14967","7221","7746",
"괴정2동","총인구","2024.06 월","6884","14962","7225","7737",
"괴정2동","총인구","2024.07 월","6884","14941","7222","7719",
"괴정2동","총인구","2024.08 월","6877","14887","7203","7684",
"괴정2동","총인구","2024.09 월","6866","14873","7193","7680",
"괴정2동","총인구","2024.10 월","6841","14809","7162","7647",
"괴정2동","총인구","2024.11 월","6842","14822","7172","7650",
"괴정2동","총인구","2024.12 월","6849","14801","7166","7635",
"괴정3동","총인구","2020.01 월","6526","13418","6436","6982",
"괴정3동","총인구","2020.02 월","6515","13368","6417","6951",
"괴정3동","총인구","2020.03 월","6541","13332","6401","6931",
"괴정3동","총인구","2020.04 월","6547","13300","6387","6913",
"괴정3동","총인구","2020.05 월","6556","13267","6371","6896",
"괴정3동","총인구","2020.06 월","6584","13307","6391","6916",
"괴정3동","총인구","2020.07 월","6580","13272","6371","6901",
"괴정3동","총인구","2020.08 월","6586","13241","6356","6885",
"괴정3동","총인구","2020.09 월","6589","13190","6337","6853",
"괴정3동","총인구","2020.10 월","6565","13112","6301","6811",
"괴정3동","총인구","2020.11 월","6582","13072","6291","6781",
"괴정3동","총인구","2020.12 월","6594","13054","6280","6774",
"괴정3동","총인구","2021.01 월","6574","13004","6251","6753",
"괴정3동","총인구","2021.02 월","6599","13013","6255","6758",
"괴정3동","총인구","2021.03 월","6493","12848","6184","6664",
"괴정3동","총인구","2021.04 월","6476","12770","6146","6624",
"괴정3동","총인구","2021.05 월","6465","12718","6122","6596",
"괴정3동","총인구","2021.06 월","6462","12705","6107","6598",
"괴정3동","총인구","2021.07 월","6442","12645","6083","6562",
"괴정3동","총인구","2021.08 월","6436","12614","6067","6547",
"괴정3동","총인구","2021.09 월","6447","12624","6061","6563",
"괴정3동","총인구","2021.10 월","6451","12590","6029","6561",
"괴정3동","총인구","2021.11 월","6460","12574","6011","6563",
"괴정3동","총인구","2021.12 월","6449","12551","5993","6558",
"괴정3동","총인구","2022.01 월","6443","12465","5952","6513",
"괴정3동","총인구","2022.02 월","6405","12365","5898","6467",
"괴정3동","총인구","2022.03 월","6389","12301","5863","6438",
"괴정3동","총인구","2022.04 월","6390","12262","5850","6412",
"괴정3동","총인구","2022.05 월","6379","12249","5849","6400",
"괴정3동","총인구","2022.06 월","6392","12277","5861","6416",
"괴정3동","총인구","2022.07 월","6392","12253","5844","6409",
"괴정3동","총인구","2022.08 월","6391","12232","5837","6395",
"괴정3동","총인구","2022.09 월","6367","12197","5805","6392",
"괴정3동","총인구","2022.10 월","6363","12165","5792","6373",
"괴정3동","총인구","2022.11 월","6348","12116","5766","6350",
"괴정3동","총인구","2022.12 월","6354","12118","5763","6355",
"괴정3동","총인구","2023.01 월","6330","12064","5746","6318",
"괴정3동","총인구","2023.02 월","6351","12043","5725","6318",
"괴정3동","총인구","2023.03 월","6337","12009","5704","6305",
"괴정3동","총인구","2023.04 월","6343","11981","5686","6295",
"괴정3동","총인구","2023.05 월","6335","11968","5689","6279",
"괴정3동","총인구","2023.06 월","6327","11921","5668","6253",
"괴정3동","총인구","2023.07 월","6333","11884","5659","6225",
"괴정3동","총인구","2023.08 월","6316","11810","5623","6187",
"괴정3동","총인구","2023.09 월","6329","11803","5611","6192",
"괴정3동","총인구","2023.10 월","6308","11752","5590","6162",
"괴정3동","총인구","2023.11 월","6296","11693","5561","6132",
"괴정3동","총인구","2023.12 월","6286","11680","5554","6126",
"괴정3동","총인구","2024.01 월","6291","11671","5541","6130",
"괴정3동","총인구","2024.02 월","6294","11638","5530","6108",
"괴정3동","총인구","2024.03 월","6301","11613","5507","6106",
"괴정3동","총인구","2024.04 월","6311","11644","5525","6119",
"괴정3동","총인구","2024.05 월","6304","11626","5515","6111",
"괴정3동","총인구","2024.06 월","6294","11598","5502","6096",
"괴정3동","총인구","2024.07 월","6289","11597","5511","6086",
"괴정3동","총인구","2024.08 월","6274","11578","5499","6079",
"괴정3동","총인구","2024.09 월","6267","11543","5486","6057",
"괴정3동","총인구","2024.10 월","6254","11513","5469","6044",
"괴정3동","총인구","2024.11 월","6237","11474","5448","6026",
"괴정3동","총인구","2024.12 월","6223","11429","5415","6014",
"괴정4동","총인구","2020.01 월","5233","11861","5760","6101",
"괴정4동","총인구","2020.02 월","5221","11804","5724","6080",
"괴정4동","총인구","2020.03 월","5211","11753","5707","6046",
"괴정4동","총인구","2020.04 월","5195","11727","5692","6035",
"괴정4동","총인구","2020.05 월","5202","11720","5682","6038",
"괴정4동","총인구","2020.06 월","5188","11659","5645","6014",
"괴정4동","총인구","2020.07 월","5186","11604","5621","5983",
"괴정4동","총인구","2020.08 월","5191","11567","5597","5970",
"괴정4동","총인구","2020.09 월","5186","11531","5576","5955",
"괴정4동","총인구","2020.10 월","5194","11516","5569","5947",
"괴정4동","총인구","2020.11 월","5181","11489","5548","5941",
"괴정4동","총인구","2020.12 월","5176","11426","5524","5902",
"괴정4동","총인구","2021.01 월","5181","11399","5517","5882",
"괴정4동","총인구","2021.02 월","5430","12126","5897","6229",
"괴정4동","총인구","2021.03 월","5485","12347","6005","6342",
"괴정4동","총인구","2021.04 월","5521","12434","6023","6411",
"괴정4동","총인구","2021.05 월","5557","12503","6046","6457",
"괴정4동","총인구","2021.06 월","5552","12484","6042","6442",
"괴정4동","총인구","2021.07 월","5552","12445","6018","6427",
"괴정4동","총인구","2021.08 월","5558","12414","6001","6413",
"괴정4동","총인구","2021.09 월","5569","12406","6004","6402",
"괴정4동","총인구","2021.10 월","5558","12343","5985","6358",
"괴정4동","총인구","2021.11 월","5562","12371","6007","6364",
"괴정4동","총인구","2021.12 월","5553","12331","5982","6349",
"괴정4동","총인구","2022.01 월","5534","12253","5951","6302",
"괴정4동","총인구","2022.02 월","5519","12211","5939","6272",
"괴정4동","총인구","2022.03 월","5501","12143","5909","6234",
"괴정4동","총인구","2022.04 월","5495","12108","5888","6220",
"괴정4동","총인구","2022.05 월","5501","12083","5869","6214",
"괴정4동","총인구","2022.06 월","5501","12078","5871","6207",
"괴정4동","총인구","2022.07 월","5492","12042","5864","6178",
"괴정4동","총인구","2022.08 월","5489","12032","5860","6172",
"괴정4동","총인구","2022.09 월","5469","11988","5833","6155",
"괴정4동","총인구","2022.10 월","5464","11982","5828","6154",
"괴정4동","총인구","2022.11 월","5458","11968","5826","6142",
"괴정4동","총인구","2022.12 월","5459","11975","5826","6149",
"괴정4동","총인구","2023.01 월","5705","12679","6181","6498",
"괴정4동","총인구","2023.02 월","6059","13707","6712","6995",
"괴정4동","총인구","2023.03 월","6299","14318","7018","7300",
"괴정4동","총인구","2023.04 월","6397","14595","7144","7451",
"괴정4동","총인구","2023.05 월","6500","14877","7261","7616",
"괴정4동","총인구","2023.06 월","6551","15012","7318","7694",
"괴정4동","총인구","2023.07 월","6573","15078","7356","7722",
"괴정4동","총인구","2023.08 월","6596","15172","7406","7766",
"괴정4동","총인구","2023.09 월","6603","15206","7421","7785",
"괴정4동","총인구","2023.10 월","6617","15261","7459","7802",
"괴정4동","총인구","2023.11 월","6616","15288","7472","7816",
"괴정4동","총인구","2023.12 월","6608","15278","7474","7804",
"괴정4동","총인구","2024.01 월","6598","15266","7456","7810",
"괴정4동","총인구","2024.02 월","6599","15248","7447","7801",
"괴정4동","총인구","2024.03 월","6593","15211","7429","7782",
"괴정4동","총인구","2024.04 월","6585","15198","7421","7777",
"괴정4동","총인구","2024.05 월","6598","15188","7417","7771",
"괴정4동","총인구","2024.06 월","6600","15174","7410","7764",
"괴정4동","총인구","2024.07 월","6602","15146","7399","7747",
"괴정4동","총인구","2024.08 월","6585","15111","7379","7732",
"괴정4동","총인구","2024.09 월","6584","15090","7369","7721",
"괴정4동","총인구","2024.10 월","6560","15027","7337","7690",
"괴정4동","총인구","2024.11 월","6550","14990","7324","7666",
"괴정4동","총인구","2024.12 월","6553","14966","7316","7650",
"당리동","총인구","2020.01 월","11573","28459","13984","14475",
"당리동","총인구","2020.02 월","11553","28312","13930","14382",
"당리동","총인구","2020.03 월","11527","28217","13896","14321",
"당리동","총인구","2020.04 월","11523","28112","13829","14283",
"당리동","총인구","2020.05 월","11546","28049","13771","14278",
"당리동","총인구","2020.06 월","11547","27963","13722","14241",
"당리동","총인구","2020.07 월","11545","27945","13704","14241",
"당리동","총인구","2020.08 월","11512","27797","13631","14166",
"당리동","총인구","2020.09 월","11471","27644","13562","14082",
"당리동","총인구","2020.10 월","11466","27596","13534","14062",
"당리동","총인구","2020.11 월","11475","27536","13505","14031",
"당리동","총인구","2020.12 월","11439","27390","13421","13969",
"당리동","총인구","2021.01 월","11420","27284","13363","13921",
"당리동","총인구","2021.02 월","11393","27156","13297","13859",
"당리동","총인구","2021.03 월","11367","27037","13228","13809",
"당리동","총인구","2021.04 월","11364","26964","13212","13752",
"당리동","총인구","2021.05 월","11371","26930","13185","13745",
"당리동","총인구","2021.06 월","11364","26859","13140","13719",
"당리동","총인구","2021.07 월","11367","26778","13110","13668",
"당리동","총인구","2021.08 월","11384","26752","13096","13656",
"당리동","총인구","2021.09 월","11399","26729","13084","13645",
"당리동","총인구","2021.10 월","11431","26720","13063","13657",
"당리동","총인구","2021.11 월","11445","26719","13043","13676",
"당리동","총인구","2021.12 월","11445","26697","13028","13669",
"당리동","총인구","2022.01 월","11430","26572","12949","13623",
"당리동","총인구","2022.02 월","11402","26398","12863","13535",
"당리동","총인구","2022.03 월","11361","26279","12817","13462",
"당리동","총인구","2022.04 월","11361","26185","12763","13422",
"당리동","총인구","2022.05 월","11361","26148","12764","13384",
"당리동","총인구","2022.06 월","11367","26117","12764","13353",
"당리동","총인구","2022.07 월","11376","26098","12744","13354",
"당리동","총인구","2022.08 월","11388","26049","12701","13348",
"당리동","총인구","2022.09 월","11364","25982","12661","13321",
"당리동","총인구","2022.10 월","11346","25935","12646","13289",
"당리동","총인구","2022.11 월","11305","25831","12592","13239",
"당리동","총인구","2022.12 월","11290","25750","12548","13202",
"당리동","총인구","2023.01 월","11260","25650","12486","13164",
"당리동","총인구","2023.02 월","11219","25454","12384","13070",
"당리동","총인구","2023.03 월","11158","25258","12272","12986",
"당리동","총인구","2023.04 월","11119","25134","12206","12928",
"당리동","총인구","2023.05 월","11043","24948","12120","12828",
"당리동","총인구","2023.06 월","11014","24857","12086","12771",
"당리동","총인구","2023.07 월","11008","24806","12055","12751",
"당리동","총인구","2023.08 월","10989","24716","12006","12710",
"당리동","총인구","2023.09 월","10970","24665","11980","12685",
"당리동","총인구","2023.10 월","10958","24613","11952","12661",
"당리동","총인구","2023.11 월","10945","24555","11941","12614",
"당리동","총인구","2023.12 월","10933","24495","11911","12584",
"당리동","총인구","2024.01 월","10912","24407","11867","12540",
"당리동","총인구","2024.02 월","10919","24370","11846","12524",
"당리동","총인구","2024.03 월","10946","24375","11855","12520",
"당리동","총인구","2024.04 월","10932","24301","11813","12488",
"당리동","총인구","2024.05 월","10910","24228","11788","12440",
"당리동","총인구","2024.06 월","10907","24178","11772","12406",
"당리동","총인구","2024.07 월","10905","24122","11730","12392",
"당리동","총인구","2024.08 월","10890","24070","11704","12366",
"당리동","총인구","2024.09 월","10868","23993","11656","12337",
"당리동","총인구","2024.10 월","10834","23934","11625","12309",
"당리동","총인구","2024.11 월","10832","23891","11607","12284",
"당리동","총인구","2024.12 월","10798","23778","11560","12218",
"하단1동","총인구","2020.01 월","10065","22465","11262","11203",
"하단1동","총인구","2020.02 월","10124","22497","11272","11225",
"하단1동","총인구","2020.03 월","10167","22455","11249","11206",
"하단1동","총인구","2020.04 월","10182","22467","11232","11235",
"하단1동","총인구","2020.05 월","10211","22455","11222","11233",
"하단1동","총인구","2020.06 월","10233","22429","11206","11223",
"하단1동","총인구","2020.07 월","10247","22414","11190","11224",
"하단1동","총인구","2020.08 월","10250","22331","11153","11178",
"하단1동","총인구","2020.09 월","10267","22272","11102","11170",
"하단1동","총인구","2020.10 월","10250","22189","11042","11147",
"하단1동","총인구","2020.11 월","10234","22088","10983","11105",
"하단1동","총인구","2020.12 월","10231","22030","10956","11074",
"하단1동","총인구","2021.01 월","10247","21999","10942","11057",
"하단1동","총인구","2021.02 월","10230","21934","10935","10999",
"하단1동","총인구","2021.03 월","10204","21813","10878","10935",
"하단1동","총인구","2021.04 월","10210","21788","10855","10933",
"하단1동","총인구","2021.05 월","10193","21706","10812","10894",
"하단1동","총인구","2021.06 월","10238","21752","10836","10916",
"하단1동","총인구","2021.07 월","10264","21735","10825","10910",
"하단1동","총인구","2021.08 월","10276","21697","10793","10904",
"하단1동","총인구","2021.09 월","10296","21690","10796","10894",
"하단1동","총인구","2021.10 월","10328","21729","10815","10914",
"하단1동","총인구","2021.11 월","10376","21747","10823","10924",
"하단1동","총인구","2021.12 월","10401","21761","10819","10942",
"하단1동","총인구","2022.01 월","10396","21707","10773","10934",
"하단1동","총인구","2022.02 월","10417","21600","10733","10867",
"하단1동","총인구","2022.03 월","10432","21594","10732","10862",
"하단1동","총인구","2022.04 월","10453","21571","10732","10839",
"하단1동","총인구","2022.05 월","10469","21551","10722","10829",
"하단1동","총인구","2022.06 월","10492","21518","10710","10808",
"하단1동","총인구","2022.07 월","10515","21523","10715","10808",
"하단1동","총인구","2022.08 월","10571","21604","10749","10855",
"하단1동","총인구","2022.09 월","10560","21583","10740","10843",
"하단1동","총인구","2022.10 월","10681","21706","10808","10898",
"하단1동","총인구","2022.11 월","10729","21722","10794","10928",
"하단1동","총인구","2022.12 월","10792","21784","10827","10957",
"하단1동","총인구","2023.01 월","10845","21836","10852","10984",
"하단1동","총인구","2023.02 월","10897","21824","10847","10977",
"하단1동","총인구","2023.03 월","10907","21797","10826","10971",
"하단1동","총인구","2023.04 월","10928","21816","10841","10975",
"하단1동","총인구","2023.05 월","10961","21851","10852","10999",
"하단1동","총인구","2023.06 월","10981","21830","10841","10989",
"하단1동","총인구","2023.07 월","11001","21832","10853","10979",
"하단1동","총인구","2023.08 월","10983","21787","10827","10960",
"하단1동","총인구","2023.09 월","10978","21766","10844","10922",
"하단1동","총인구","2023.10 월","10947","21717","10823","10894",
"하단1동","총인구","2023.11 월","10955","21753","10842","10911",
"하단1동","총인구","2023.12 월","10955","21701","10822","10879",
"하단1동","총인구","2024.01 월","10935","21642","10780","10862",
"하단1동","총인구","2024.02 월","10929","21589","10745","10844",
"하단1동","총인구","2024.03 월","10932","21553","10720","10833",
"하단1동","총인구","2024.04 월","10947","21548","10720","10828",
"하단1동","총인구","2024.05 월","10931","21470","10689","10781",
"하단1동","총인구","2024.06 월","10930","21453","10693","10760",
"하단1동","총인구","2024.07 월","10924","21400","10655","10745",
"하단1동","총인구","2024.08 월","10930","21377","10643","10734",
"하단1동","총인구","2024.09 월","10922","21372","10646","10726",
"하단1동","총인구","2024.10 월","10894","21273","10602","10671",
"하단1동","총인구","2024.11 월","10891","21196","10573","10623",
"하단1동","총인구","2024.12 월","10869","21139","10531","10608",
"하단2동","총인구","2020.01 월","12138","26441","13162","13279",
"하단2동","총인구","2020.02 월","12255","26483","13208","13275",
"하단2동","총인구","2020.03 월","12276","26434","13176","13258",
"하단2동","총인구","2020.04 월","12276","26340","13141","13199",
"하단2동","총인구","2020.05 월","12308","26352","13139","13213",
"하단2동","총인구","2020.06 월","12325","26292","13107","13185",
"하단2동","총인구","2020.07 월","12360","26280","13108","13172",
"하단2동","총인구","2020.08 월","12377","26208","13065","13143",
"하단2동","총인구","2020.09 월","12378","26107","12988","13119",
"하단2동","총인구","2020.10 월","12353","26005","12918","13087",
"하단2동","총인구","2020.11 월","12387","25981","12911","13070",
"하단2동","총인구","2020.12 월","12376","25889","12860","13029",
"하단2동","총인구","2021.01 월","12370","25800","12824","12976",
"하단2동","총인구","2021.02 월","12446","25745","12797","12948",
"하단2동","총인구","2021.03 월","12572","25810","12826","12984",
"하단2동","총인구","2021.04 월","12548","25720","12785","12935",
"하단2동","총인구","2021.05 월","12609","25760","12822","12938",
"하단2동","총인구","2021.06 월","12646","25768","12824","12944",
"하단2동","총인구","2021.07 월","12672","25745","12806","12939",
"하단2동","총인구","2021.08 월","12712","25749","12839","12910",
"하단2동","총인구","2021.09 월","12760","25806","12857","12949",
"하단2동","총인구","2021.10 월","12797","25819","12857","12962",
"하단2동","총인구","2021.11 월","12846","25823","12862","12961",
"하단2동","총인구","2021.12 월","12871","25799","12849","12950",
"하단2동","총인구","2022.01 월","12832","25691","12809","12882",
"하단2동","총인구","2022.02 월","12960","25737","12857","12880",
"하단2동","총인구","2022.03 월","13024","25738","12879","12859",
"하단2동","총인구","2022.04 월","13057","25735","12892","12843",
"하단2동","총인구","2022.05 월","13097","25759","12902","12857",
"하단2동","총인구","2022.06 월","13102","25762","12895","12867",
"하단2동","총인구","2022.07 월","13134","25742","12906","12836",
"하단2동","총인구","2022.08 월","13231","25814","12956","12858",
"하단2동","총인구","2022.09 월","13250","25849","12965","12884",
"하단2동","총인구","2022.10 월","13271","25860","12986","12874",
"하단2동","총인구","2022.11 월","13285","25873","12998","12875",
"하단2동","총인구","2022.12 월","13245","25790","12951","12839",
"하단2동","총인구","2023.01 월","13210","25716","12934","12782",
"하단2동","총인구","2023.02 월","13372","25767","12990","12777",
"하단2동","총인구","2023.03 월","13421","25866","13007","12859",
"하단2동","총인구","2023.04 월","13415","25825","12975","12850",
"하단2동","총인구","2023.05 월","13440","25865","12981","12884",
"하단2동","총인구","2023.06 월","13445","25821","12951","12870",
"하단2동","총인구","2023.07 월","13449","25797","12942","12855",
"하단2동","총인구","2023.08 월","13501","25851","12968","12883",
"하단2동","총인구","2023.09 월","13498","25883","12956","12927",
"하단2동","총인구","2023.10 월","13494","25809","12951","12858",
"하단2동","총인구","2023.11 월","13497","25809","12935","12874",
"하단2동","총인구","2023.12 월","13513","25813","12942","12871",
"하단2동","총인구","2024.01 월","13454","25689","12861","12828",
"하단2동","총인구","2024.02 월","13561","25688","12920","12768",
"하단2동","총인구","2024.03 월","13628","25770","12970","12800",
"하단2동","총인구","2024.04 월","13627","25744","12957","12787",
"하단2동","총인구","2024.05 월","13654","25760","12966","12794",
"하단2동","총인구","2024.06 월","13644","25722","12923","12799",
"하단2동","총인구","2024.07 월","13668","25716","12950","12766",
"하단2동","총인구","2024.08 월","13676","25675","12947","12728",
"하단2동","총인구","2024.09 월","13669","25709","12948","12761",
"하단2동","총인구","2024.10 월","13667","25661","12919","12742",
"하단2동","총인구","2024.11 월","13663","25609","12889","12720",
"하단2동","총인구","2024.12 월","13642","25553","12881","12672",
"신평1동","총인구","2020.01 월","8491","18585","9658","8927",
"신평1동","총인구","2020.02 월","8494","18561","9657","8904",
"신평1동","총인구","2020.03 월","8497","18505","9596","8909",
"신평1동","총인구","2020.04 월","8512","18507","9596","8911",
"신평1동","총인구","2020.05 월","8519","18469","9575","8894",
"신평1동","총인구","2020.06 월","8516","18433","9546","8887",
"신평1동","총인구","2020.07 월","8511","18395","9541","8854",
"신평1동","총인구","2020.08 월","8490","18314","9493","8821",
"신평1동","총인구","2020.09 월","8481","18246","9448","8798",
"신평1동","총인구","2020.10 월","8469","18171","9403","8768",
"신평1동","총인구","2020.11 월","8478","18155","9393","8762",
"신평1동","총인구","2020.12 월","8482","18127","9371","8756",
"신평1동","총인구","2021.01 월","8462","18068","9342","8726",
"신평1동","총인구","2021.02 월","8445","17997","9311","8686",
"신평1동","총인구","2021.03 월","8297","17797","9227","8570",
"신평1동","총인구","2021.04 월","8295","17771","9242","8529",
"신평1동","총인구","2021.05 월","8290","17715","9231","8484",
"신평1동","총인구","2021.06 월","8292","17658","9188","8470",
"신평1동","총인구","2021.07 월","8275","17609","9162","8447",
"신평1동","총인구","2021.08 월","8261","17546","9138","8408",
"신평1동","총인구","2021.09 월","8262","17493","9116","8377",
"신평1동","총인구","2021.10 월","8258","17454","9104","8350",
"신평1동","총인구","2021.11 월","8261","17414","9083","8331",
"신평1동","총인구","2021.12 월","8258","17362","9057","8305",
"신평1동","총인구","2022.01 월","8244","17290","9016","8274",
"신평1동","총인구","2022.02 월","8221","17192","8962","8230",
"신평1동","총인구","2022.03 월","8222","17119","8933","8186",
"신평1동","총인구","2022.04 월","8235","17108","8917","8191",
"신평1동","총인구","2022.05 월","8233","17097","8909","8188",
"신평1동","총인구","2022.06 월","8208","17028","8875","8153",
"신평1동","총인구","2022.07 월","8203","16975","8831","8144",
"신평1동","총인구","2022.08 월","8207","16953","8814","8139",
"신평1동","총인구","2022.09 월","8170","16858","8759","8099",
"신평1동","총인구","2022.10 월","8152","16816","8735","8081",
"신평1동","총인구","2022.11 월","8138","16758","8705","8053",
"신평1동","총인구","2022.12 월","8122","16710","8675","8035",
"신평1동","총인구","2023.01 월","8106","16668","8662","8006",
"신평1동","총인구","2023.02 월","8079","16562","8600","7962",
"신평1동","총인구","2023.03 월","8059","16492","8563","7929",
"신평1동","총인구","2023.04 월","8047","16464","8546","7918",
"신평1동","총인구","2023.05 월","8039","16442","8537","7905",
"신평1동","총인구","2023.06 월","8018","16408","8523","7885",
"신평1동","총인구","2023.07 월","8019","16368","8494","7874",
"신평1동","총인구","2023.08 월","7987","16273","8459","7814",
"신평1동","총인구","2023.09 월","7971","16265","8462","7803",
"신평1동","총인구","2023.10 월","7967","16280","8476","7804",
"신평1동","총인구","2023.11 월","7951","16257","8473","7784",
"신평1동","총인구","2023.12 월","7944","16222","8456","7766",
"신평1동","총인구","2024.01 월","7915","16195","8442","7753",
"신평1동","총인구","2024.02 월","7903","16140","8416","7724",
"신평1동","총인구","2024.03 월","7905","16154","8428","7726",
"신평1동","총인구","2024.04 월","7913","16151","8421","7730",
"신평1동","총인구","2024.05 월","7907","16144","8427","7717",
"신평1동","총인구","2024.06 월","7897","16117","8411","7706",
"신평1동","총인구","2024.07 월","7881","16086","8396","7690",
"신평1동","총인구","2024.08 월","7878","16040","8373","7667",
"신평1동","총인구","2024.09 월","7884","16012","8355","7657",
"신평1동","총인구","2024.10 월","7851","15953","8323","7630",
"신평1동","총인구","2024.11 월","7807","15872","8290","7582",
"신평1동","총인구","2024.12 월","7782","15800","8260","7540",
"신평2동","총인구","2020.01 월","6611","16693","8487","8206",
"신평2동","총인구","2020.02 월","6610","16657","8465","8192",
"신평2동","총인구","2020.03 월","6625","16678","8454","8224",
"신평2동","총인구","2020.04 월","6637","16664","8444","8220",
"신평2동","총인구","2020.05 월","6672","16689","8445","8244",
"신평2동","총인구","2020.06 월","6692","16716","8474","8242",
"신평2동","총인구","2020.07 월","6700","16709","8468","8241",
"신평2동","총인구","2020.08 월","6711","16651","8427","8224",
"신평2동","총인구","2020.09 월","6704","16581","8385","8196",
"신평2동","총인구","2020.10 월","6688","16514","8358","8156",
"신평2동","총인구","2020.11 월","6698","16474","8343","8131",
"신평2동","총인구","2020.12 월","6681","16363","8268","8095",
"신평2동","총인구","2021.01 월","6684","16354","8268","8086",
"신평2동","총인구","2021.02 월","6709","16353","8258","8095",
"신평2동","총인구","2021.03 월","6682","16259","8202","8057",
"신평2동","총인구","2021.04 월","6666","16184","8149","8035",
"신평2동","총인구","2021.05 월","6679","16158","8131","8027",
"신평2동","총인구","2021.06 월","6679","16125","8112","8013",
"신평2동","총인구","2021.07 월","6691","16111","8101","8010",
"신평2동","총인구","2021.08 월","6706","16073","8085","7988",
"신평2동","총인구","2021.09 월","6711","16059","8090","7969",
"신평2동","총인구","2021.10 월","6721","16047","8085","7962",
"신평2동","총인구","2021.11 월","6742","16053","8102","7951",
"신평2동","총인구","2021.12 월","6733","16033","8084","7949",
"신평2동","총인구","2022.01 월","6990","16611","8363","8248",
"신평2동","총인구","2022.02 월","7373","17493","8814","8679",
"신평2동","총인구","2022.03 월","7503","17781","8973","8808",
"신평2동","총인구","2022.04 월","7572","17902","9025","8877",
"신평2동","총인구","2022.05 월","7596","17953","9054","8899",
"신평2동","총인구","2022.06 월","7607","17968","9057","8911",
"신평2동","총인구","2022.07 월","7610","17962","9043","8919",
"신평2동","총인구","2022.08 월","7597","17899","9004","8895",
"신평2동","총인구","2022.09 월","7608","17887","9000","8887",
"신평2동","총인구","2022.10 월","7615","17904","8999","8905",
"신평2동","총인구","2022.11 월","7613","17939","9019","8920",
"신평2동","총인구","2022.12 월","7605","17932","9017","8915",
"신평2동","총인구","2023.01 월","7582","17881","8971","8910",
"신평2동","총인구","2023.02 월","7575","17832","8947","8885",
"신평2동","총인구","2023.03 월","7549","17787","8917","8870",
"신평2동","총인구","2023.04 월","7548","17750","8901","8849",
"신평2동","총인구","2023.05 월","7557","17751","8903","8848",
"신평2동","총인구","2023.06 월","7557","17757","8918","8839",
"신평2동","총인구","2023.07 월","7554","17734","8915","8819",
"신평2동","총인구","2023.08 월","7561","17761","8928","8833",
"신평2동","총인구","2023.09 월","7560","17750","8911","8839",
"신평2동","총인구","2023.10 월","7548","17717","8894","8823",
"신평2동","총인구","2023.11 월","7554","17716","8884","8832",
"신평2동","총인구","2023.12 월","7546","17715","8887","8828",
"신평2동","총인구","2024.01 월","7541","17693","8886","8807",
"신평2동","총인구","2024.02 월","7532","17631","8861","8770",
"신평2동","총인구","2024.03 월","7521","17591","8839","8752",
"신평2동","총인구","2024.04 월","7526","17585","8848","8737",
"신평2동","총인구","2024.05 월","7525","17561","8838","8723",
"신평2동","총인구","2024.06 월","7526","17560","8847","8713",
"신평2동","총인구","2024.07 월","7530","17537","8828","8709",
"신평2동","총인구","2024.08 월","7533","17525","8818","8707",
"신평2동","총인구","2024.09 월","7536","17515","8813","8702",
"신평2동","총인구","2024.10 월","7525","17399","8757","8642",
"신평2동","총인구","2024.11 월","7507","17343","8722","8621",
"신평2동","총인구","2024.12 월","7517","17379","8736","8643",
"장림1동","총인구","2020.01 월","5499","13018","7013","6005",
"장림1동","총인구","2020.02 월","5472","12952","6985","5967",
"장림1동","총인구","2020.03 월","5402","12808","6895","5913",
"장림1동","총인구","2020.04 월","5330","12636","6804","5832",
"장림1동","총인구","2020.05 월","5293","12509","6727","5782",
"장림1동","총인구","2020.06 월","5243","12388","6659","5729",
"장림1동","총인구","2020.07 월","5213","12300","6609","5691",
"장림1동","총인구","2020.08 월","5212","12255","6589","5666",
"장림1동","총인구","2020.09 월","5196","12198","6553","5645",
"장림1동","총인구","2020.10 월","5184","12132","6504","5628",
"장림1동","총인구","2020.11 월","5147","12009","6436","5573",
"장림1동","총인구","2020.12 월","5107","11894","6371","5523",
"장림1동","총인구","2021.01 월","5100","11855","6346","5509",
"장림1동","총인구","2021.02 월","5078","11751","6281","5470",
"장림1동","총인구","2021.03 월","5012","11631","6219","5412",
"장림1동","총인구","2021.04 월","5009","11604","6201","5403",
"장림1동","총인구","2021.05 월","4997","11557","6173","5384",
"장림1동","총인구","2021.06 월","4995","11537","6160","5377",
"장림1동","총인구","2021.07 월","4994","11496","6143","5353",
"장림1동","총인구","2021.08 월","4993","11489","6135","5354",
"장림1동","총인구","2021.09 월","4997","11460","6116","5344",
"장림1동","총인구","2021.10 월","4971","11404","6074","5330",
"장림1동","총인구","2021.11 월","4967","11380","6057","5323",
"장림1동","총인구","2021.12 월","4963","11332","6026","5306",
"장림1동","총인구","2022.01 월","4952","11293","6003","5290",
"장림1동","총인구","2022.02 월","4936","11243","5969","5274",
"장림1동","총인구","2022.03 월","4945","11203","5953","5250",
"장림1동","총인구","2022.04 월","4943","11189","5945","5244",
"장림1동","총인구","2022.05 월","4948","11188","5949","5239",
"장림1동","총인구","2022.06 월","4935","11157","5935","5222",
"장림1동","총인구","2022.07 월","4931","11144","5929","5215",
"장림1동","총인구","2022.08 월","4942","11141","5935","5206",
"장림1동","총인구","2022.09 월","4942","11149","5939","5210",
"장림1동","총인구","2022.10 월","4941","11156","5938","5218",
"장림1동","총인구","2022.11 월","4914","11146","5940","5206",
"장림1동","총인구","2022.12 월","4906","11120","5934","5186",
"장림1동","총인구","2023.01 월","4900","11105","5927","5178",
"장림1동","총인구","2023.02 월","4891","11065","5893","5172",
"장림1동","총인구","2023.03 월","4875","11011","5864","5147",
"장림1동","총인구","2023.04 월","4875","11002","5867","5135",
"장림1동","총인구","2023.05 월","4869","11018","5884","5134",
"장림1동","총인구","2023.06 월","4853","10999","5882","5117",
"장림1동","총인구","2023.07 월","4846","10959","5876","5083",
"장림1동","총인구","2023.08 월","4830","10939","5856","5083",
"장림1동","총인구","2023.09 월","4821","10929","5850","5079",
"장림1동","총인구","2023.10 월","4819","10949","5868","5081",
"장림1동","총인구","2023.11 월","4808","10909","5839","5070",
"장림1동","총인구","2023.12 월","4810","10897","5839","5058",
"장림1동","총인구","2024.01 월","4808","10891","5842","5049",
"장림1동","총인구","2024.02 월","4805","10901","5854","5047",
"장림1동","총인구","2024.03 월","4792","10874","5835","5039",
"장림1동","총인구","2024.04 월","4782","10841","5818","5023",
"장림1동","총인구","2024.05 월","4775","10826","5818","5008",
"장림1동","총인구","2024.06 월","4770","10801","5787","5014",
"장림1동","총인구","2024.07 월","4763","10780","5786","4994",
"장림1동","총인구","2024.08 월","4758","10753","5770","4983",
"장림1동","총인구","2024.09 월","4782","10785","5787","4998",
"장림1동","총인구","2024.10 월","5355","12094","6462","5632",
"장림1동","총인구","2024.11 월","5757","13079","6960","6119",
"장림1동","총인구","2024.12 월","5930","13515","7201","6314",
"장림2동","총인구","2020.01 월","11541","28550","14495","14055",
"장림2동","총인구","2020.02 월","11535","28500","14469","14031",
"장림2동","총인구","2020.03 월","11578","28489","14454","14035",
"장림2동","총인구","2020.04 월","11581","28442","14436","14006",
"장림2동","총인구","2020.05 월","11613","28437","14446","13991",
"장림2동","총인구","2020.06 월","11702","28557","14522","14035",
"장림2동","총인구","2020.07 월","11794","28665","14589","14076",
"장림2동","총인구","2020.08 월","11818","28665","14602","14063",
"장림2동","총인구","2020.09 월","11844","28627","14579","14048",
"장림2동","총인구","2020.10 월","11841","28593","14566","14027",
"장림2동","총인구","2020.11 월","11875","28589","14535","14054",
"장림2동","총인구","2020.12 월","11901","28507","14494","14013",
"장림2동","총인구","2021.01 월","11913","28462","14484","13978",
"장림2동","총인구","2021.02 월","11915","28390","14445","13945",
"장림2동","총인구","2021.03 월","11885","28314","14409","13905",
"장림2동","총인구","2021.04 월","11895","28231","14368","13863",
"장림2동","총인구","2021.05 월","11893","28164","14346","13818",
"장림2동","총인구","2021.06 월","11894","28087","14301","13786",
"장림2동","총인구","2021.07 월","11880","28012","14262","13750",
"장림2동","총인구","2021.08 월","11864","27872","14194","13678",
"장림2동","총인구","2021.09 월","11876","27854","14173","13681",
"장림2동","총인구","2021.10 월","11877","27770","14134","13636",
"장림2동","총인구","2021.11 월","11875","27764","14126","13638",
"장림2동","총인구","2021.12 월","11876","27728","14089","13639",
"장림2동","총인구","2022.01 월","11857","27618","14040","13578",
"장림2동","총인구","2022.02 월","11836","27489","13964","13525",
"장림2동","총인구","2022.03 월","11857","27487","13956","13531",
"장림2동","총인구","2022.04 월","11891","27508","13974","13534",
"장림2동","총인구","2022.05 월","11904","27467","13958","13509",
"장림2동","총인구","2022.06 월","11902","27443","13932","13511",
"장림2동","총인구","2022.07 월","11909","27422","13947","13475",
"장림2동","총인구","2022.08 월","11905","27350","13901","13449",
"장림2동","총인구","2022.09 월","11881","27244","13854","13390",
"장림2동","총인구","2022.10 월","11865","27179","13809","13370",
"장림2동","총인구","2022.11 월","11860","27169","13804","13365",
"장림2동","총인구","2022.12 월","11841","27094","13765","13329",
"장림2동","총인구","2023.01 월","11823","27025","13728","13297",
"장림2동","총인구","2023.02 월","11821","26968","13700","13268",
"장림2동","총인구","2023.03 월","11801","26904","13679","13225",
"장림2동","총인구","2023.04 월","11786","26840","13644","13196",
"장림2동","총인구","2023.05 월","11794","26761","13585","13176",
"장림2동","총인구","2023.06 월","11793","26769","13587","13182",
"장림2동","총인구","2023.07 월","11786","26722","13558","13164",
"장림2동","총인구","2023.08 월","11757","26677","13527","13150",
"장림2동","총인구","2023.09 월","11747","26653","13506","13147",
"장림2동","총인구","2023.10 월","11735","26608","13483","13125",
"장림2동","총인구","2023.11 월","11724","26540","13439","13101",
"장림2동","총인구","2023.12 월","11717","26486","13396","13090",
"장림2동","총인구","2024.01 월","11712","26444","13380","13064",
"장림2동","총인구","2024.02 월","11703","26372","13344","13028",
"장림2동","총인구","2024.03 월","11727","26348","13339","13009",
"장림2동","총인구","2024.04 월","11715","26311","13315","12996",
"장림2동","총인구","2024.05 월","11722","26282","13306","12976",
"장림2동","총인구","2024.06 월","11701","26275","13286","12989",
"장림2동","총인구","2024.07 월","11709","26286","13295","12991",
"장림2동","총인구","2024.08 월","11693","26210","13255","12955",
"장림2동","총인구","2024.09 월","11682","26194","13239","12955",
"장림2동","총인구","2024.10 월","11624","25996","13122","12874",
"장림2동","총인구","2024.11 월","11574","25811","13033","12778",
"장림2동","총인구","2024.12 월","11552","25698","12981","12717",
"다대1동","총인구","2020.01 월","16930","41680","21052","20628",
"다대1동","총인구","2020.02 월","16933","41569","20995","20574",
"다대1동","총인구","2020.03 월","16958","41477","20951","20526",
"다대1동","총인구","2020.04 월","16983","41447","20950","20497",
"다대1동","총인구","2020.05 월","16994","41404","20926","20478",
"다대1동","총인구","2020.06 월","16991","41293","20886","20407",
"다대1동","총인구","2020.07 월","16980","41196","20830","20366",
"다대1동","총인구","2020.08 월","16988","41068","20762","20306",
"다대1동","총인구","2020.09 월","16981","40933","20669","20264",
"다대1동","총인구","2020.10 월","16973","40846","20620","20226",
"다대1동","총인구","2020.11 월","16982","40762","20613","20149",
"다대1동","총인구","2020.12 월","16975","40688","20602","20086",
"다대1동","총인구","2021.01 월","16960","40529","20515","20014",
"다대1동","총인구","2021.02 월","16987","40374","20449","19925",
"다대1동","총인구","2021.03 월","16960","40227","20349","19878",
"다대1동","총인구","2021.04 월","16971","40162","20306","19856",
"다대1동","총인구","2021.05 월","16990","40061","20251","19810",
"다대1동","총인구","2021.06 월","16980","39960","20197","19763",
"다대1동","총인구","2021.07 월","16971","39874","20153","19721",
"다대1동","총인구","2021.08 월","16952","39796","20097","19699",
"다대1동","총인구","2021.09 월","16953","39686","20037","19649",
"다대1동","총인구","2021.10 월","16974","39634","20006","19628",
"다대1동","총인구","2021.11 월","16989","39608","20008","19600",
"다대1동","총인구","2021.12 월","17011","39550","19959","19591",
"다대1동","총인구","2022.01 월","16983","39403","19869","19534",
"다대1동","총인구","2022.02 월","16970","39208","19782","19426",
"다대1동","총인구","2022.03 월","16966","39062","19711","19351",
"다대1동","총인구","2022.04 월","16968","38976","19659","19317",
"다대1동","총인구","2022.05 월","16989","38925","19636","19289",
"다대1동","총인구","2022.06 월","16970","38816","19543","19273",
"다대1동","총인구","2022.07 월","16970","38749","19518","19231",
"다대1동","총인구","2022.08 월","16941","38615","19466","19149",
"다대1동","총인구","2022.09 월","16897","38523","19428","19095",
"다대1동","총인구","2022.10 월","16890","38475","19388","19087",
"다대1동","총인구","2022.11 월","16873","38424","19391","19033",
"다대1동","총인구","2022.12 월","16865","38427","19397","19030",
"다대1동","총인구","2023.01 월","16854","38355","19362","18993",
"다대1동","총인구","2023.02 월","16862","38229","19299","18930",
"다대1동","총인구","2023.03 월","16871","38144","19264","18880",
"다대1동","총인구","2023.04 월","16860","38090","19231","18859",
"다대1동","총인구","2023.05 월","16835","38007","19174","18833",
"다대1동","총인구","2023.06 월","16826","37923","19138","18785",
"다대1동","총인구","2023.07 월","16830","37915","19139","18776",
"다대1동","총인구","2023.08 월","16812","37847","19114","18733",
"다대1동","총인구","2023.09 월","16797","37783","19102","18681",
"다대1동","총인구","2023.10 월","16780","37733","19080","18653",
"다대1동","총인구","2023.11 월","16759","37640","19017","18623",
"다대1동","총인구","2023.12 월","16754","37597","19000","18597",
"다대1동","총인구","2024.01 월","16719","37484","18954","18530",
"다대1동","총인구","2024.02 월","16705","37325","18853","18472",
"다대1동","총인구","2024.03 월","16686","37271","18825","18446",
"다대1동","총인구","2024.04 월","16660","37155","18760","18395",
"다대1동","총인구","2024.05 월","16661","37069","18712","18357",
"다대1동","총인구","2024.06 월","16660","36973","18658","18315",
"다대1동","총인구","2024.07 월","16653","36919","18642","18277",
"다대1동","총인구","2024.08 월","16639","36840","18589","18251",
"다대1동","총인구","2024.09 월","16637","36773","18553","18220",
"다대1동","총인구","2024.10 월","16600","36613","18487","18126",
"다대1동","총인구","2024.11 월","16605","36549","18454","18095",
"다대1동","총인구","2024.12 월","16598","36512","18428","18084",
"다대2동","총인구","2020.01 월","12199","29061","14306","14755",
"다대2동","총인구","2020.02 월","12199","28998","14272","14726",
"다대2동","총인구","2020.03 월","12238","28977","14257","14720",
"다대2동","총인구","2020.04 월","12231","28938","14226","14712",
"다대2동","총인구","2020.05 월","12237","28906","14206","14700",
"다대2동","총인구","2020.06 월","12261","28886","14194","14692",
"다대2동","총인구","2020.07 월","12245","28778","14137","14641",
"다대2동","총인구","2020.08 월","12229","28658","14083","14575",
"다대2동","총인구","2020.09 월","12207","28568","14043","14525",
"다대2동","총인구","2020.10 월","12198","28479","13990","14489",
"다대2동","총인구","2020.11 월","12183","28366","13925","14441",
"다대2동","총인구","2020.12 월","12181","28272","13875","14397",
"다대2동","총인구","2021.01 월","12196","28243","13847","14396",
"다대2동","총인구","2021.02 월","12202","28188","13826","14362",
"다대2동","총인구","2021.03 월","12173","28080","13796","14284",
"다대2동","총인구","2021.04 월","12194","28031","13768","14263",
"다대2동","총인구","2021.05 월","12193","27976","13752","14224",
"다대2동","총인구","2021.06 월","12211","27931","13710","14221",
"다대2동","총인구","2021.07 월","12177","27824","13651","14173",
"다대2동","총인구","2021.08 월","12155","27697","13586","14111",
"다대2동","총인구","2021.09 월","12145","27634","13549","14085",
"다대2동","총인구","2021.10 월","12132","27571","13512","14059",
"다대2동","총인구","2021.11 월","12140","27535","13505","14030",
"다대2동","총인구","2021.12 월","12153","27483","13477","14006",
"다대2동","총인구","2022.01 월","12124","27353","13418","13935",
"다대2동","총인구","2022.02 월","12119","27205","13333","13872",
"다대2동","총인구","2022.03 월","12124","27137","13305","13832",
"다대2동","총인구","2022.04 월","12127","27094","13273","13821",
"다대2동","총인구","2022.05 월","12130","27030","13256","13774",
"다대2동","총인구","2022.06 월","12135","26962","13228","13734",
"다대2동","총인구","2022.07 월","12122","26866","13158","13708",
"다대2동","총인구","2022.08 월","12110","26785","13114","13671",
"다대2동","총인구","2022.09 월","12072","26678","13056","13622",
"다대2동","총인구","2022.10 월","12058","26609","13022","13587",
"다대2동","총인구","2022.11 월","12053","26588","13015","13573",
"다대2동","총인구","2022.12 월","12055","26574","13006","13568",
"다대2동","총인구","2023.01 월","12054","26542","13004","13538",
"다대2동","총인구","2023.02 월","12050","26471","12976","13495",
"다대2동","총인구","2023.03 월","12045","26449","12971","13478",
"다대2동","총인구","2023.04 월","12052","26426","12954","13472",
"다대2동","총인구","2023.05 월","12061","26388","12935","13453",
"다대2동","총인구","2023.06 월","12047","26336","12918","13418",
"다대2동","총인구","2023.07 월","12026","26229","12870","13359",
"다대2동","총인구","2023.08 월","11996","26128","12813","13315",
"다대2동","총인구","2023.09 월","11991","26107","12794","13313",
"다대2동","총인구","2023.10 월","11988","26064","12777","13287",
"다대2동","총인구","2023.11 월","12001","26027","12762","13265",
"다대2동","총인구","2023.12 월","12016","26027","12780","13247",
"다대2동","총인구","2024.01 월","12015","25995","12765","13230",
"다대2동","총인구","2024.02 월","11998","25896","12715","13181",
"다대2동","총인구","2024.03 월","12000","25828","12681","13147",
"다대2동","총인구","2024.04 월","11992","25791","12663","13128",
"다대2동","총인구","2024.05 월","11979","25749","12648","13101",
"다대2동","총인구","2024.06 월","11986","25712","12644","13068",
"다대2동","총인구","2024.07 월","11982","25676","12617","13059",
"다대2동","총인구","2024.08 월","11957","25636","12597","13039",
"다대2동","총인구","2024.09 월","11965","25605","12566","13039",
"다대2동","총인구","2024.10 월","11936","25473","12499","12974",
"다대2동","총인구","2024.11 월","11926","25370","12442","12928",
"다대2동","총인구","2024.12 월","11930","25343","12429","12914",
"구평동","총인구","2020.01 월","4607","12014","6137","5877",
"구평동","총인구","2020.02 월","4584","11964","6100","5864",
"구평동","총인구","2020.03 월","4577","11936","6090","5846",
"구평동","총인구","2020.04 월","4589","11946","6105","5841",
"구평동","총인구","2020.05 월","4592","11932","6106","5826",
"구평동","총인구","2020.06 월","4606","11942","6118","5824",
"구평동","총인구","2020.07 월","4608","11933","6105","5828",
"구평동","총인구","2020.08 월","4600","11913","6092","5821",
"구평동","총인구","2020.09 월","4599","11890","6084","5806",
"구평동","총인구","2020.10 월","4605","11873","6078","5795",
"구평동","총인구","2020.11 월","4621","11873","6083","5790",
"구평동","총인구","2020.12 월","4614","11840","6072","5768",
"구평동","총인구","2021.01 월","4614","11827","6069","5758",
"구평동","총인구","2021.02 월","4618","11813","6069","5744",
"구평동","총인구","2021.03 월","4579","11775","6051","5724",
"구평동","총인구","2021.04 월","4574","11743","6021","5722",
"구평동","총인구","2021.05 월","4582","11738","6015","5723",
"구평동","총인구","2021.06 월","4581","11716","6004","5712",
"구평동","총인구","2021.07 월","4592","11731","6014","5717",
"구평동","총인구","2021.08 월","4966","12507","6419","6088",
"구평동","총인구","2021.09 월","5138","12862","6585","6277",
"구평동","총인구","2021.10 월","5224","13026","6673","6353",
"구평동","총인구","2021.11 월","5225","13040","6672","6368",
"구평동","총인구","2021.12 월","5228","13058","6688","6370",
"구평동","총인구","2022.01 월","5226","13029","6673","6356",
"구평동","총인구","2022.02 월","5231","13061","6693","6368",
"구평동","총인구","2022.03 월","5212","13019","6662","6357",
"구평동","총인구","2022.04 월","5208","13040","6675","6365",
"구평동","총인구","2022.05 월","5211","13076","6688","6388",
"구평동","총인구","2022.06 월","5207","13061","6675","6386",
"구평동","총인구","2022.07 월","5211","13032","6656","6376",
"구평동","총인구","2022.08 월","5212","13022","6650","6372",
"구평동","총인구","2022.09 월","5196","12969","6628","6341",
"구평동","총인구","2022.10 월","5200","12966","6630","6336",
"구평동","총인구","2022.11 월","5201","12966","6643","6323",
"구평동","총인구","2022.12 월","5198","12958","6644","6314",
"구평동","총인구","2023.01 월","5190","12938","6637","6301",
"구평동","총인구","2023.02 월","5168","12867","6593","6274",
"구평동","총인구","2023.03 월","5166","12868","6597","6271",
"구평동","총인구","2023.04 월","5184","12888","6609","6279",
"구평동","총인구","2023.05 월","5182","12847","6588","6259",
"구평동","총인구","2023.06 월","5185","12852","6598","6254",
"구평동","총인구","2023.07 월","5185","12843","6594","6249",
"구평동","총인구","2023.08 월","5171","12796","6575","6221",
"구평동","총인구","2023.09 월","5143","12746","6556","6190",
"구평동","총인구","2023.10 월","5103","12670","6515","6155",
"구평동","총인구","2023.11 월","5100","12664","6503","6161",
"구평동","총인구","2023.12 월","5092","12634","6486","6148",
"구평동","총인구","2024.01 월","5086","12597","6478","6119",
"구평동","총인구","2024.02 월","5097","12618","6498","6120",
"구평동","총인구","2024.03 월","5101","12645","6517","6128",
"구평동","총인구","2024.04 월","5099","12658","6523","6135",
"구평동","총인구","2024.05 월","5111","12673","6535","6138",
"구평동","총인구","2024.06 월","5107","12660","6528","6132",
"구평동","총인구","2024.07 월","5113","12669","6531","6138",
"구평동","총인구","2024.08 월","5102","12639","6509","6130",
"구평동","총인구","2024.09 월","5101","12609","6492","6117",
"구평동","총인구","2024.10 월","5096","12568","6465","6103",
"구평동","총인구","2024.11 월","5100","12542","6446","6096",
"구평동","총인구","2024.12 월","5112","12537","6448","6089",
"감천1동","총인구","2020.01 월","8504","20466","10165","10301",
"감천1동","총인구","2020.02 월","8508","20401","10137","10264",
"감천1동","총인구","2020.03 월","8504","20335","10098","10237",
"감천1동","총인구","2020.04 월","8489","20246","10037","10209",
"감천1동","총인구","2020.05 월","8489","20182","9997","10185",
"감천1동","총인구","2020.06 월","8500","20122","9968","10154",
"감천1동","총인구","2020.07 월","8483","20021","9912","10109",
"감천1동","총인구","2020.08 월","8480","19953","9868","10085",
"감천1동","총인구","2020.09 월","8473","19911","9843","10068",
"감천1동","총인구","2020.10 월","8452","19813","9799","10014",
"감천1동","총인구","2020.11 월","8439","19714","9737","9977",
"감천1동","총인구","2020.12 월","8448","19658","9725","9933",
"감천1동","총인구","2021.01 월","8457","19617","9702","9915",
"감천1동","총인구","2021.02 월","8447","19513","9643","9870",
"감천1동","총인구","2021.03 월","8359","19329","9557","9772",
"감천1동","총인구","2021.04 월","8348","19287","9523","9764",
"감천1동","총인구","2021.05 월","8322","19189","9470","9719",
"감천1동","총인구","2021.06 월","8319","19138","9449","9689",
"감천1동","총인구","2021.07 월","8315","19085","9420","9665",
"감천1동","총인구","2021.08 월","8287","18969","9350","9619",
"감천1동","총인구","2021.09 월","8268","18891","9304","9587",
"감천1동","총인구","2021.10 월","8285","18854","9279","9575",
"감천1동","총인구","2021.11 월","8301","18849","9282","9567",
"감천1동","총인구","2021.12 월","8294","18798","9255","9543",
"감천1동","총인구","2022.01 월","8273","18707","9216","9491",
"감천1동","총인구","2022.02 월","8254","18579","9148","9431",
"감천1동","총인구","2022.03 월","8243","18501","9101","9400",
"감천1동","총인구","2022.04 월","8217","18425","9066","9359",
"감천1동","총인구","2022.05 월","8216","18381","9045","9336",
"감천1동","총인구","2022.06 월","8215","18355","9036","9319",
"감천1동","총인구","2022.07 월","8218","18294","9006","9288",
"감천1동","총인구","2022.08 월","8211","18245","8973","9272",
"감천1동","총인구","2022.09 월","8175","18163","8927","9236",
"감천1동","총인구","2022.10 월","8162","18130","8909","9221",
"감천1동","총인구","2022.11 월","8161","18137","8920","9217",
"감천1동","총인구","2022.12 월","8150","18077","8895","9182",
"감천1동","총인구","2023.01 월","8131","18002","8866","9136",
"감천1동","총인구","2023.02 월","8122","17941","8838","9103",
"감천1동","총인구","2023.03 월","8093","17865","8796","9069",
"감천1동","총인구","2023.04 월","8093","17827","8777","9050",
"감천1동","총인구","2023.05 월","8083","17779","8751","9028",
"감천1동","총인구","2023.06 월","8072","17734","8730","9004",
"감천1동","총인구","2023.07 월","8061","17700","8714","8986",
"감천1동","총인구","2023.08 월","8042","17638","8674","8964",
"감천1동","총인구","2023.09 월","8040","17608","8669","8939",
"감천1동","총인구","2023.10 월","8010","17535","8630","8905",
"감천1동","총인구","2023.11 월","7998","17489","8611","8878",
"감천1동","총인구","2023.12 월","7976","17430","8577","8853",
"감천1동","총인구","2024.01 월","7974","17388","8559","8829",
"감천1동","총인구","2024.02 월","7969","17325","8530","8795",
"감천1동","총인구","2024.03 월","7958","17286","8501","8785",
"감천1동","총인구","2024.04 월","7948","17261","8497","8764",
"감천1동","총인구","2024.05 월","7959","17257","8501","8756",
"감천1동","총인구","2024.06 월","7945","17216","8469","8747",
"감천1동","총인구","2024.07 월","7911","17147","8426","8721",
"감천1동","총인구","2024.08 월","7895","17090","8393","8697",
"감천1동","총인구","2024.09 월","7873","17032","8354","8678",
"감천1동","총인구","2024.10 월","7843","16932","8299","8633",
"감천1동","총인구","2024.11 월","7825","16883","8267","8616",
"감천1동","총인구","2024.12 월","7811","16826","8239","8587",
"감천2동","총인구","2020.01 월","3684","6893","3536","3357",
"감천2동","총인구","2020.02 월","3675","6879","3527","3352",
"감천2동","총인구","2020.03 월","3661","6810","3495","3315",
"감천2동","총인구","2020.04 월","3651","6767","3470","3297",
"감천2동","총인구","2020.05 월","3643","6745","3460","3285",
"감천2동","총인구","2020.06 월","3652","6729","3452","3277",
"감천2동","총인구","2020.07 월","3627","6688","3431","3257",
"감천2동","총인구","2020.08 월","3610","6622","3395","3227",
"감천2동","총인구","2020.09 월","3592","6560","3356","3204",
"감천2동","총인구","2020.10 월","3583","6507","3326","3181",
"감천2동","총인구","2020.11 월","3577","6474","3309","3165",
"감천2동","총인구","2020.12 월","3568","6429","3284","3145",
"감천2동","총인구","2021.01 월","3566","6416","3285","3131",
"감천2동","총인구","2021.02 월","3563","6392","3271","3121",
"감천2동","총인구","2021.03 월","3426","6221","3181","3040",
"감천2동","총인구","2021.04 월","3419","6183","3163","3020",
"감천2동","총인구","2021.05 월","3405","6154","3155","2999",
"감천2동","총인구","2021.06 월","3393","6142","3147","2995",
"감천2동","총인구","2021.07 월","3383","6103","3126","2977",
"감천2동","총인구","2021.08 월","3367","6067","3108","2959",
"감천2동","총인구","2021.09 월","3360","6041","3094","2947",
"감천2동","총인구","2021.10 월","3352","6013","3077","2936",
"감천2동","총인구","2021.11 월","3347","5988","3062","2926",
"감천2동","총인구","2021.12 월","3341","5973","3051","2922",
"감천2동","총인구","2022.01 월","3338","5955","3043","2912",
"감천2동","총인구","2022.02 월","3324","5910","3018","2892",
"감천2동","총인구","2022.03 월","3316","5885","2994","2891",
"감천2동","총인구","2022.04 월","3314","5857","2980","2877",
"감천2동","총인구","2022.05 월","3316","5843","2975","2868",
"감천2동","총인구","2022.06 월","3304","5808","2953","2855",
"감천2동","총인구","2022.07 월","3294","5791","2943","2848",
"감천2동","총인구","2022.08 월","3282","5752","2919","2833",
"감천2동","총인구","2022.09 월","3257","5718","2900","2818",
"감천2동","총인구","2022.10 월","3253","5705","2886","2819",
"감천2동","총인구","2022.11 월","3254","5699","2882","2817",
"감천2동","총인구","2022.12 월","3247","5691","2870","2821",
"감천2동","총인구","2023.01 월","3236","5669","2861","2808",
"감천2동","총인구","2023.02 월","3234","5654","2848","2806",
"감천2동","총인구","2023.03 월","3234","5650","2842","2808",
"감천2동","총인구","2023.04 월","3229","5624","2828","2796",
"감천2동","총인구","2023.05 월","3230","5603","2813","2790",
"감천2동","총인구","2023.06 월","3231","5572","2794","2778",
"감천2동","총인구","2023.07 월","3209","5536","2776","2760",
"감천2동","총인구","2023.08 월","3197","5514","2767","2747",
"감천2동","총인구","2023.09 월","3189","5495","2760","2735",
"감천2동","총인구","2023.10 월","3186","5476","2757","2719",
"감천2동","총인구","2023.11 월","3186","5454","2742","2712",
"감천2동","총인구","2023.12 월","3177","5426","2730","2696",
"감천2동","총인구","2024.01 월","3168","5409","2721","2688",
"감천2동","총인구","2024.02 월","3161","5386","2706","2680",
"감천2동","총인구","2024.03 월","3156","5365","2695","2670",
"감천2동","총인구","2024.04 월","3147","5347","2684","2663",
"감천2동","총인구","2024.05 월","3156","5336","2685","2651",
"감천2동","총인구","2024.06 월","3161","5334","2679","2655",
"감천2동","총인구","2024.07 월","3157","5322","2677","2645",
"감천2동","총인구","2024.08 월","3157","5302","2672","2630",
"감천2동","총인구","2024.09 월","3143","5281","2662","2619",
"감천2동","총인구","2024.10 월","3122","5231","2630","2601",
"감천2동","총인구","2024.11 월","3113","5218","2623","2595",
"감천2동","총인구","2024.12 월","3101","5196","2610","2586",
"금정구","총인구","2020.01 월","106857","243328","118742","124586",
"금정구","총인구","2020.02 월","107042","242911","118501","124410",
"금정구","총인구","2020.03 월","107184","242147","118010","124137",
"금정구","총인구","2020.04 월","107101","241100","117535","123565",
"금정구","총인구","2020.05 월","107313","240623","117312","123311",
"금정구","총인구","2020.06 월","107358","240006","117016","122990",
"금정구","총인구","2020.07 월","107273","238974","116481","122493",
"금정구","총인구","2020.08 월","107323","238347","116173","122174",
"금정구","총인구","2020.09 월","107383","238173","115984","122189",
"금정구","총인구","2020.10 월","107345","237527","115633","121894",
"금정구","총인구","2020.11 월","107491","237153","115433","121720",
"금정구","총인구","2020.12 월","107561","236485","115133","121352",
"금정구","총인구","2021.01 월","107415","235664","114741","120923",
"금정구","총인구","2021.02 월","107710","235357","114692","120665",
"금정구","총인구","2021.03 월","107184","234561","114304","120257",
"금정구","총인구","2021.04 월","107157","234173","114086","120087",
"금정구","총인구","2021.05 월","107158","233642","113868","119774",
"금정구","총인구","2021.06 월","107165","233081","113601","119480",
"금정구","총인구","2021.07 월","107360","232947","113558","119389",
"금정구","총인구","2021.08 월","107559","232836","113527","119309",
"금정구","총인구","2021.09 월","107990","233472","113699","119773",
"금정구","총인구","2021.10 월","108131","233233","113583","119650",
"금정구","총인구","2021.11 월","108257","232989","113466","119523",
"금정구","총인구","2021.12 월","108070","231996","113067","118929",
"금정구","총인구","2022.01 월","107737","230711","112455","118256",
"금정구","총인구","2022.02 월","107785","229763","112011","117752",
"금정구","총인구","2022.03 월","107916","229693","111883","117810",
"금정구","총인구","2022.04 월","107856","229112","111612","117500",
"금정구","총인구","2022.05 월","107900","228835","111429","117406",
"금정구","총인구","2022.06 월","107827","228255","111153","117102",
"금정구","총인구","2022.07 월","107729","227728","110901","116827",
"금정구","총인구","2022.08 월","107887","227436","110798","116638",
"금정구","총인구","2022.09 월","107535","227471","110637","116834",
"금정구","총인구","2022.10 월","107403","226775","110341","116434",
"금정구","총인구","2022.11 월","107061","226141","110009","116132",
"금정구","총인구","2022.12 월","106950","225717","109797","115920",
"금정구","총인구","2023.01 월","106606","224861","109361","115500",
"금정구","총인구","2023.02 월","106851","224410","109197","115213",
"금정구","총인구","2023.03 월","106954","224488","109119","115369",
"금정구","총인구","2023.04 월","106821","224011","108873","115138",
"금정구","총인구","2023.05 월","106809","223670","108693","114977",
"금정구","총인구","2023.06 월","106725","223182","108425","114757",
"금정구","총인구","2023.07 월","106693","222657","108194","114463",
"금정구","총인구","2023.08 월","106726","222095","108002","114093",
"금정구","총인구","2023.09 월","106616","222232","107888","114344",
"금정구","총인구","2023.10 월","106297","221486","107566","113920",
"금정구","총인구","2023.11 월","106121","221049","107344","113705",
"금정구","총인구","2023.12 월","105906","220286","106926","113360",
"금정구","총인구","2024.01 월","105465","219268","106414","112854",
"금정구","총인구","2024.02 월","105513","218544","106131","112413",
"금정구","총인구","2024.03 월","105729","218408","106001","112407",
"금정구","총인구","2024.04 월","105621","218355","105890","112465",
"금정구","총인구","2024.05 월","105706","218105","105717","112388",
"금정구","총인구","2024.06 월","105566","217550","105467","112083",
"금정구","총인구","2024.07 월","105390","216866","105179","111687",
"금정구","총인구","2024.08 월","105401","216285","104969","111316",
"금정구","총인구","2024.09 월","105363","216543","104930","111613",
"금정구","총인구","2024.10 월","105059","215919","104598","111321",
"금정구","총인구","2024.11 월","104956","215413","104355","111058",
"금정구","총인구","2024.12 월","104817","214922","104108","110814",
"서1동","총인구","2020.01 월","3614","6593","3341","3252",
"서1동","총인구","2020.02 월","3605","6560","3324","3236",
"서1동","총인구","2020.03 월","3592","6492","3286","3206",
"서1동","총인구","2020.04 월","3585","6452","3256","3196",
"서1동","총인구","2020.05 월","3566","6385","3217","3168",
"서1동","총인구","2020.06 월","3565","6326","3194","3132",
"서1동","총인구","2020.07 월","3518","6218","3145","3073",
"서1동","총인구","2020.08 월","3486","6129","3100","3029",
"서1동","총인구","2020.09 월","3472","6093","3082","3011",
"서1동","총인구","2020.10 월","3459","6063","3067","2996",
"서1동","총인구","2020.11 월","3450","6015","3046","2969",
"서1동","총인구","2020.12 월","3422","5941","3017","2924",
"서1동","총인구","2021.01 월","3393","5865","2990","2875",
"서1동","총인구","2021.02 월","3385","5812","2963","2849",
"서1동","총인구","2021.03 월","3286","5674","2910","2764",
"서1동","총인구","2021.04 월","3276","5628","2881","2747",
"서1동","총인구","2021.05 월","3268","5588","2864","2724",
"서1동","총인구","2021.06 월","3252","5546","2840","2706",
"서1동","총인구","2021.07 월","3239","5513","2830","2683",
"서1동","총인구","2021.08 월","3233","5490","2819","2671",
"서1동","총인구","2021.09 월","3228","5467","2813","2654",
"서1동","총인구","2021.10 월","3191","5395","2773","2622",
"서1동","총인구","2021.11 월","3183","5356","2756","2600",
"서1동","총인구","2021.12 월","3174","5334","2753","2581",
"서1동","총인구","2022.01 월","3181","5323","2749","2574",
"서1동","총인구","2022.02 월","3163","5296","2735","2561",
"서1동","총인구","2022.03 월","3139","5255","2717","2538",
"서1동","총인구","2022.04 월","3137","5223","2695","2528",
"서1동","총인구","2022.05 월","3132","5206","2679","2527",
"서1동","총인구","2022.06 월","3110","5160","2663","2497",
"서1동","총인구","2022.07 월","3103","5150","2658","2492",
"서1동","총인구","2022.08 월","3088","5108","2648","2460",
"서1동","총인구","2022.09 월","3043","5047","2619","2428",
"서1동","총인구","2022.10 월","3043","5033","2616","2417",
"서1동","총인구","2022.11 월","3033","5024","2619","2405",
"서1동","총인구","2022.12 월","3024","5000","2607","2393",
"서1동","총인구","2023.01 월","3013","4955","2575","2380",
"서1동","총인구","2023.02 월","3002","4930","2570","2360",
"서1동","총인구","2023.03 월","2987","4887","2551","2336",
"서1동","총인구","2023.04 월","2968","4849","2533","2316",
"서1동","총인구","2023.05 월","2948","4816","2522","2294",
"서1동","총인구","2023.06 월","2934","4789","2505","2284",
"서1동","총인구","2023.07 월","2933","4787","2508","2279",
"서1동","총인구","2023.08 월","2918","4758","2490","2268",
"서1동","총인구","2023.09 월","2907","4737","2474","2263",
"서1동","총인구","2023.10 월","2907","4720","2465","2255",
"서1동","총인구","2023.11 월","2892","4693","2451","2242",
"서1동","총인구","2023.12 월","2874","4652","2430","2222",
"서1동","총인구","2024.01 월","2862","4631","2423","2208",
"서1동","총인구","2024.02 월","2843","4590","2398","2192",
"서1동","총인구","2024.03 월","2831","4558","2376","2182",
"서1동","총인구","2024.04 월","2815","4529","2365","2164",
"서1동","총인구","2024.05 월","2802","4503","2347","2156",
"서1동","총인구","2024.06 월","2796","4496","2345","2151",
"서1동","총인구","2024.07 월","2784","4470","2331","2139",
"서1동","총인구","2024.08 월","2770","4447","2317","2130",
"서1동","총인구","2024.09 월","2761","4433","2300","2133",
"서1동","총인구","2024.10 월","2746","4406","2283","2123",
"서1동","총인구","2024.11 월","2725","4363","2258","2105",
"서1동","총인구","2024.12 월","2710","4330","2241","2089",
"서2동","총인구","2020.01 월","5235","10439","5190","5249",
"서2동","총인구","2020.02 월","5236","10415","5185","5230",
"서2동","총인구","2020.03 월","5232","10369","5161","5208",
"서2동","총인구","2020.04 월","5214","10320","5133","5187",
"서2동","총인구","2020.05 월","5211","10294","5129","5165",
"서2동","총인구","2020.06 월","5186","10220","5093","5127",
"서2동","총인구","2020.07 월","5203","10211","5102","5109",
"서2동","총인구","2020.08 월","5181","10142","5063","5079",
"서2동","총인구","2020.09 월","5178","10085","5020","5065",
"서2동","총인구","2020.10 월","5146","10002","4973","5029",
"서2동","총인구","2020.11 월","5143","9947","4945","5002",
"서2동","총인구","2020.12 월","5130","9876","4907","4969",
"서2동","총인구","2021.01 월","5099","9807","4875","4932",
"서2동","총인구","2021.02 월","5103","9756","4840","4916",
"서2동","총인구","2021.03 월","4995","9614","4782","4832",
"서2동","총인구","2021.04 월","4975","9561","4745","4816",
"서2동","총인구","2021.05 월","4960","9490","4717","4773",
"서2동","총인구","2021.06 월","4971","9457","4704","4753",
"서2동","총인구","2021.07 월","4959","9409","4676","4733",
"서2동","총인구","2021.08 월","4950","9367","4659","4708",
"서2동","총인구","2021.09 월","4948","9351","4652","4699",
"서2동","총인구","2021.10 월","4960","9336","4641","4695",
"서2동","총인구","2021.11 월","4964","9316","4636","4680",
"서2동","총인구","2021.12 월","4958","9280","4616","4664",
"서2동","총인구","2022.01 월","4946","9240","4598","4642",
"서2동","총인구","2022.02 월","4929","9194","4583","4611",
"서2동","총인구","2022.03 월","4922","9162","4578","4584",
"서2동","총인구","2022.04 월","4921","9128","4555","4573",
"서2동","총인구","2022.05 월","4934","9133","4551","4582",
"서2동","총인구","2022.06 월","4926","9110","4538","4572",
"서2동","총인구","2022.07 월","4913","9055","4514","4541",
"서2동","총인구","2022.08 월","4920","9053","4508","4545",
"서2동","총인구","2022.09 월","4872","8999","4480","4519",
"서2동","총인구","2022.10 월","4862","8975","4470","4505",
"서2동","총인구","2022.11 월","4822","8910","4438","4472",
"서2동","총인구","2022.12 월","4812","8869","4425","4444",
"서2동","총인구","2023.01 월","4800","8833","4403","4430",
"서2동","총인구","2023.02 월","4781","8779","4378","4401",
"서2동","총인구","2023.03 월","4773","8762","4368","4394",
"서2동","총인구","2023.04 월","4772","8746","4364","4382",
"서2동","총인구","2023.05 월","4768","8723","4356","4367",
"서2동","총인구","2023.06 월","4750","8682","4331","4351",
"서2동","총인구","2023.07 월","4753","8661","4322","4339",
"서2동","총인구","2023.08 월","4743","8626","4302","4324",
"서2동","총인구","2023.09 월","4727","8605","4289","4316",
"서2동","총인구","2023.10 월","4724","8597","4291","4306",
"서2동","총인구","2023.11 월","4713","8550","4259","4291",
"서2동","총인구","2023.12 월","4711","8552","4265","4287",
"서2동","총인구","2024.01 월","4697","8517","4251","4266",
"서2동","총인구","2024.02 월","4682","8499","4237","4262",
"서2동","총인구","2024.03 월","4667","8458","4209","4249",
"서2동","총인구","2024.04 월","4657","8433","4197","4236",
"서2동","총인구","2024.05 월","4637","8404","4174","4230",
"서2동","총인구","2024.06 월","4616","8376","4164","4212",
"서2동","총인구","2024.07 월","4595","8341","4151","4190",
"서2동","총인구","2024.08 월","4578","8301","4132","4169",
"서2동","총인구","2024.09 월","4572","8292","4125","4167",
"서2동","총인구","2024.10 월","4549","8234","4100","4134",
"서2동","총인구","2024.11 월","4532","8191","4082","4109",
"서2동","총인구","2024.12 월","4522","8170","4076","4094",
"서3동","총인구","2020.01 월","5831","11774","5932","5842",
"서3동","총인구","2020.02 월","5822","11711","5892","5819",
"서3동","총인구","2020.03 월","5843","11693","5877","5816",
"서3동","총인구","2020.04 월","5845","11693","5866","5827",
"서3동","총인구","2020.05 월","5852","11694","5867","5827",
"서3동","총인구","2020.06 월","5870","11700","5863","5837",
"서3동","총인구","2020.07 월","5893","11699","5862","5837",
"서3동","총인구","2020.08 월","5890","11663","5836","5827",
"서3동","총인구","2020.09 월","5878","11605","5806","5799",
"서3동","총인구","2020.10 월","5879","11595","5792","5803",
"서3동","총인구","2020.11 월","5877","11531","5755","5776",
"서3동","총인구","2020.12 월","5905","11561","5772","5789",
"서3동","총인구","2021.01 월","5898","11536","5756","5780",
"서3동","총인구","2021.02 월","5939","11546","5764","5782",
"서3동","총인구","2021.03 월","5894","11474","5732","5742",
"서3동","총인구","2021.04 월","5899","11453","5725","5728",
"서3동","총인구","2021.05 월","5910","11428","5722","5706",
"서3동","총인구","2021.06 월","5931","11413","5705","5708",
"서3동","총인구","2021.07 월","5938","11410","5698","5712",
"서3동","총인구","2021.08 월","5948","11402","5694","5708",
"서3동","총인구","2021.09 월","5958","11388","5679","5709",
"서3동","총인구","2021.10 월","5951","11346","5661","5685",
"서3동","총인구","2021.11 월","5954","11325","5645","5680",
"서3동","총인구","2021.12 월","5957","11307","5633","5674",
"서3동","총인구","2022.01 월","5943","11260","5614","5646",
"서3동","총인구","2022.02 월","5930","11216","5588","5628",
"서3동","총인구","2022.03 월","5921","11172","5569","5603",
"서3동","총인구","2022.04 월","5917","11145","5563","5582",
"서3동","총인구","2022.05 월","5915","11102","5543","5559",
"서3동","총인구","2022.06 월","5911","11077","5526","5551",
"서3동","총인구","2022.07 월","5905","11045","5508","5537",
"서3동","총인구","2022.08 월","5908","11018","5495","5523",
"서3동","총인구","2022.09 월","5889","10981","5483","5498",
"서3동","총인구","2022.10 월","5873","10937","5463","5474",
"서3동","총인구","2022.11 월","5853","10888","5437","5451",
"서3동","총인구","2022.12 월","5834","10853","5413","5440",
"서3동","총인구","2023.01 월","5816","10845","5402","5443",
"서3동","총인구","2023.02 월","5808","10821","5391","5430",
"서3동","총인구","2023.03 월","5790","10777","5361","5416",
"서3동","총인구","2023.04 월","5781","10754","5347","5407",
"서3동","총인구","2023.05 월","5770","10718","5322","5396",
"서3동","총인구","2023.06 월","5765","10701","5321","5380",
"서3동","총인구","2023.07 월","5753","10663","5300","5363",
"서3동","총인구","2023.08 월","5745","10619","5282","5337",
"서3동","총인구","2023.09 월","5753","10598","5269","5329",
"서3동","총인구","2023.10 월","5720","10560","5249","5311",
"서3동","총인구","2023.11 월","5705","10505","5211","5294",
"서3동","총인구","2023.12 월","5682","10467","5190","5277",
"서3동","총인구","2024.01 월","5686","10453","5189","5264",
"서3동","총인구","2024.02 월","5672","10405","5170","5235",
"서3동","총인구","2024.03 월","5651","10355","5151","5204",
"서3동","총인구","2024.04 월","5637","10330","5130","5200",
"서3동","총인구","2024.05 월","5637","10287","5106","5181",
"서3동","총인구","2024.06 월","5639","10255","5091","5164",
"서3동","총인구","2024.07 월","5605","10178","5057","5121",
"서3동","총인구","2024.08 월","5594","10145","5036","5109",
"서3동","총인구","2024.09 월","5578","10112","5022","5090",
"서3동","총인구","2024.10 월","5564","10067","5005","5062",
"서3동","총인구","2024.11 월","5559","10037","4984","5053",
"서3동","총인구","2024.12 월","5533","9989","4961","5028",
"금사회동동","총인구","2020.01 월","4355","8980","4747","4233",
"금사회동동","총인구","2020.02 월","4354","8954","4733","4221",
"금사회동동","총인구","2020.03 월","4345","8917","4704","4213",
"금사회동동","총인구","2020.04 월","4340","8886","4694","4192",
"금사회동동","총인구","2020.05 월","4359","8884","4699","4185",
"금사회동동","총인구","2020.06 월","4360","8843","4686","4157",
"금사회동동","총인구","2020.07 월","4247","8550","4534","4016",
"금사회동동","총인구","2020.08 월","4251","8508","4513","3995",
"금사회동동","총인구","2020.09 월","4253","8500","4510","3990",
"금사회동동","총인구","2020.10 월","4250","8467","4498","3969",
"금사회동동","총인구","2020.11 월","4263","8479","4504","3975",
"금사회동동","총인구","2020.12 월","4251","8431","4471","3960",
"금사회동동","총인구","2021.01 월","4251","8395","4457","3938",
"금사회동동","총인구","2021.02 월","4255","8366","4444","3922",
"금사회동동","총인구","2021.03 월","4204","8275","4401","3874",
"금사회동동","총인구","2021.04 월","4208","8252","4393","3859",
"금사회동동","총인구","2021.05 월","4200","8224","4372","3852",
"금사회동동","총인구","2021.06 월","4182","8175","4345","3830",
"금사회동동","총인구","2021.07 월","4197","8155","4327","3828",
"금사회동동","총인구","2021.08 월","4188","8134","4310","3824",
"금사회동동","총인구","2021.09 월","4172","8099","4291","3808",
"금사회동동","총인구","2021.10 월","4167","8080","4271","3809",
"금사회동동","총인구","2021.11 월","4165","8075","4264","3811",
"금사회동동","총인구","2021.12 월","4168","8053","4256","3797",
"금사회동동","총인구","2022.01 월","4161","8009","4230","3779",
"금사회동동","총인구","2022.02 월","4153","7952","4203","3749",
"금사회동동","총인구","2022.03 월","4160","7939","4190","3749",
"금사회동동","총인구","2022.04 월","4155","7914","4174","3740",
"금사회동동","총인구","2022.05 월","4157","7897","4171","3726",
"금사회동동","총인구","2022.06 월","4172","7896","4171","3725",
"금사회동동","총인구","2022.07 월","4165","7876","4157","3719",
"금사회동동","총인구","2022.08 월","4166","7858","4141","3717",
"금사회동동","총인구","2022.09 월","4128","7800","4108","3692",
"금사회동동","총인구","2022.10 월","4126","7769","4097","3672",
"금사회동동","총인구","2022.11 월","4119","7738","4083","3655",
"금사회동동","총인구","2022.12 월","4123","7715","4075","3640",
"금사회동동","총인구","2023.01 월","4112","7708","4076","3632",
"금사회동동","총인구","2023.02 월","4117","7693","4064","3629",
"금사회동동","총인구","2023.03 월","4116","7687","4057","3630",
"금사회동동","총인구","2023.04 월","4106","7657","4035","3622",
"금사회동동","총인구","2023.05 월","4104","7649","4036","3613",
"금사회동동","총인구","2023.06 월","4107","7633","4032","3601",
"금사회동동","총인구","2023.07 월","4104","7602","4012","3590",
"금사회동동","총인구","2023.08 월","4093","7577","3995","3582",
"금사회동동","총인구","2023.09 월","4088","7555","3976","3579",
"금사회동동","총인구","2023.10 월","4074","7524","3962","3562",
"금사회동동","총인구","2023.11 월","4067","7495","3941","3554",
"금사회동동","총인구","2023.12 월","4058","7448","3919","3529",
"금사회동동","총인구","2024.01 월","4047","7412","3898","3514",
"금사회동동","총인구","2024.02 월","4039","7407","3894","3513",
"금사회동동","총인구","2024.03 월","4028","7383","3876","3507",
"금사회동동","총인구","2024.04 월","4023","7359","3864","3495",
"금사회동동","총인구","2024.05 월","4014","7332","3857","3475",
"금사회동동","총인구","2024.06 월","3995","7288","3840","3448",
"금사회동동","총인구","2024.07 월","3990","7269","3828","3441",
"금사회동동","총인구","2024.08 월","3985","7249","3818","3431",
"금사회동동","총인구","2024.09 월","3977","7227","3812","3415",
"금사회동동","총인구","2024.10 월","3967","7182","3787","3395",
"금사회동동","총인구","2024.11 월","3951","7150","3771","3379",
"금사회동동","총인구","2024.12 월","3935","7101","3738","3363",
"부곡1동","총인구","2020.01 월","4546","9053","4347","4706",
"부곡1동","총인구","2020.02 월","4541","9010","4330","4680",
"부곡1동","총인구","2020.03 월","4541","8973","4313","4660",
"부곡1동","총인구","2020.04 월","4542","8954","4304","4650",
"부곡1동","총인구","2020.05 월","4555","8945","4302","4643",
"부곡1동","총인구","2020.06 월","4562","8905","4290","4615",
"부곡1동","총인구","2020.07 월","4576","8901","4282","4619",
"부곡1동","총인구","2020.08 월","4569","8861","4261","4600",
"부곡1동","총인구","2020.09 월","4562","8814","4247","4567",
"부곡1동","총인구","2020.10 월","4540","8767","4225","4542",
"부곡1동","총인구","2020.11 월","4550","8734","4203","4531",
"부곡1동","총인구","2020.12 월","4536","8688","4174","4514",
"부곡1동","총인구","2021.01 월","4539","8630","4133","4497",
"부곡1동","총인구","2021.02 월","4556","8637","4131","4506",
"부곡1동","총인구","2021.03 월","4526","8579","4097","4482",
"부곡1동","총인구","2021.04 월","4530","8569","4096","4473",
"부곡1동","총인구","2021.05 월","4525","8547","4081","4466",
"부곡1동","총인구","2021.06 월","4521","8511","4071","4440",
"부곡1동","총인구","2021.07 월","4510","8490","4067","4423",
"부곡1동","총인구","2021.08 월","4486","8446","4047","4399",
"부곡1동","총인구","2021.09 월","4479","8408","4029","4379",
"부곡1동","총인구","2021.10 월","4486","8382","4024","4358",
"부곡1동","총인구","2021.11 월","4480","8337","4001","4336",
"부곡1동","총인구","2021.12 월","4479","8307","3990","4317",
"부곡1동","총인구","2022.01 월","4479","8294","3993","4301",
"부곡1동","총인구","2022.02 월","4467","8265","3980","4285",
"부곡1동","총인구","2022.03 월","4469","8256","3980","4276",
"부곡1동","총인구","2022.04 월","4457","8232","3978","4254",
"부곡1동","총인구","2022.05 월","4450","8220","3957","4263",
"부곡1동","총인구","2022.06 월","4456","8234","3971","4263",
"부곡1동","총인구","2022.07 월","4457","8203","3955","4248",
"부곡1동","총인구","2022.08 월","4454","8174","3940","4234",
"부곡1동","총인구","2022.09 월","4428","8133","3926","4207",
"부곡1동","총인구","2022.10 월","4421","8108","3904","4204",
"부곡1동","총인구","2022.11 월","4415","8103","3898","4205",
"부곡1동","총인구","2022.12 월","4413","8097","3891","4206",
"부곡1동","총인구","2023.01 월","4391","8044","3865","4179",
"부곡1동","총인구","2023.02 월","4395","8015","3856","4159",
"부곡1동","총인구","2023.03 월","4377","7977","3841","4136",
"부곡1동","총인구","2023.04 월","4355","7946","3831","4115",
"부곡1동","총인구","2023.05 월","4352","7923","3815","4108",
"부곡1동","총인구","2023.06 월","4347","7885","3803","4082",
"부곡1동","총인구","2023.07 월","4341","7868","3796","4072",
"부곡1동","총인구","2023.08 월","4332","7854","3785","4069",
"부곡1동","총인구","2023.09 월","4328","7832","3777","4055",
"부곡1동","총인구","2023.10 월","4300","7781","3749","4032",
"부곡1동","총인구","2023.11 월","4285","7747","3729","4018",
"부곡1동","총인구","2023.12 월","4290","7736","3720","4016",
"부곡1동","총인구","2024.01 월","4284","7706","3711","3995",
"부곡1동","총인구","2024.02 월","4290","7696","3707","3989",
"부곡1동","총인구","2024.03 월","4281","7674","3697","3977",
"부곡1동","총인구","2024.04 월","4259","7629","3680","3949",
"부곡1동","총인구","2024.05 월","4240","7583","3663","3920",
"부곡1동","총인구","2024.06 월","4222","7549","3636","3913",
"부곡1동","총인구","2024.07 월","4207","7497","3610","3887",
"부곡1동","총인구","2024.08 월","4201","7489","3598","3891",
"부곡1동","총인구","2024.09 월","4185","7449","3585","3864",
"부곡1동","총인구","2024.10 월","4168","7390","3560","3830",
"부곡1동","총인구","2024.11 월","4153","7345","3533","3812",
"부곡1동","총인구","2024.12 월","4148","7331","3526","3805",
"부곡2동","총인구","2020.01 월","7197","17184","8299","8885",
"부곡2동","총인구","2020.02 월","7216","17158","8264","8894",
"부곡2동","총인구","2020.03 월","7254","17146","8240","8906",
"부곡2동","총인구","2020.04 월","7263","17150","8245","8905",
"부곡2동","총인구","2020.05 월","7296","17159","8254","8905",
"부곡2동","총인구","2020.06 월","7306","17174","8252","8922",
"부곡2동","총인구","2020.07 월","7314","17123","8217","8906",
"부곡2동","총인구","2020.08 월","7279","17038","8171","8867",
"부곡2동","총인구","2020.09 월","7281","17009","8153","8856",
"부곡2동","총인구","2020.10 월","7299","17035","8150","8885",
"부곡2동","총인구","2020.11 월","7299","17009","8138","8871",
"부곡2동","총인구","2020.12 월","7316","16952","8123","8829",
"부곡2동","총인구","2021.01 월","7303","16919","8115","8804",
"부곡2동","총인구","2021.02 월","7303","16872","8094","8778",
"부곡2동","총인구","2021.03 월","7256","16798","8067","8731",
"부곡2동","총인구","2021.04 월","7271","16788","8066","8722",
"부곡2동","총인구","2021.05 월","7245","16723","8024","8699",
"부곡2동","총인구","2021.06 월","7248","16693","8012","8681",
"부곡2동","총인구","2021.07 월","7426","17057","8167","8890",
"부곡2동","총인구","2021.08 월","7659","17581","8410","9171",
"부곡2동","총인구","2021.09 월","7777","17799","8510","9289",
"부곡2동","총인구","2021.10 월","7862","17947","8558","9389",
"부곡2동","총인구","2021.11 월","7936","18066","8631","9435",
"부곡2동","총인구","2021.12 월","7954","18064","8612","9452",
"부곡2동","총인구","2022.01 월","7926","17984","8568","9416",
"부곡2동","총인구","2022.02 월","7940","17965","8560","9405",
"부곡2동","총인구","2022.03 월","7956","17951","8557","9394",
"부곡2동","총인구","2022.04 월","7965","17932","8551","9381",
"부곡2동","총인구","2022.05 월","7955","17916","8540","9376",
"부곡2동","총인구","2022.06 월","7970","17899","8528","9371",
"부곡2동","총인구","2022.07 월","7953","17851","8496","9355",
"부곡2동","총인구","2022.08 월","7968","17806","8461","9345",
"부곡2동","총인구","2022.09 월","7934","17727","8414","9313",
"부곡2동","총인구","2022.10 월","7927","17698","8401","9297",
"부곡2동","총인구","2022.11 월","7923","17694","8385","9309",
"부곡2동","총인구","2022.12 월","7922","17694","8388","9306",
"부곡2동","총인구","2023.01 월","7896","17645","8354","9291",
"부곡2동","총인구","2023.02 월","7918","17619","8352","9267",
"부곡2동","총인구","2023.03 월","7914","17590","8330","9260",
"부곡2동","총인구","2023.04 월","7909","17550","8314","9236",
"부곡2동","총인구","2023.05 월","7892","17508","8292","9216",
"부곡2동","총인구","2023.06 월","7904","17493","8276","9217",
"부곡2동","총인구","2023.07 월","7903","17458","8259","9199",
"부곡2동","총인구","2023.08 월","7909","17378","8221","9157",
"부곡2동","총인구","2023.09 월","7888","17337","8195","9142",
"부곡2동","총인구","2023.10 월","7872","17311","8184","9127",
"부곡2동","총인구","2023.11 월","7854","17305","8198","9107",
"부곡2동","총인구","2023.12 월","7843","17226","8157","9069",
"부곡2동","총인구","2024.01 월","7828","17161","8104","9057",
"부곡2동","총인구","2024.02 월","7843","17141","8104","9037",
"부곡2동","총인구","2024.03 월","7868","17133","8099","9034",
"부곡2동","총인구","2024.04 월","7860","17123","8093","9030",
"부곡2동","총인구","2024.05 월","7862","17105","8076","9029",
"부곡2동","총인구","2024.06 월","7855","17061","8062","8999",
"부곡2동","총인구","2024.07 월","7856","17017","8033","8984",
"부곡2동","총인구","2024.08 월","7856","17007","8028","8979",
"부곡2동","총인구","2024.09 월","7870","17053","8052","9001",
"부곡2동","총인구","2024.10 월","7817","16905","7976","8929",
"부곡2동","총인구","2024.11 월","7799","16825","7932","8893",
"부곡2동","총인구","2024.12 월","7784","16801","7919","8882",
"부곡3동","총인구","2020.01 월","7271","17737","8506","9231",
"부곡3동","총인구","2020.02 월","7276","17658","8456","9202",
"부곡3동","총인구","2020.03 월","7238","17489","8380","9109",
"부곡3동","총인구","2020.04 월","7129","17232","8255","8977",
"부곡3동","총인구","2020.05 월","7055","17015","8148","8867",
"부곡3동","총인구","2020.06 월","6970","16777","8018","8759",
"부곡3동","총인구","2020.07 월","6949","16664","7967","8697",
"부곡3동","총인구","2020.08 월","6913","16536","7896","8640",
"부곡3동","총인구","2020.09 월","6886","16446","7851","8595",
"부곡3동","총인구","2020.10 월","6882","16412","7832","8580",
"부곡3동","총인구","2020.11 월","6879","16381","7817","8564",
"부곡3동","총인구","2020.12 월","6860","16287","7771","8516",
"부곡3동","총인구","2021.01 월","6850","16229","7751","8478",
"부곡3동","총인구","2021.02 월","6868","16221","7757","8464",
"부곡3동","총인구","2021.03 월","6837","16180","7742","8438",
"부곡3동","총인구","2021.04 월","6829","16154","7743","8411",
"부곡3동","총인구","2021.05 월","6832","16159","7749","8410",
"부곡3동","총인구","2021.06 월","6835","16137","7734","8403",
"부곡3동","총인구","2021.07 월","6843","16070","7712","8358",
"부곡3동","총인구","2021.08 월","6836","16011","7685","8326",
"부곡3동","총인구","2021.09 월","6853","15989","7688","8301",
"부곡3동","총인구","2021.10 월","6873","15989","7693","8296",
"부곡3동","총인구","2021.11 월","6878","15975","7684","8291",
"부곡3동","총인구","2021.12 월","6875","15893","7652","8241",
"부곡3동","총인구","2022.01 월","6852","15825","7595","8230",
"부곡3동","총인구","2022.02 월","6850","15744","7553","8191",
"부곡3동","총인구","2022.03 월","6840","15697","7528","8169",
"부곡3동","총인구","2022.04 월","6861","15697","7531","8166",
"부곡3동","총인구","2022.05 월","6860","15673","7513","8160",
"부곡3동","총인구","2022.06 월","6860","15653","7507","8146",
"부곡3동","총인구","2022.07 월","6861","15622","7486","8136",
"부곡3동","총인구","2022.08 월","6863","15614","7496","8118",
"부곡3동","총인구","2022.09 월","6842","15583","7465","8118",
"부곡3동","총인구","2022.10 월","6841","15556","7436","8120",
"부곡3동","총인구","2022.11 월","6830","15516","7407","8109",
"부곡3동","총인구","2022.12 월","6826","15500","7397","8103",
"부곡3동","총인구","2023.01 월","6812","15464","7369","8095",
"부곡3동","총인구","2023.02 월","6824","15417","7345","8072",
"부곡3동","총인구","2023.03 월","6832","15407","7345","8062",
"부곡3동","총인구","2023.04 월","6808","15381","7334","8047",
"부곡3동","총인구","2023.05 월","6833","15390","7334","8056",
"부곡3동","총인구","2023.06 월","6845","15359","7311","8048",
"부곡3동","총인구","2023.07 월","6839","15330","7289","8041",
"부곡3동","총인구","2023.08 월","6860","15335","7292","8043",
"부곡3동","총인구","2023.09 월","6858","15339","7293","8046",
"부곡3동","총인구","2023.10 월","6835","15293","7277","8016",
"부곡3동","총인구","2023.11 월","6816","15233","7250","7983",
"부곡3동","총인구","2023.12 월","6804","15204","7217","7987",
"부곡3동","총인구","2024.01 월","6802","15193","7214","7979",
"부곡3동","총인구","2024.02 월","6794","15115","7168","7947",
"부곡3동","총인구","2024.03 월","6818","15100","7177","7923",
"부곡3동","총인구","2024.04 월","6853","15137","7190","7947",
"부곡3동","총인구","2024.05 월","6883","15148","7186","7962",
"부곡3동","총인구","2024.06 월","6865","15099","7164","7935",
"부곡3동","총인구","2024.07 월","6845","15069","7163","7906",
"부곡3동","총인구","2024.08 월","6864","15066","7161","7905",
"부곡3동","총인구","2024.09 월","6862","15074","7153","7921",
"부곡3동","총인구","2024.10 월","6821","14998","7106","7892",
"부곡3동","총인구","2024.11 월","6795","14907","7065","7842",
"부곡3동","총인구","2024.12 월","6792","14914","7069","7845",
"부곡4동","총인구","2020.01 월","6219","13681","6600","7081",
"부곡4동","총인구","2020.02 월","6205","13626","6582","7044",
"부곡4동","총인구","2020.03 월","6176","13550","6528","7022",
"부곡4동","총인구","2020.04 월","6163","13509","6511","6998",
"부곡4동","총인구","2020.05 월","6170","13490","6498","6992",
"부곡4동","총인구","2020.06 월","6181","13491","6495","6996",
"부곡4동","총인구","2020.07 월","6173","13435","6457","6978",
"부곡4동","총인구","2020.08 월","6169","13410","6442","6968",
"부곡4동","총인구","2020.09 월","6169","13398","6438","6960",
"부곡4동","총인구","2020.10 월","6189","13411","6432","6979",
"부곡4동","총인구","2020.11 월","6183","13380","6410","6970",
"부곡4동","총인구","2020.12 월","6181","13356","6391","6965",
"부곡4동","총인구","2021.01 월","6176","13271","6353","6918",
"부곡4동","총인구","2021.02 월","6177","13219","6335","6884",
"부곡4동","총인구","2021.03 월","6134","13155","6303","6852",
"부곡4동","총인구","2021.04 월","6132","13121","6281","6840",
"부곡4동","총인구","2021.05 월","6140","13098","6279","6819",
"부곡4동","총인구","2021.06 월","6144","13059","6259","6800",
"부곡4동","총인구","2021.07 월","6158","13068","6264","6804",
"부곡4동","총인구","2021.08 월","6157","13032","6252","6780",
"부곡4동","총인구","2021.09 월","6153","13000","6237","6763",
"부곡4동","총인구","2021.10 월","6156","12982","6229","6753",
"부곡4동","총인구","2021.11 월","6157","12971","6223","6748",
"부곡4동","총인구","2021.12 월","6124","12916","6205","6711",
"부곡4동","총인구","2022.01 월","6115","12855","6181","6674",
"부곡4동","총인구","2022.02 월","6112","12808","6149","6659",
"부곡4동","총인구","2022.03 월","6110","12782","6134","6648",
"부곡4동","총인구","2022.04 월","6103","12738","6111","6627",
"부곡4동","총인구","2022.05 월","6093","12684","6088","6596",
"부곡4동","총인구","2022.06 월","6084","12643","6074","6569",
"부곡4동","총인구","2022.07 월","6085","12617","6062","6555",
"부곡4동","총인구","2022.08 월","6080","12587","6051","6536",
"부곡4동","총인구","2022.09 월","6055","12547","6019","6528",
"부곡4동","총인구","2022.10 월","6051","12503","5996","6507",
"부곡4동","총인구","2022.11 월","6048","12508","5991","6517",
"부곡4동","총인구","2022.12 월","6044","12459","5956","6503",
"부곡4동","총인구","2023.01 월","6033","12440","5942","6498",
"부곡4동","총인구","2023.02 월","6033","12408","5931","6477",
"부곡4동","총인구","2023.03 월","6028","12389","5924","6465",
"부곡4동","총인구","2023.04 월","6033","12367","5908","6459",
"부곡4동","총인구","2023.05 월","6032","12320","5878","6442",
"부곡4동","총인구","2023.06 월","6045","12304","5867","6437",
"부곡4동","총인구","2023.07 월","6038","12272","5850","6422",
"부곡4동","총인구","2023.08 월","6032","12232","5827","6405",
"부곡4동","총인구","2023.09 월","6013","12162","5793","6369",
"부곡4동","총인구","2023.10 월","5989","12118","5770","6348",
"부곡4동","총인구","2023.11 월","5988","12094","5767","6327",
"부곡4동","총인구","2023.12 월","5968","12046","5734","6312",
"부곡4동","총인구","2024.01 월","5961","11996","5711","6285",
"부곡4동","총인구","2024.02 월","5956","11974","5694","6280",
"부곡4동","총인구","2024.03 월","5950","11946","5680","6266",
"부곡4동","총인구","2024.04 월","5951","11923","5669","6254",
"부곡4동","총인구","2024.05 월","5940","11888","5661","6227",
"부곡4동","총인구","2024.06 월","5935","11859","5639","6220",
"부곡4동","총인구","2024.07 월","5920","11820","5610","6210",
"부곡4동","총인구","2024.08 월","5915","11779","5582","6197",
"부곡4동","총인구","2024.09 월","5902","11748","5563","6185",
"부곡4동","총인구","2024.10 월","5871","11670","5527","6143",
"부곡4동","총인구","2024.11 월","5861","11625","5514","6111",
"부곡4동","총인구","2024.12 월","5870","11615","5499","6116",
"장전1동","총인구","2020.01 월","9908","19594","9918","9676",
"장전1동","총인구","2020.02 월","10018","19643","9944","9699",
"장전1동","총인구","2020.03 월","10151","19698","9962","9736",
"장전1동","총인구","2020.04 월","10160","19498","9894","9604",
"장전1동","총인구","2020.05 월","10262","19563","9927","9636",
"장전1동","총인구","2020.06 월","10297","19578","9935","9643",
"장전1동","총인구","2020.07 월","10311","19521","9902","9619",
"장전1동","총인구","2020.08 월","10350","19506","9912","9594",
"장전1동","총인구","2020.09 월","10377","19517","9914","9603",
"장전1동","총인구","2020.10 월","10364","19427","9889","9538",
"장전1동","총인구","2020.11 월","10392","19428","9875","9553",
"장전1동","총인구","2020.12 월","10382","19347","9838","9509",
"장전1동","총인구","2021.01 월","10265","19183","9766","9417",
"장전1동","총인구","2021.02 월","10396","19283","9886","9397",
"장전1동","총인구","2021.03 월","10579","19467","9994","9473",
"장전1동","총인구","2021.04 월","10550","19397","9945","9452",
"장전1동","총인구","2021.05 월","10577","19415","9976","9439",
"장전1동","총인구","2021.06 월","10583","19398","9971","9427",
"장전1동","총인구","2021.07 월","10570","19346","9949","9397",
"장전1동","총인구","2021.08 월","10617","19396","9988","9408",
"장전1동","총인구","2021.09 월","10773","19588","10077","9511",
"장전1동","총인구","2021.10 월","10823","19603","10083","9520",
"장전1동","총인구","2021.11 월","10847","19623","10095","9528",
"장전1동","총인구","2021.12 월","10811","19572","10110","9462",
"장전1동","총인구","2022.01 월","10732","19395","10032","9363",
"장전1동","총인구","2022.02 월","10852","19430","10037","9393",
"장전1동","총인구","2022.03 월","10996","19562","10106","9456",
"장전1동","총인구","2022.04 월","10984","19481","10061","9420",
"장전1동","총인구","2022.05 월","11042","19530","10084","9446",
"장전1동","총인구","2022.06 월","11036","19523","10067","9456",
"장전1동","총인구","2022.07 월","11032","19520","10063","9457",
"장전1동","총인구","2022.08 월","11161","19687","10154","9533",
"장전1동","총인구","2022.09 월","11208","19787","10184","9603",
"장전1동","총인구","2022.10 월","11182","19719","10147","9572",
"장전1동","총인구","2022.11 월","11093","19623","10117","9506",
"장전1동","총인구","2022.12 월","11096","19665","10143","9522",
"장전1동","총인구","2023.01 월","10997","19523","10090","9433",
"장전1동","총인구","2023.02 월","11203","19672","10159","9513",
"장전1동","총인구","2023.03 월","11319","19770","10179","9591",
"장전1동","총인구","2023.04 월","11316","19718","10152","9566",
"장전1동","총인구","2023.05 월","11326","19710","10150","9560",
"장전1동","총인구","2023.06 월","11310","19700","10123","9577",
"장전1동","총인구","2023.07 월","11310","19691","10123","9568",
"장전1동","총인구","2023.08 월","11401","19786","10192","9594",
"장전1동","총인구","2023.09 월","11404","19841","10182","9659",
"장전1동","총인구","2023.10 월","11354","19715","10117","9598",
"장전1동","총인구","2023.11 월","11336","19740","10125","9615",
"장전1동","총인구","2023.12 월","11275","19655","10062","9593",
"장전1동","총인구","2024.01 월","11081","19443","9960","9483",
"장전1동","총인구","2024.02 월","11182","19508","10032","9476",
"장전1동","총인구","2024.03 월","11346","19655","10078","9577",
"장전1동","총인구","2024.04 월","11340","19605","10061","9544",
"장전1동","총인구","2024.05 월","11408","19658","10091","9567",
"장전1동","총인구","2024.06 월","11427","19665","10098","9567",
"장전1동","총인구","2024.07 월","11434","19601","10076","9525",
"장전1동","총인구","2024.08 월","11511","19660","10147","9513",
"장전1동","총인구","2024.09 월","11532","19737","10134","9603",
"장전1동","총인구","2024.10 월","11456","19581","10057","9524",
"장전1동","총인구","2024.11 월","11431","19543","10031","9512",
"장전1동","총인구","2024.12 월","11405","19493","9993","9500",
"장전2동","총인구","2020.01 월","11744","28740","13810","14930",
"장전2동","총인구","2020.02 월","11778","28719","13804","14915",
"장전2동","총인구","2020.03 월","11796","28679","13764","14915",
"장전2동","총인구","2020.04 월","11806","28568","13689","14879",
"장전2동","총인구","2020.05 월","11856","28494","13666","14828",
"장전2동","총인구","2020.06 월","11860","28399","13645","14754",
"장전2동","총인구","2020.07 월","11809","28182","13534","14648",
"장전2동","총인구","2020.08 월","11810","28067","13497","14570",
"장전2동","총인구","2020.09 월","11785","28075","13477","14598",
"장전2동","총인구","2020.10 월","11766","27958","13406","14552",
"장전2동","총인구","2020.11 월","11798","27932","13396","14536",
"장전2동","총인구","2020.12 월","11846","27872","13365","14507",
"장전2동","총인구","2021.01 월","11845","27833","13340","14493",
"장전2동","총인구","2021.02 월","11855","27832","13348","14484",
"장전2동","총인구","2021.03 월","11747","27816","13345","14471",
"장전2동","총인구","2021.04 월","11737","27794","13322","14472",
"장전2동","총인구","2021.05 월","11754","27803","13327","14476",
"장전2동","총인구","2021.06 월","11735","27722","13295","14427",
"장전2동","총인구","2021.07 월","11733","27621","13259","14362",
"장전2동","총인구","2021.08 월","11706","27458","13206","14252",
"장전2동","총인구","2021.09 월","11737","27619","13239","14380",
"장전2동","총인구","2021.10 월","11759","27623","13261","14362",
"장전2동","총인구","2021.11 월","11755","27555","13217","14338",
"장전2동","총인구","2021.12 월","11715","27355","13134","14221",
"장전2동","총인구","2022.01 월","11626","27076","13023","14053",
"장전2동","총인구","2022.02 월","11609","26879","12926","13953",
"장전2동","총인구","2022.03 월","11634","27012","12944","14068",
"장전2동","총인구","2022.04 월","11632","26992","12932","14060",
"장전2동","총인구","2022.05 월","11661","26968","12919","14049",
"장전2동","총인구","2022.06 월","11661","26909","12912","13997",
"장전2동","총인구","2022.07 월","11641","26839","12886","13953",
"장전2동","총인구","2022.08 월","11649","26831","12891","13940",
"장전2동","총인구","2022.09 월","11630","27106","12962","14144",
"장전2동","총인구","2022.10 월","11602","26994","12942","14052",
"장전2동","총인구","2022.11 월","11552","26876","12878","13998",
"장전2동","총인구","2022.12 월","11537","26792","12866","13926",
"장전2동","총인구","2023.01 월","11495","26558","12771","13787",
"장전2동","총인구","2023.02 월","11521","26534","12777","13757",
"장전2동","총인구","2023.03 월","11559","26701","12832","13869",
"장전2동","총인구","2023.04 월","11548","26667","12804","13863",
"장전2동","총인구","2023.05 월","11563","26687","12820","13867",
"장전2동","총인구","2023.06 월","11558","26627","12798","13829",
"장전2동","총인구","2023.07 월","11562","26545","12762","13783",
"장전2동","총인구","2023.08 월","11537","26372","12709","13663",
"장전2동","총인구","2023.09 월","11549","26626","12794","13832",
"장전2동","총인구","2023.10 월","11504","26600","12770","13830",
"장전2동","총인구","2023.11 월","11497","26591","12752","13839",
"장전2동","총인구","2023.12 월","11489","26479","12706","13773",
"장전2동","총인구","2024.01 월","11401","26217","12575","13642",
"장전2동","총인구","2024.02 월","11421","26044","12488","13556",
"장전2동","총인구","2024.03 월","11467","26125","12512","13613",
"장전2동","총인구","2024.04 월","11457","26257","12539","13718",
"장전2동","총인구","2024.05 월","11477","26269","12530","13739",
"장전2동","총인구","2024.06 월","11452","26164","12476","13688",
"장전2동","총인구","2024.07 월","11455","26109","12458","13651",
"장전2동","총인구","2024.08 월","11458","26015","12422","13593",
"장전2동","총인구","2024.09 월","11465","26301","12511","13790",
"장전2동","총인구","2024.10 월","11525","26466","12601","13865",
"장전2동","총인구","2024.11 월","11610","26640","12691","13949",
"장전2동","총인구","2024.12 월","11644","26642","12707","13935",
"선두구동","총인구","2020.01 월","1279","2464","1307","1157",
"선두구동","총인구","2020.02 월","1258","2432","1287","1145",
"선두구동","총인구","2020.03 월","1254","2426","1284","1142",
"선두구동","총인구","2020.04 월","1255","2413","1279","1134",
"선두구동","총인구","2020.05 월","1254","2407","1279","1128",
"선두구동","총인구","2020.06 월","1253","2386","1267","1119",
"선두구동","총인구","2020.07 월","1261","2391","1269","1122",
"선두구동","총인구","2020.08 월","1264","2391","1267","1124",
"선두구동","총인구","2020.09 월","1269","2399","1272","1127",
"선두구동","총인구","2020.10 월","1274","2394","1269","1125",
"선두구동","총인구","2020.11 월","1273","2382","1268","1114",
"선두구동","총인구","2020.12 월","1289","2403","1277","1126",
"선두구동","총인구","2021.01 월","1300","2431","1291","1140",
"선두구동","총인구","2021.02 월","1309","2424","1287","1137",
"선두구동","총인구","2021.03 월","1280","2376","1273","1103",
"선두구동","총인구","2021.04 월","1279","2369","1274","1095",
"선두구동","총인구","2021.05 월","1279","2358","1265","1093",
"선두구동","총인구","2021.06 월","1274","2350","1257","1093",
"선두구동","총인구","2021.07 월","1282","2355","1262","1093",
"선두구동","총인구","2021.08 월","1283","2351","1259","1092",
"선두구동","총인구","2021.09 월","1280","2348","1260","1088",
"선두구동","총인구","2021.10 월","1282","2343","1261","1082",
"선두구동","총인구","2021.11 월","1280","2346","1260","1086",
"선두구동","총인구","2021.12 월","1275","2341","1256","1085",
"선두구동","총인구","2022.01 월","1272","2331","1246","1085",
"선두구동","총인구","2022.02 월","1269","2320","1241","1079",
"선두구동","총인구","2022.03 월","1266","2312","1234","1078",
"선두구동","총인구","2022.04 월","1265","2307","1234","1073",
"선두구동","총인구","2022.05 월","1263","2304","1227","1077",
"선두구동","총인구","2022.06 월","1268","2304","1222","1082",
"선두구동","총인구","2022.07 월","1267","2300","1219","1081",
"선두구동","총인구","2022.08 월","1259","2281","1212","1069",
"선두구동","총인구","2022.09 월","1246","2257","1201","1056",
"선두구동","총인구","2022.10 월","1250","2254","1199","1055",
"선두구동","총인구","2022.11 월","1243","2246","1194","1052",
"선두구동","총인구","2022.12 월","1236","2228","1185","1043",
"선두구동","총인구","2023.01 월","1237","2230","1187","1043",
"선두구동","총인구","2023.02 월","1236","2229","1186","1043",
"선두구동","총인구","2023.03 월","1229","2215","1182","1033",
"선두구동","총인구","2023.04 월","1234","2213","1179","1034",
"선두구동","총인구","2023.05 월","1228","2203","1171","1032",
"선두구동","총인구","2023.06 월","1227","2203","1174","1029",
"선두구동","총인구","2023.07 월","1219","2188","1166","1022",
"선두구동","총인구","2023.08 월","1216","2186","1163","1023",
"선두구동","총인구","2023.09 월","1206","2161","1149","1012",
"선두구동","총인구","2023.10 월","1198","2159","1149","1010",
"선두구동","총인구","2023.11 월","1188","2146","1144","1002",
"선두구동","총인구","2023.12 월","1182","2132","1135","997",
"선두구동","총인구","2024.01 월","1181","2126","1130","996",
"선두구동","총인구","2024.02 월","1174","2102","1124","978",
"선두구동","총인구","2024.03 월","1169","2095","1122","973",
"선두구동","총인구","2024.04 월","1163","2082","1121","961",
"선두구동","총인구","2024.05 월","1166","2088","1116","972",
"선두구동","총인구","2024.06 월","1163","2079","1109","970",
"선두구동","총인구","2024.07 월","1164","2077","1107","970",
"선두구동","총인구","2024.08 월","1162","2067","1100","967",
"선두구동","총인구","2024.09 월","1160","2051","1090","961",
"선두구동","총인구","2024.10 월","1162","2044","1084","960",
"선두구동","총인구","2024.11 월","1156","2039","1082","957",
"선두구동","총인구","2024.12 월","1153","2035","1074","961",
"청룡노포동","총인구","2020.01 월","4418","10293","5044","5249",
"청룡노포동","총인구","2020.02 월","4427","10277","5038","5239",
"청룡노포동","총인구","2020.03 월","4428","10251","5024","5227",
"청룡노포동","총인구","2020.04 월","4433","10254","5026","5228",
"청룡노포동","총인구","2020.05 월","4443","10233","5020","5213",
"청룡노포동","총인구","2020.06 월","4439","10198","5001","5197",
"청룡노포동","총인구","2020.07 월","4447","10209","4998","5211",
"청룡노포동","총인구","2020.08 월","4464","10220","5001","5219",
"청룡노포동","총인구","2020.09 월","4461","10207","4994","5213",
"청룡노포동","총인구","2020.10 월","4465","10178","4977","5201",
"청룡노포동","총인구","2020.11 월","4475","10193","4974","5219",
"청룡노포동","총인구","2020.12 월","4467","10151","4960","5191",
"청룡노포동","총인구","2021.01 월","4454","10107","4945","5162",
"청룡노포동","총인구","2021.02 월","4470","10110","4951","5159",
"청룡노포동","총인구","2021.03 월","4400","9969","4884","5085",
"청룡노포동","총인구","2021.04 월","4399","9940","4874","5066",
"청룡노포동","총인구","2021.05 월","4397","9903","4858","5045",
"청룡노포동","총인구","2021.06 월","4394","9885","4849","5036",
"청룡노포동","총인구","2021.07 월","4388","9864","4837","5027",
"청룡노포동","총인구","2021.08 월","4387","9855","4828","5027",
"청룡노포동","총인구","2021.09 월","4387","9840","4818","5022",
"청룡노포동","총인구","2021.10 월","4393","9825","4797","5028",
"청룡노포동","총인구","2021.11 월","4416","9833","4794","5039",
"청룡노포동","총인구","2021.12 월","4398","9797","4780","5017",
"청룡노포동","총인구","2022.01 월","4399","9785","4762","5023",
"청룡노포동","총인구","2022.02 월","4417","9816","4782","5034",
"청룡노포동","총인구","2022.03 월","4422","9808","4774","5034",
"청룡노포동","총인구","2022.04 월","4418","9776","4763","5013",
"청룡노포동","총인구","2022.05 월","4409","9755","4746","5009",
"청룡노포동","총인구","2022.06 월","4426","9784","4764","5020",
"청룡노포동","총인구","2022.07 월","4471","9839","4791","5048",
"청룡노포동","총인구","2022.08 월","4484","9857","4796","5061",
"청룡노포동","총인구","2022.09 월","4474","9830","4783","5047",
"청룡노포동","총인구","2022.10 월","4470","9807","4779","5028",
"청룡노포동","총인구","2022.11 월","4457","9772","4765","5007",
"청룡노포동","총인구","2022.12 월","4457","9756","4753","5003",
"청룡노포동","총인구","2023.01 월","4452","9745","4748","4997",
"청룡노포동","총인구","2023.02 월","4461","9749","4746","5003",
"청룡노포동","총인구","2023.03 월","4459","9724","4739","4985",
"청룡노포동","총인구","2023.04 월","4452","9717","4742","4975",
"청룡노포동","총인구","2023.05 월","4461","9716","4742","4974",
"청룡노포동","총인구","2023.06 월","4448","9683","4724","4959",
"청룡노포동","총인구","2023.07 월","4454","9684","4728","4956",
"청룡노포동","총인구","2023.08 월","4453","9643","4709","4934",
"청룡노포동","총인구","2023.09 월","4452","9632","4697","4935",
"청룡노포동","총인구","2023.10 월","4442","9597","4685","4912",
"청룡노포동","총인구","2023.11 월","4444","9596","4688","4908",
"청룡노포동","총인구","2023.12 월","4441","9561","4663","4898",
"청룡노포동","총인구","2024.01 월","4432","9516","4640","4876",
"청룡노포동","총인구","2024.02 월","4423","9492","4622","4870",
"청룡노포동","총인구","2024.03 월","4421","9477","4608","4869",
"청룡노포동","총인구","2024.04 월","4415","9466","4604","4862",
"청룡노포동","총인구","2024.05 월","4410","9435","4586","4849",
"청룡노포동","총인구","2024.06 월","4409","9420","4578","4842",
"청룡노포동","총인구","2024.07 월","4394","9367","4558","4809",
"청룡노포동","총인구","2024.08 월","4387","9348","4557","4791",
"청룡노포동","총인구","2024.09 월","4389","9332","4542","4790",
"청룡노포동","총인구","2024.10 월","4380","9302","4529","4773",
"청룡노포동","총인구","2024.11 월","4376","9279","4517","4762",
"청룡노포동","총인구","2024.12 월","4373","9268","4508","4760",
"남산동","총인구","2020.01 월","13923","31608","15297","16311",
"남산동","총인구","2020.02 월","13927","31501","15251","16250",
"남산동","총인구","2020.03 월","13925","31384","15175","16209",
"남산동","총인구","2020.04 월","13904","31122","15082","16040",
"남산동","총인구","2020.05 월","13923","31046","15046","16000",
"남산동","총인구","2020.06 월","13961","31012","15032","15980",
"남산동","총인구","2020.07 월","13977","30928","14989","15939",
"남산동","총인구","2020.08 월","13982","30789","14946","15843",
"남산동","총인구","2020.09 월","13994","30860","14937","15923",
"남산동","총인구","2020.10 월","14003","30760","14913","15847",
"남산동","총인구","2020.11 월","14009","30660","14863","15797",
"남산동","총인구","2020.12 월","14018","30530","14807","15723",
"남산동","총인구","2021.01 월","14026","30381","14732","15649",
"남산동","총인구","2021.02 월","14036","30216","14668","15548",
"남산동","총인구","2021.03 월","14032","30245","14614","15631",
"남산동","총인구","2021.04 월","14041","30199","14574","15625",
"남산동","총인구","2021.05 월","14044","30105","14533","15572",
"남산동","총인구","2021.06 월","14059","29989","14479","15510",
"남산동","총인구","2021.07 월","14086","29916","14464","15452",
"남산동","총인구","2021.08 월","14099","29790","14418","15372",
"남산동","총인구","2021.09 월","14178","30054","14449","15605",
"남산동","총인구","2021.10 월","14188","29988","14430","15558",
"남산동","총인구","2021.11 월","14201","29919","14398","15521",
"남산동","총인구","2021.12 월","14174","29703","14315","15388",
"남산동","총인구","2022.01 월","14136","29508","14240","15268",
"남산동","총인구","2022.02 월","14204","29413","14217","15196",
"남산동","총인구","2022.03 월","14212","29430","14191","15239",
"남산동","총인구","2022.04 월","14208","29331","14142","15189",
"남산동","총인구","2022.05 월","14207","29281","14112","15169",
"남산동","총인구","2022.06 월","14110","28965","13957","15008",
"남산동","총인구","2022.07 월","14055","28811","13887","14924",
"남산동","총인구","2022.08 월","14052","28681","13837","14844",
"남산동","총인구","2022.09 월","13999","28896","13865","15031",
"남산동","총인구","2022.10 월","13994","28769","13808","14961",
"남산동","총인구","2022.11 월","13949","28673","13762","14911",
"남산동","총인구","2022.12 월","13906","28585","13713","14872",
"남산동","총인구","2023.01 월","13848","28438","13634","14804",
"남산동","총인구","2023.02 월","13858","28300","13586","14714",
"남산동","총인구","2023.03 월","13875","28444","13603","14841",
"남산동","총인구","2023.04 월","13851","28352","13571","14781",
"남산동","총인구","2023.05 월","13851","28286","13529","14757",
"남산동","총인구","2023.06 월","13799","28147","13463","14684",
"남산동","총인구","2023.07 월","13793","28031","13422","14609",
"남산동","총인구","2023.08 월","13792","27894","13381","14513",
"남산동","총인구","2023.09 월","13793","28084","13395","14689",
"남산동","총인구","2023.10 월","13769","27940","13369","14571",
"남산동","총인구","2023.11 월","13744","27861","13333","14528",
"남산동","총인구","2023.12 월","13722","27770","13291","14479",
"남산동","총인구","2024.01 월","13676","27647","13257","14390",
"남산동","총인구","2024.02 월","13680","27486","13210","14276",
"남산동","총인구","2024.03 월","13715","27437","13190","14247",
"남산동","총인구","2024.04 월","13709","27553","13198","14355",
"남산동","총인구","2024.05 월","13713","27464","13162","14302",
"남산동","총인구","2024.06 월","13693","27382","13151","14231",
"남산동","총인구","2024.07 월","13628","27218","13096","14122",
"남산동","총인구","2024.08 월","13624","26996","13044","13952",
"남산동","총인구","2024.09 월","13632","27087","13052","14035",
"남산동","총인구","2024.10 월","13587","27210","13062","14148",
"남산동","총인구","2024.11 월","13595","27154","13055","14099",
"남산동","총인구","2024.12 월","13572","27046","13004","14042",
"구서1동","총인구","2020.01 월","7570","19534","9280","10254",
"구서1동","총인구","2020.02 월","7605","19573","9289","10284",
"구서1동","총인구","2020.03 월","7638","19549","9271","10278",
"구서1동","총인구","2020.04 월","7675","19572","9293","10279",
"구서1동","총인구","2020.05 월","7685","19552","9280","10272",
"구서1동","총인구","2020.06 월","7693","19544","9280","10264",
"구서1동","총인구","2020.07 월","7700","19525","9261","10264",
"구서1동","총인구","2020.08 월","7808","19749","9365","10384",
"구서1동","총인구","2020.09 월","7895","19930","9444","10486",
"구서1동","총인구","2020.10 월","7906","19880","9413","10467",
"구서1동","총인구","2020.11 월","7974","19970","9460","10510",
"구서1동","총인구","2020.12 월","8008","20004","9499","10505",
"구서1동","총인구","2021.01 월","8049","20067","9526","10541",
"구서1동","총인구","2021.02 월","8060","20041","9509","10532",
"구서1동","총인구","2021.03 월","8045","20015","9502","10513",
"구서1동","총인구","2021.04 월","8044","20012","9489","10523",
"구서1동","총인구","2021.05 월","8048","19970","9480","10490",
"구서1동","총인구","2021.06 월","8063","19954","9477","10477",
"구서1동","총인구","2021.07 월","8063","19928","9467","10461",
"구서1동","총인구","2021.08 월","8055","19899","9450","10449",
"구서1동","총인구","2021.09 월","8080","19889","9440","10449",
"구서1동","총인구","2021.10 월","8082","19867","9433","10434",
"구서1동","총인구","2021.11 월","8092","19845","9420","10425",
"구서1동","총인구","2021.12 월","8075","19783","9385","10398",
"구서1동","총인구","2022.01 월","8058","19714","9342","10372",
"구서1동","총인구","2022.02 월","8043","19610","9293","10317",
"구서1동","총인구","2022.03 월","8030","19589","9270","10319",
"구서1동","총인구","2022.04 월","8020","19527","9233","10294",
"구서1동","총인구","2022.05 월","8031","19529","9225","10304",
"구서1동","총인구","2022.06 월","8046","19514","9209","10305",
"구서1동","총인구","2022.07 월","8048","19480","9203","10277",
"구서1동","총인구","2022.08 월","8049","19453","9200","10253",
"구서1동","총인구","2022.09 월","8029","19408","9182","10226",
"구서1동","총인구","2022.10 월","8020","19367","9173","10194",
"구서1동","총인구","2022.11 월","7999","19341","9162","10179",
"구서1동","총인구","2022.12 월","7985","19314","9136","10178",
"구서1동","총인구","2023.01 월","7979","19279","9107","10172",
"구서1동","총인구","2023.02 월","7966","19194","9066","10128",
"구서1동","총인구","2023.03 월","7967","19179","9046","10133",
"구서1동","총인구","2023.04 월","7971","19143","9030","10113",
"구서1동","총인구","2023.05 월","7967","19102","9013","10089",
"구서1동","총인구","2023.06 월","7975","19087","9008","10079",
"구서1동","총인구","2023.07 월","7978","19085","9010","10075",
"구서1동","총인구","2023.08 월","7975","19067","9007","10060",
"구서1동","총인구","2023.09 월","7955","19034","8991","10043",
"구서1동","총인구","2023.10 월","7939","18975","8958","10017",
"구서1동","총인구","2023.11 월","7941","18947","8952","9995",
"구서1동","총인구","2023.12 월","7943","18931","8934","9997",
"구서1동","총인구","2024.01 월","7930","18871","8899","9972",
"구서1동","총인구","2024.02 월","7908","18781","8858","9923",
"구서1동","총인구","2024.03 월","7912","18761","8841","9920",
"구서1동","총인구","2024.04 월","7905","18750","8835","9915",
"구서1동","총인구","2024.05 월","7913","18732","8821","9911",
"구서1동","총인구","2024.06 월","7906","18713","8814","9899",
"구서1동","총인구","2024.07 월","7904","18701","8802","9899",
"구서1동","총인구","2024.08 월","7892","18661","8770","9891",
"구서1동","총인구","2024.09 월","7886","18650","8761","9889",
"구서1동","총인구","2024.10 월","7871","18554","8734","9820",
"구서1동","총인구","2024.11 월","7858","18497","8698","9799",
"구서1동","총인구","2024.12 월","7841","18441","8674","9767",
"구서2동","총인구","2020.01 월","13255","34522","16572","17950",
"구서2동","총인구","2020.02 월","13283","34550","16575","17975",
"구서2동","총인구","2020.03 월","13279","34410","16495","17915",
"구서2동","총인구","2020.04 월","13296","34359","16463","17896",
"구서2동","총인구","2020.05 월","13340","34353","16441","17912",
"구서2동","총인구","2020.06 월","13369","34349","16427","17922",
"구서2동","총인구","2020.07 월","13408","34314","16425","17889",
"구서2동","총인구","2020.08 월","13422","34238","16368","17870",
"구서2동","총인구","2020.09 월","13440","34136","16305","17831",
"구서2동","총인구","2020.10 월","13439","34080","16263","17817",
"구서2동","총인구","2020.11 월","13439","34014","16246","17768",
"구서2동","총인구","2020.12 월","13462","33992","16229","17763",
"구서2동","총인구","2021.01 월","13476","33915","16181","17734",
"구서2동","총인구","2021.02 월","13508","33932","16185","17747",
"구서2동","총인구","2021.03 월","13486","33847","16138","17709",
"구서2동","총인구","2021.04 월","13507","33867","16162","17705",
"구서2동","총인구","2021.05 월","13498","33761","16106","17655",
"구서2동","총인구","2021.06 월","13495","33729","16093","17636",
"구서2동","총인구","2021.07 월","13491","33685","16072","17613",
"구서2동","총인구","2021.08 월","13479","33562","15995","17567",
"구서2동","총인구","2021.09 월","13512","33571","16006","17565",
"구서2동","총인구","2021.10 월","13483","33472","15961","17511",
"구서2동","총인구","2021.11 월","13473","33386","15934","17452",
"구서2동","총인구","2021.12 월","13457","33238","15868","17370",
"구서2동","총인구","2022.01 월","13435","33063","15778","17285",
"구서2동","총인구","2022.02 월","13375","32822","15668","17154",
"구서2동","총인구","2022.03 월","13367","32738","15617","17121",
"구서2동","총인구","2022.04 월","13341","32659","15594","17065",
"구서2동","총인구","2022.05 월","13323","32617","15587","17030",
"구서2동","총인구","2022.06 월","13323","32567","15560","17007",
"구서2동","총인구","2022.07 월","13302","32500","15526","16974",
"구서2동","총인구","2022.08 월","13312","32412","15481","16931",
"구서2동","총인구","2022.09 월","13288","32364","15460","16904",
"구서2동","총인구","2022.10 월","13273","32280","15423","16857",
"구서2동","총인구","2022.11 월","13253","32222","15388","16834",
"구서2동","총인구","2022.12 월","13266","32186","15365","16821",
"구서2동","총인구","2023.01 월","13259","32150","15355","16795",
"구서2동","총인구","2023.02 월","13263","32052","15306","16746",
"구서2동","총인구","2023.03 월","13269","31999","15282","16717",
"구서2동","총인구","2023.04 월","13258","31977","15252","16725",
"구서2동","총인구","2023.05 월","13252","31939","15235","16704",
"구서2동","총인구","2023.06 월","13249","31909","15209","16700",
"구서2동","총인구","2023.07 월","13253","31823","15171","16652",
"구서2동","총인구","2023.08 월","13259","31802","15169","16633",
"구서2동","총인구","2023.09 월","13240","31736","15144","16592",
"구서2동","총인구","2023.10 월","13218","31650","15104","16546",
"구서2동","총인구","2023.11 월","13200","31611","15081","16530",
"구서2동","총인구","2023.12 월","13173","31489","15034","16455",
"구서2동","총인구","2024.01 월","13150","31449","14988","16461",
"구서2동","총인구","2024.02 월","13158","31379","14963","16416",
"구서2동","총인구","2024.03 월","13160","31335","14931","16404",
"구서2동","총인구","2024.04 월","13132","31265","14891","16374",
"구서2동","총인구","2024.05 월","13156","31295","14889","16406",
"구서2동","총인구","2024.06 월","13145","31231","14847","16384",
"구서2동","총인구","2024.07 월","13161","31220","14848","16372",
"구서2동","총인구","2024.08 월","13154","31144","14806","16338",
"구서2동","총인구","2024.09 월","13141","31092","14779","16313",
"구서2동","총인구","2024.10 월","13127","31007","14739","16268",
"구서2동","총인구","2024.11 월","13106","30917","14698","16219",
"구서2동","총인구","2024.12 월","13086","30844","14675","16169",
"금성동","총인구","2020.01 월","492","1132","552","580",
"금성동","총인구","2020.02 월","491","1124","547","577",
"금성동","총인구","2020.03 월","492","1121","546","575",
"금성동","총인구","2020.04 월","491","1118","545","573",
"금성동","총인구","2020.05 월","486","1109","539","570",
"금성동","총인구","2020.06 월","486","1104","538","566",
"금성동","총인구","2020.07 월","487","1103","537","566",
"금성동","총인구","2020.08 월","485","1100","535","565",
"금성동","총인구","2020.09 월","483","1099","534","565",
"금성동","총인구","2020.10 월","484","1098","534","564",
"금성동","총인구","2020.11 월","487","1098","533","565",
"금성동","총인구","2020.12 월","488","1094","532","562",
"금성동","총인구","2021.01 월","491","1095","530","565",
"금성동","총인구","2021.02 월","490","1090","530","560",
"금성동","총인구","2021.03 월","483","1077","520","557",
"금성동","총인구","2021.04 월","480","1069","516","553",
"금성동","총인구","2021.05 월","481","1070","515","555",
"금성동","총인구","2021.06 월","478","1063","510","553",
"금성동","총인구","2021.07 월","477","1060","507","553",
"금성동","총인구","2021.08 월","476","1062","507","555",
"금성동","총인구","2021.09 월","475","1062","511","551",
"금성동","총인구","2021.10 월","475","1055","507","548",
"금성동","총인구","2021.11 월","476","1061","508","553",
"금성동","총인구","2021.12 월","476","1053","502","551",
"금성동","총인구","2022.01 월","476","1049","504","545",
"금성동","총인구","2022.02 월","472","1033","496","537",
"금성동","총인구","2022.03 월","472","1028","494","534",
"금성동","총인구","2022.04 월","472","1030","495","535",
"금성동","총인구","2022.05 월","468","1020","487","533",
"금성동","총인구","2022.06 월","468","1017","484","533",
"금성동","총인구","2022.07 월","471","1020","490","530",
"금성동","총인구","2022.08 월","474","1016","487","529",
"금성동","총인구","2022.09 월","470","1006","486","520",
"금성동","총인구","2022.10 월","468","1006","487","519",
"금성동","총인구","2022.11 월","472","1007","485","522",
"금성동","총인구","2022.12 월","469","1004","484","520",
"금성동","총인구","2023.01 월","466","1004","483","521",
"금성동","총인구","2023.02 월","465","998","484","514",
"금성동","총인구","2023.03 월","460","980","479","501",
"금성동","총인구","2023.04 월","459","974","477","497",
"금성동","총인구","2023.05 월","462","980","478","502",
"금성동","총인구","2023.06 월","462","980","480","500",
"금성동","총인구","2023.07 월","460","969","476","493",
"금성동","총인구","2023.08 월","461","966","478","488",
"금성동","총인구","2023.09 월","455","953","470","483",
"금성동","총인구","2023.10 월","452","946","467","479",
"금성동","총인구","2023.11 월","451","935","463","472",
"금성동","총인구","2023.12 월","451","938","469","469",
"금성동","총인구","2024.01 월","447","930","464","466",
"금성동","총인구","2024.02 월","448","925","462","463",
"금성동","총인구","2024.03 월","445","916","454","462",
"금성동","총인구","2024.04 월","445","914","453","461",
"금성동","총인구","2024.05 월","448","914","452","462",
"금성동","총인구","2024.06 월","448","913","453","460",
"금성동","총인구","2024.07 월","448","912","451","461",
"금성동","총인구","2024.08 월","450","911","451","460",
"금성동","총인구","2024.09 월","451","905","449","456",
"금성동","총인구","2024.10 월","448","903","448","455",
"금성동","총인구","2024.11 월","449","901","444","457",
"금성동","총인구","2024.12 월","449","902","444","458",
"강서구","총인구","2020.01 월","54087","135812","71980","63832",
"강서구","총인구","2020.02 월","54359","136226","72139","64087",
"강서구","총인구","2020.03 월","54611","136491","72232","64259",
"강서구","총인구","2020.04 월","54725","136516","72206","64310",
"강서구","총인구","2020.05 월","54994","136814","72352","64462",
"강서구","총인구","2020.06 월","55158","137005","72436","64569",
"강서구","총인구","2020.07 월","55314","137122","72447","64675",
"강서구","총인구","2020.08 월","55958","138423","73091","65332",
"강서구","총인구","2020.09 월","56828","140337","74069","66268",
"강서구","총인구","2020.10 월","57341","141408","74564","66844",
"강서구","총인구","2020.11 월","57690","142064","74866","67198",
"강서구","총인구","2020.12 월","58141","142719","75157","67562",
"강서구","총인구","2021.01 월","58512","143347","75515","67832",
"강서구","총인구","2021.02 월","58905","143787","75736","68051",
"강서구","총인구","2021.03 월","58879","143899","75819","68080",
"강서구","총인구","2021.04 월","59236","144243","75992","68251",
"강서구","총인구","2021.05 월","59598","144752","76249","68503",
"강서구","총인구","2021.06 월","59954","145270","76539","68731",
"강서구","총인구","2021.07 월","60289","145740","76786","68954",
"강서구","총인구","2021.08 월","60574","146189","77049","69140",
"강서구","총인구","2021.09 월","60878","146607","77292","69315",
"강서구","총인구","2021.10 월","61157","146910","77451","69459",
"강서구","총인구","2021.11 월","61397","147215","77590","69625",
"강서구","총인구","2021.12 월","61502","147347","77658","69689",
"강서구","총인구","2022.01 월","61711","147512","77712","69800",
"강서구","총인구","2022.02 월","61929","147652","77762","69890",
"강서구","총인구","2022.03 월","62135","147857","77818","70039",
"강서구","총인구","2022.04 월","62285","148066","77948","70118",
"강서구","총인구","2022.05 월","62530","148386","78147","70239",
"강서구","총인구","2022.06 월","62674","148522","78244","70278",
"강서구","총인구","2022.07 월","62758","148586","78263","70323",
"강서구","총인구","2022.08 월","62728","148447","78219","70228",
"강서구","총인구","2022.09 월","62645","148292","78217","70075",
"강서구","총인구","2022.10 월","62601","148213","78210","70003",
"강서구","총인구","2022.11 월","62497","148165","78259","69906",
"강서구","총인구","2022.12 월","62426","148257","78413","69844",
"강서구","총인구","2023.01 월","62358","148217","78438","69779",
"강서구","총인구","2023.02 월","62350","148060","78393","69667",
"강서구","총인구","2023.03 월","62376","148176","78446","69730",
"강서구","총인구","2023.04 월","62443","148315","78561","69754",
"강서구","총인구","2023.05 월","62466","148504","78739","69765",
"강서구","총인구","2023.06 월","62494","148597","78813","69784",
"강서구","총인구","2023.07 월","62482","148678","78900","69778",
"강서구","총인구","2023.08 월","62506","148693","78970","69723",
"강서구","총인구","2023.09 월","62513","148762","79014","69748",
"강서구","총인구","2023.10 월","62465","148705","79008","69697",
"강서구","총인구","2023.11 월","62354","148736","79077","69659",
"강서구","총인구","2023.12 월","62238","148540","79016","69524",
"강서구","총인구","2024.01 월","62153","148516","79144","69372",
"강서구","총인구","2024.02 월","62085","148245","79047","69198",
"강서구","총인구","2024.03 월","62113","148315","79103","69212",
"강서구","총인구","2024.04 월","62215","148720","79315","69405",
"강서구","총인구","2024.05 월","62312","149009","79452","69557",
"강서구","총인구","2024.06 월","62322","148997","79451","69546",
"강서구","총인구","2024.07 월","62463","149400","79667","69733",
"강서구","총인구","2024.08 월","62605","149855","79891","69964",
"강서구","총인구","2024.09 월","62617","149951","79960","69991",
"강서구","총인구","2024.10 월","62569","149954","79968","69986",
"강서구","총인구","2024.11 월","62457","149906","79980","69926",
"강서구","총인구","2024.12 월","62433","149982","80013","69969",
"대저1동","총인구","2020.01 월","3814","7088","3957","3131",
"대저1동","총인구","2020.02 월","3794","7027","3919","3108",
"대저1동","총인구","2020.03 월","3801","7020","3921","3099",
"대저1동","총인구","2020.04 월","3805","6991","3899","3092",
"대저1동","총인구","2020.05 월","3801","6986","3893","3093",
"대저1동","총인구","2020.06 월","3811","6979","3884","3095",
"대저1동","총인구","2020.07 월","3818","6975","3877","3098",
"대저1동","총인구","2020.08 월","3813","6941","3856","3085",
"대저1동","총인구","2020.09 월","3836","6953","3858","3095",
"대저1동","총인구","2020.10 월","3851","6958","3852","3106",
"대저1동","총인구","2020.11 월","3864","6973","3861","3112",
"대저1동","총인구","2020.12 월","3877","6970","3856","3114",
"대저1동","총인구","2021.01 월","3871","6971","3866","3105",
"대저1동","총인구","2021.02 월","3868","6952","3863","3089",
"대저1동","총인구","2021.03 월","3733","6794","3784","3010",
"대저1동","총인구","2021.04 월","3725","6759","3763","2996",
"대저1동","총인구","2021.05 월","3729","6752","3756","2996",
"대저1동","총인구","2021.06 월","3724","6744","3753","2991",
"대저1동","총인구","2021.07 월","3722","6744","3754","2990",
"대저1동","총인구","2021.08 월","3708","6713","3739","2974",
"대저1동","총인구","2021.09 월","3711","6715","3735","2980",
"대저1동","총인구","2021.10 월","3717","6699","3718","2981",
"대저1동","총인구","2021.11 월","3742","6712","3720","2992",
"대저1동","총인구","2021.12 월","3740","6707","3708","2999",
"대저1동","총인구","2022.01 월","3746","6690","3702","2988",
"대저1동","총인구","2022.02 월","3738","6651","3691","2960",
"대저1동","총인구","2022.03 월","3726","6621","3667","2954",
"대저1동","총인구","2022.04 월","3724","6594","3654","2940",
"대저1동","총인구","2022.05 월","3713","6565","3635","2930",
"대저1동","총인구","2022.06 월","3709","6554","3633","2921",
"대저1동","총인구","2022.07 월","3713","6555","3631","2924",
"대저1동","총인구","2022.08 월","3693","6505","3602","2903",
"대저1동","총인구","2022.09 월","3654","6437","3568","2869",
"대저1동","총인구","2022.10 월","3635","6399","3555","2844",
"대저1동","총인구","2022.11 월","3620","6357","3528","2829",
"대저1동","총인구","2022.12 월","3616","6328","3513","2815",
"대저1동","총인구","2023.01 월","3592","6294","3499","2795",
"대저1동","총인구","2023.02 월","3591","6281","3492","2789",
"대저1동","총인구","2023.03 월","3576","6262","3489","2773",
"대저1동","총인구","2023.04 월","3573","6257","3485","2772",
"대저1동","총인구","2023.05 월","3559","6227","3472","2755",
"대저1동","총인구","2023.06 월","3551","6196","3451","2745",
"대저1동","총인구","2023.07 월","3533","6163","3435","2728",
"대저1동","총인구","2023.08 월","3520","6138","3420","2718",
"대저1동","총인구","2023.09 월","3506","6100","3400","2700",
"대저1동","총인구","2023.10 월","3505","6095","3400","2695",
"대저1동","총인구","2023.11 월","3507","6088","3403","2685",
"대저1동","총인구","2023.12 월","3505","6074","3395","2679",
"대저1동","총인구","2024.01 월","3495","6051","3391","2660",
"대저1동","총인구","2024.02 월","3494","6061","3400","2661",
"대저1동","총인구","2024.03 월","3480","6025","3372","2653",
"대저1동","총인구","2024.04 월","3463","5989","3359","2630",
"대저1동","총인구","2024.05 월","3443","5957","3337","2620",
"대저1동","총인구","2024.06 월","3437","5943","3325","2618",
"대저1동","총인구","2024.07 월","3425","5933","3317","2616",
"대저1동","총인구","2024.08 월","3409","5908","3302","2606",
"대저1동","총인구","2024.09 월","3398","5895","3296","2599",
"대저1동","총인구","2024.10 월","3378","5864","3268","2596",
"대저1동","총인구","2024.11 월","3353","5837","3248","2589",
"대저1동","총인구","2024.12 월","3331","5797","3222","2575",
"대저2동","총인구","2020.01 월","3673","7687","4334","3353",
"대저2동","총인구","2020.02 월","3659","7624","4301","3323",
"대저2동","총인구","2020.03 월","3646","7566","4265","3301",
"대저2동","총인구","2020.04 월","3647","7471","4193","3278",
"대저2동","총인구","2020.05 월","3647","7426","4160","3266",
"대저2동","총인구","2020.06 월","3649","7408","4138","3270",
"대저2동","총인구","2020.07 월","3648","7385","4128","3257",
"대저2동","총인구","2020.08 월","3630","7334","4109","3225",
"대저2동","총인구","2020.09 월","3624","7313","4105","3208",
"대저2동","총인구","2020.10 월","3630","7330","4114","3216",
"대저2동","총인구","2020.11 월","3628","7312","4108","3204",
"대저2동","총인구","2020.12 월","3614","7248","4074","3174",
"대저2동","총인구","2021.01 월","3618","7228","4066","3162",
"대저2동","총인구","2021.02 월","3641","7259","4081","3178",
"대저2동","총인구","2021.03 월","3599","7193","4047","3146",
"대저2동","총인구","2021.04 월","3601","7158","4038","3120",
"대저2동","총인구","2021.05 월","3612","7176","4050","3126",
"대저2동","총인구","2021.06 월","3643","7189","4062","3127",
"대저2동","총인구","2021.07 월","3691","7259","4090","3169",
"대저2동","총인구","2021.08 월","3716","7282","4104","3178",
"대저2동","총인구","2021.09 월","3725","7246","4100","3146",
"대저2동","총인구","2021.10 월","3714","7216","4086","3130",
"대저2동","총인구","2021.11 월","3705","7192","4062","3130",
"대저2동","총인구","2021.12 월","3726","7201","4072","3129",
"대저2동","총인구","2022.01 월","3732","7182","4058","3124",
"대저2동","총인구","2022.02 월","3735","7178","4049","3129",
"대저2동","총인구","2022.03 월","3725","7134","4031","3103",
"대저2동","총인구","2022.04 월","3727","7136","4028","3108",
"대저2동","총인구","2022.05 월","3736","7150","4040","3110",
"대저2동","총인구","2022.06 월","3734","7137","4045","3092",
"대저2동","총인구","2022.07 월","3730","7138","4044","3094",
"대저2동","총인구","2022.08 월","3723","7125","4025","3100",
"대저2동","총인구","2022.09 월","3723","7117","4027","3090",
"대저2동","총인구","2022.10 월","3719","7118","4022","3096",
"대저2동","총인구","2022.11 월","3721","7122","4026","3096",
"대저2동","총인구","2022.12 월","3696","7084","3993","3091",
"대저2동","총인구","2023.01 월","3689","7058","3982","3076",
"대저2동","총인구","2023.02 월","3688","7022","3979","3043",
"대저2동","총인구","2023.03 월","3692","7025","3976","3049",
"대저2동","총인구","2023.04 월","3683","7014","3967","3047",
"대저2동","총인구","2023.05 월","3660","6975","3940","3035",
"대저2동","총인구","2023.06 월","3641","6945","3928","3017",
"대저2동","총인구","2023.07 월","3620","6920","3914","3006",
"대저2동","총인구","2023.08 월","3602","6896","3900","2996",
"대저2동","총인구","2023.09 월","3599","6893","3903","2990",
"대저2동","총인구","2023.10 월","3579","6859","3879","2980",
"대저2동","총인구","2023.11 월","3567","6832","3872","2960",
"대저2동","총인구","2023.12 월","3547","6791","3847","2944",
"대저2동","총인구","2024.01 월","3540","6765","3835","2930",
"대저2동","총인구","2024.02 월","3532","6739","3833","2906",
"대저2동","총인구","2024.03 월","3520","6716","3821","2895",
"대저2동","총인구","2024.04 월","3506","6698","3807","2891",
"대저2동","총인구","2024.05 월","3501","6682","3801","2881",
"대저2동","총인구","2024.06 월","3473","6635","3779","2856",
"대저2동","총인구","2024.07 월","3448","6589","3755","2834",
"대저2동","총인구","2024.08 월","3422","6544","3724","2820",
"대저2동","총인구","2024.09 월","3408","6517","3705","2812",
"대저2동","총인구","2024.10 월","3383","6458","3675","2783",
"대저2동","총인구","2024.11 월","3352","6390","3630","2760",
"대저2동","총인구","2024.12 월","3338","6363","3620","2743",
"강동동","총인구","2020.01 월","2686","4854","2633","2221",
"강동동","총인구","2020.02 월","2683","4839","2619","2220",
"강동동","총인구","2020.03 월","2677","4806","2606","2200",
"강동동","총인구","2020.04 월","2658","4772","2587","2185",
"강동동","총인구","2020.05 월","2661","4764","2589","2175",
"강동동","총인구","2020.06 월","2656","4745","2575","2170",
"강동동","총인구","2020.07 월","2654","4738","2568","2170",
"강동동","총인구","2020.08 월","2654","4717","2549","2168",
"강동동","총인구","2020.09 월","2637","4680","2530","2150",
"강동동","총인구","2020.10 월","2628","4651","2510","2141",
"강동동","총인구","2020.11 월","2641","4647","2508","2139",
"강동동","총인구","2020.12 월","2652","4642","2509","2133",
"강동동","총인구","2021.01 월","2638","4620","2493","2127",
"강동동","총인구","2021.02 월","2632","4604","2484","2120",
"강동동","총인구","2021.03 월","2528","4488","2425","2063",
"강동동","총인구","2021.04 월","2533","4464","2407","2057",
"강동동","총인구","2021.05 월","2544","4467","2416","2051",
"강동동","총인구","2021.06 월","2541","4451","2403","2048",
"강동동","총인구","2021.07 월","2532","4425","2394","2031",
"강동동","총인구","2021.08 월","2531","4403","2387","2016",
"강동동","총인구","2021.09 월","2532","4378","2378","2000",
"강동동","총인구","2021.10 월","2527","4353","2363","1990",
"강동동","총인구","2021.11 월","2531","4356","2362","1994",
"강동동","총인구","2021.12 월","2527","4346","2361","1985",
"강동동","총인구","2022.01 월","2536","4340","2357","1983",
"강동동","총인구","2022.02 월","2539","4334","2352","1982",
"강동동","총인구","2022.03 월","2546","4332","2351","1981",
"강동동","총인구","2022.04 월","2534","4302","2329","1973",
"강동동","총인구","2022.05 월","2539","4304","2333","1971",
"강동동","총인구","2022.06 월","2543","4300","2329","1971",
"강동동","총인구","2022.07 월","2540","4281","2320","1961",
"강동동","총인구","2022.08 월","2513","4244","2297","1947",
"강동동","총인구","2022.09 월","2513","4232","2293","1939",
"강동동","총인구","2022.10 월","2514","4227","2282","1945",
"강동동","총인구","2022.11 월","2509","4218","2282","1936",
"강동동","총인구","2022.12 월","2495","4212","2282","1930",
"강동동","총인구","2023.01 월","2476","4196","2273","1923",
"강동동","총인구","2023.02 월","2469","4179","2261","1918",
"강동동","총인구","2023.03 월","2470","4170","2261","1909",
"강동동","총인구","2023.04 월","2476","4165","2255","1910",
"강동동","총인구","2023.05 월","2473","4163","2252","1911",
"강동동","총인구","2023.06 월","2478","4162","2254","1908",
"강동동","총인구","2023.07 월","2471","4150","2249","1901",
"강동동","총인구","2023.08 월","2461","4132","2241","1891",
"강동동","총인구","2023.09 월","2456","4122","2238","1884",
"강동동","총인구","2023.10 월","2443","4108","2227","1881",
"강동동","총인구","2023.11 월","2418","4071","2202","1869",
"강동동","총인구","2023.12 월","2402","4039","2183","1856",
"강동동","총인구","2024.01 월","2399","4043","2183","1860",
"강동동","총인구","2024.02 월","2392","4029","2181","1848",
"강동동","총인구","2024.03 월","2458","4205","2278","1927",
"강동동","총인구","2024.04 월","2677","4852","2608","2244",
"강동동","총인구","2024.05 월","2793","5156","2755","2401",
"강동동","총인구","2024.06 월","2809","5216","2789","2427",
"강동동","총인구","2024.07 월","2981","5709","3016","2693",
"강동동","총인구","2024.08 월","3188","6327","3318","3009",
"강동동","총인구","2024.09 월","3236","6478","3390","3088",
"강동동","총인구","2024.10 월","3296","6612","3468","3144",
"강동동","총인구","2024.11 월","3330","6773","3559","3214",
"강동동","총인구","2024.12 월","3342","6842","3591","3251",
"명지1동","총인구","2020.01 월","15932","43149","21611","21538",
"명지1동","총인구","2020.02 월","16033","43504","21781","21723",
"명지1동","총인구","2020.03 월","16079","43618","21830","21788",
"명지1동","총인구","2020.04 월","16110","43691","21865","21826",
"명지1동","총인구","2020.05 월","16141","43756","21903","21853",
"명지1동","총인구","2020.06 월","16153","43820","21948","21872",
"명지1동","총인구","2020.07 월","16184","43856","21945","21911",
"명지1동","총인구","2020.08 월","16833","45518","22789","22729",
"명지1동","총인구","2020.09 월","17735","47854","23992","23862",
"명지1동","총인구","2020.10 월","18217","49155","24637","24518",
"명지1동","총인구","2020.11 월","18444","49810","24968","24842",
"명지1동","총인구","2020.12 월","18820","50617","25361","25256",
"명지1동","총인구","2021.01 월","19094","51157","25637","25520",
"명지1동","총인구","2021.02 월","19257","51331","25711","25620",
"명지1동","총인구","2021.03 월","19325","51489","25821","25668",
"명지1동","총인구","2021.04 월","19546","51725","25942","25783",
"명지1동","총인구","2021.05 월","19756","52026","26116","25910",
"명지1동","총인구","2021.06 월","19900","52222","26220","26002",
"명지1동","총인구","2021.07 월","20037","52399","26313","26086",
"명지1동","총인구","2021.08 월","20171","52645","26456","26189",
"명지1동","총인구","2021.09 월","20314","52915","26601","26314",
"명지1동","총인구","2021.10 월","20451","53119","26725","26394",
"명지1동","총인구","2021.11 월","20548","53244","26797","26447",
"명지1동","총인구","2021.12 월","20640","53402","26858","26544",
"명지1동","총인구","2022.01 월","20828","53647","26965","26682",
"명지1동","총인구","2022.02 월","20989","53802","27018","26784",
"명지1동","총인구","2022.03 월","21032","53890","27042","26848",
"명지1동","총인구","2022.04 월","21084","53980","27087","26893",
"명지1동","총인구","2022.05 월","21149","54076","27119","26957",
"명지1동","총인구","2022.06 월","21193","54163","27148","27015",
"명지1동","총인구","2022.07 월","21203","54153","27146","27007",
"명지1동","총인구","2022.08 월","21188","54101","27143","26958",
"명지1동","총인구","2022.09 월","21140","54020","27123","26897",
"명지1동","총인구","2022.10 월","21113","53991","27122","26869",
"명지1동","총인구","2022.11 월","21062","53929","27071","26858",
"명지1동","총인구","2022.12 월","21085","54011","27118","26893",
"명지1동","총인구","2023.01 월","21099","54037","27134","26903",
"명지1동","총인구","2023.02 월","21151","54127","27180","26947",
"명지1동","총인구","2023.03 월","21215","54266","27206","27060",
"명지1동","총인구","2023.04 월","21252","54322","27226","27096",
"명지1동","총인구","2023.05 월","21317","54505","27343","27162",
"명지1동","총인구","2023.06 월","21348","54599","27400","27199",
"명지1동","총인구","2023.07 월","21408","54702","27463","27239",
"명지1동","총인구","2023.08 월","21464","54785","27502","27283",
"명지1동","총인구","2023.09 월","21476","54820","27512","27308",
"명지1동","총인구","2023.10 월","21478","54808","27491","27317",
"명지1동","총인구","2023.11 월","21469","54868","27526","27342",
"명지1동","총인구","2023.12 월","21452","54856","27543","27313",
"명지1동","총인구","2024.01 월","21443","54890","27587","27303",
"명지1동","총인구","2024.02 월","21470","54902","27585","27317",
"명지1동","총인구","2024.03 월","21483","54968","27622","27346",
"명지1동","총인구","2024.04 월","21453","54866","27599","27267",
"명지1동","총인구","2024.05 월","21449","54891","27604","27287",
"명지1동","총인구","2024.06 월","21477","54931","27612","27319",
"명지1동","총인구","2024.07 월","21498","54939","27627","27312",
"명지1동","총인구","2024.08 월","21496","54917","27611","27306",
"명지1동","총인구","2024.09 월","21503","54916","27619","27297",
"명지1동","총인구","2024.10 월","21472","54893","27625","27268",
"명지1동","총인구","2024.11 월","21413","54779","27579","27200",
"명지1동","총인구","2024.12 월","21409","54876","27619","27257",
"명지2동","총인구","2020.01 월","9982","30787","15270","15517",
"명지2동","총인구","2020.02 월","10004","30762","15253","15509",
"명지2동","총인구","2020.03 월","10033","30833","15292","15541",
"명지2동","총인구","2020.04 월","10079","30951","15359","15592",
"명지2동","총인구","2020.05 월","10095","30916","15358","15558",
"명지2동","총인구","2020.06 월","10135","30966","15385","15581",
"명지2동","총인구","2020.07 월","10152","30972","15382","15590",
"명지2동","총인구","2020.08 월","10153","30875","15338","15537",
"명지2동","총인구","2020.09 월","10110","30684","15231","15453",
"명지2동","총인구","2020.10 월","10118","30587","15192","15395",
"명지2동","총인구","2020.11 월","10127","30581","15187","15394",
"명지2동","총인구","2020.12 월","10134","30554","15183","15371",
"명지2동","총인구","2021.01 월","10132","30495","15181","15314",
"명지2동","총인구","2021.02 월","10150","30479","15186","15293",
"명지2동","총인구","2021.03 월","10175","30484","15182","15302",
"명지2동","총인구","2021.04 월","10167","30443","15174","15269",
"명지2동","총인구","2021.05 월","10190","30476","15185","15291",
"명지2동","총인구","2021.06 월","10228","30517","15208","15309",
"명지2동","총인구","2021.07 월","10236","30513","15206","15307",
"명지2동","총인구","2021.08 월","10248","30544","15224","15320",
"명지2동","총인구","2021.09 월","10264","30539","15218","15321",
"명지2동","총인구","2021.10 월","10299","30572","15234","15338",
"명지2동","총인구","2021.11 월","10316","30564","15221","15343",
"명지2동","총인구","2021.12 월","10307","30573","15229","15344",
"명지2동","총인구","2022.01 월","10287","30516","15219","15297",
"명지2동","총인구","2022.02 월","10315","30512","15211","15301",
"명지2동","총인구","2022.03 월","10331","30530","15199","15331",
"명지2동","총인구","2022.04 월","10331","30538","15205","15333",
"명지2동","총인구","2022.05 월","10360","30551","15225","15326",
"명지2동","총인구","2022.06 월","10370","30505","15202","15303",
"명지2동","총인구","2022.07 월","10374","30517","15204","15313",
"명지2동","총인구","2022.08 월","10372","30502","15202","15300",
"명지2동","총인구","2022.09 월","10379","30490","15201","15289",
"명지2동","총인구","2022.10 월","10371","30440","15188","15252",
"명지2동","총인구","2022.11 월","10366","30405","15171","15234",
"명지2동","총인구","2022.12 월","10377","30381","15146","15235",
"명지2동","총인구","2023.01 월","10391","30387","15150","15237",
"명지2동","총인구","2023.02 월","10384","30322","15127","15195",
"명지2동","총인구","2023.03 월","10362","30296","15103","15193",
"명지2동","총인구","2023.04 월","10375","30291","15088","15203",
"명지2동","총인구","2023.05 월","10383","30306","15092","15214",
"명지2동","총인구","2023.06 월","10406","30314","15090","15224",
"명지2동","총인구","2023.07 월","10413","30285","15058","15227",
"명지2동","총인구","2023.08 월","10447","30278","15077","15201",
"명지2동","총인구","2023.09 월","10456","30315","15100","15215",
"명지2동","총인구","2023.10 월","10441","30317","15107","15210",
"명지2동","총인구","2023.11 월","10444","30332","15126","15206",
"명지2동","총인구","2023.12 월","10436","30324","15128","15196",
"명지2동","총인구","2024.01 월","10439","30329","15124","15205",
"명지2동","총인구","2024.02 월","10452","30270","15106","15164",
"명지2동","총인구","2024.03 월","10445","30202","15068","15134",
"명지2동","총인구","2024.04 월","10445","30182","15048","15134",
"명지2동","총인구","2024.05 월","10446","30174","15045","15129",
"명지2동","총인구","2024.06 월","10451","30180","15048","15132",
"명지2동","총인구","2024.07 월","10469","30165","15040","15125",
"명지2동","총인구","2024.08 월","10462","30107","15018","15089",
"명지2동","총인구","2024.09 월","10464","30121","15037","15084",
"명지2동","총인구","2024.10 월","10466","30086","15014","15072",
"명지2동","총인구","2024.11 월","10470","30080","15008","15072",
"명지2동","총인구","2024.12 월","10482","30100","15018","15082",
"가락동","총인구","2020.01 월","1401","2639","1419","1220",
"가락동","총인구","2020.02 월","1402","2636","1416","1220",
"가락동","총인구","2020.03 월","1398","2626","1416","1210",
"가락동","총인구","2020.04 월","1402","2617","1410","1207",
"가락동","총인구","2020.05 월","1404","2609","1410","1199",
"가락동","총인구","2020.06 월","1404","2599","1409","1190",
"가락동","총인구","2020.07 월","1405","2592","1400","1192",
"가락동","총인구","2020.08 월","1404","2581","1396","1185",
"가락동","총인구","2020.09 월","1403","2578","1400","1178",
"가락동","총인구","2020.10 월","1405","2572","1397","1175",
"가락동","총인구","2020.11 월","1406","2568","1396","1172",
"가락동","총인구","2020.12 월","1405","2560","1391","1169",
"가락동","총인구","2021.01 월","1398","2536","1377","1159",
"가락동","총인구","2021.02 월","1385","2517","1364","1153",
"가락동","총인구","2021.03 월","1370","2487","1344","1143",
"가락동","총인구","2021.04 월","1366","2476","1338","1138",
"가락동","총인구","2021.05 월","1360","2470","1335","1135",
"가락동","총인구","2021.06 월","1357","2452","1326","1126",
"가락동","총인구","2021.07 월","1354","2454","1328","1126",
"가락동","총인구","2021.08 월","1358","2457","1325","1132",
"가락동","총인구","2021.09 월","1352","2444","1322","1122",
"가락동","총인구","2021.10 월","1354","2442","1322","1120",
"가락동","총인구","2021.11 월","1355","2432","1320","1112",
"가락동","총인구","2021.12 월","1353","2424","1317","1107",
"가락동","총인구","2022.01 월","1353","2422","1318","1104",
"가락동","총인구","2022.02 월","1347","2420","1322","1098",
"가락동","총인구","2022.03 월","1343","2408","1319","1089",
"가락동","총인구","2022.04 월","1341","2398","1312","1086",
"가락동","총인구","2022.05 월","1349","2398","1310","1088",
"가락동","총인구","2022.06 월","1350","2394","1307","1087",
"가락동","총인구","2022.07 월","1354","2402","1308","1094",
"가락동","총인구","2022.08 월","1344","2378","1296","1082",
"가락동","총인구","2022.09 월","1330","2364","1292","1072",
"가락동","총인구","2022.10 월","1324","2350","1280","1070",
"가락동","총인구","2022.11 월","1314","2342","1277","1065",
"가락동","총인구","2022.12 월","1307","2329","1276","1053",
"가락동","총인구","2023.01 월","1308","2333","1279","1054",
"가락동","총인구","2023.02 월","1308","2341","1282","1059",
"가락동","총인구","2023.03 월","1305","2326","1271","1055",
"가락동","총인구","2023.04 월","1308","2326","1278","1048",
"가락동","총인구","2023.05 월","1297","2305","1272","1033",
"가락동","총인구","2023.06 월","1289","2289","1265","1024",
"가락동","총인구","2023.07 월","1277","2271","1255","1016",
"가락동","총인구","2023.08 월","1276","2272","1256","1016",
"가락동","총인구","2023.09 월","1276","2269","1257","1012",
"가락동","총인구","2023.10 월","1270","2256","1248","1008",
"가락동","총인구","2023.11 월","1265","2256","1251","1005",
"가락동","총인구","2023.12 월","1269","2266","1258","1008",
"가락동","총인구","2024.01 월","1267","2267","1256","1011",
"가락동","총인구","2024.02 월","1260","2253","1249","1004",
"가락동","총인구","2024.03 월","1260","2250","1247","1003",
"가락동","총인구","2024.04 월","1258","2240","1239","1001",
"가락동","총인구","2024.05 월","1251","2224","1227","997",
"가락동","총인구","2024.06 월","1250","2218","1226","992",
"가락동","총인구","2024.07 월","1255","2213","1225","988",
"가락동","총인구","2024.08 월","1250","2208","1219","989",
"가락동","총인구","2024.09 월","1247","2202","1221","981",
"가락동","총인구","2024.10 월","1247","2205","1216","989",
"가락동","총인구","2024.11 월","1245","2194","1206","988",
"가락동","총인구","2024.12 월","1245","2176","1200","976",
"녹산동","총인구","2020.01 월","14451","36012","20854","15158",
"녹산동","총인구","2020.02 월","14627","36262","20958","15304",
"녹산동","총인구","2020.03 월","14818","36450","21019","15431",
"녹산동","총인구","2020.04 월","14871","36460","21020","15440",
"녹산동","총인구","2020.05 월","15072","36788","21168","15620",
"녹산동","총인구","2020.06 월","15156","36898","21211","15687",
"녹산동","총인구","2020.07 월","15241","36979","21241","15738",
"녹산동","총인구","2020.08 월","15243","36811","21135","15676",
"녹산동","총인구","2020.09 월","15250","36625","21034","15591",
"녹산동","총인구","2020.10 월","15262","36531","20961","15570",
"녹산동","총인구","2020.11 월","15314","36483","20906","15577",
"녹산동","총인구","2020.12 월","15343","36395","20831","15564",
"녹산동","총인구","2021.01 월","15451","36596","20946","15650",
"녹산동","총인구","2021.02 월","15610","36844","21064","15780",
"녹산동","총인구","2021.03 월","15777","37118","21199","15919",
"녹산동","총인구","2021.04 월","15913","37365","21318","16047",
"녹산동","총인구","2021.05 월","16010","37512","21368","16144",
"녹산동","총인구","2021.06 월","16145","37791","21522","16269",
"녹산동","총인구","2021.07 월","16282","38013","21641","16372",
"녹산동","총인구","2021.08 월","16414","38227","21761","16466",
"녹산동","총인구","2021.09 월","16543","38448","21875","16573",
"녹산동","총인구","2021.10 월","16647","38571","21937","16634",
"녹산동","총인구","2021.11 월","16733","38747","22030","16717",
"녹산동","총인구","2021.12 월","16742","38719","22028","16691",
"녹산동","총인구","2022.01 월","16748","38706","21988","16718",
"녹산동","총인구","2022.02 월","16778","38729","22007","16722",
"녹산동","총인구","2022.03 월","16921","38897","22083","16814",
"녹산동","총인구","2022.04 월","17019","39058","22196","16862",
"녹산동","총인구","2022.05 월","17150","39253","22330","16923",
"녹산동","총인구","2022.06 월","17217","39351","22407","16944",
"녹산동","총인구","2022.07 월","17279","39422","22435","16987",
"녹산동","총인구","2022.08 월","17328","39466","22475","16991",
"녹산동","총인구","2022.09 월","17343","39512","22537","16975",
"녹산동","총인구","2022.10 월","17354","39567","22586","16981",
"녹산동","총인구","2022.11 월","17308","39641","22709","16932",
"녹산동","총인구","2022.12 월","17240","39751","22881","16870",
"녹산동","총인구","2023.01 월","17188","39747","22913","16834",
"녹산동","총인구","2023.02 월","17149","39604","22856","16748",
"녹산동","총인구","2023.03 월","17131","39624","22918","16706",
"녹산동","총인구","2023.04 월","17147","39708","23029","16679",
"녹산동","총인구","2023.05 월","17148","39785","23131","16654",
"녹산동","총인구","2023.06 월","17146","39822","23173","16649",
"녹산동","총인구","2023.07 월","17112","39894","23261","16633",
"녹산동","총인구","2023.08 월","17088","39897","23303","16594",
"녹산동","총인구","2023.09 월","17075","39915","23315","16600",
"녹산동","총인구","2023.10 월","17082","39919","23354","16565",
"녹산동","총인구","2023.11 월","17021","39943","23391","16552",
"녹산동","총인구","2023.12 월","16957","39834","23349","16485",
"녹산동","총인구","2024.01 월","16895","39822","23461","16361",
"녹산동","총인구","2024.02 월","16812","39648","23389","16259",
"녹산동","총인구","2024.03 월","16792","39615","23394","16221",
"녹산동","총인구","2024.04 월","16750","39566","23363","16203",
"녹산동","총인구","2024.05 월","16767","39597","23392","16205",
"녹산동","총인구","2024.06 월","16762","39549","23379","16170",
"녹산동","총인구","2024.07 월","16722","39523","23387","16136",
"녹산동","총인구","2024.08 월","16718","39523","23406","16117",
"녹산동","총인구","2024.09 월","16694","39487","23393","16094",
"녹산동","총인구","2024.10 월","16667","39496","23401","16095",
"녹산동","총인구","2024.11 월","16626","39502","23442","16060",
"녹산동","총인구","2024.12 월","16613","39481","23433","16048",
"가덕도동","총인구","2020.01 월","2148","3596","1902","1694",
"가덕도동","총인구","2020.02 월","2157","3572","1892","1680",
"가덕도동","총인구","2020.03 월","2159","3572","1883","1689",
"가덕도동","총인구","2020.04 월","2153","3563","1873","1690",
"가덕도동","총인구","2020.05 월","2173","3569","1871","1698",
"가덕도동","총인구","2020.06 월","2194","3590","1886","1704",
"가덕도동","총인구","2020.07 월","2212","3625","1906","1719",
"가덕도동","총인구","2020.08 월","2228","3646","1919","1727",
"가덕도동","총인구","2020.09 월","2233","3650","1919","1731",
"가덕도동","총인구","2020.10 월","2230","3624","1901","1723",
"가덕도동","총인구","2020.11 월","2266","3690","1932","1758",
"가덕도동","총인구","2020.12 월","2296","3733","1952","1781",
"가덕도동","총인구","2021.01 월","2310","3744","1949","1795",
"가덕도동","총인구","2021.02 월","2362","3801","1983","1818",
"가덕도동","총인구","2021.03 월","2372","3846","2017","1829",
"가덕도동","총인구","2021.04 월","2385","3853","2012","1841",
"가덕도동","총인구","2021.05 월","2397","3873","2023","1850",
"가덕도동","총인구","2021.06 월","2416","3904","2045","1859",
"가덕도동","총인구","2021.07 월","2435","3933","2060","1873",
"가덕도동","총인구","2021.08 월","2428","3918","2053","1865",
"가덕도동","총인구","2021.09 월","2437","3922","2063","1859",
"가덕도동","총인구","2021.10 월","2448","3938","2066","1872",
"가덕도동","총인구","2021.11 월","2467","3968","2078","1890",
"가덕도동","총인구","2021.12 월","2467","3975","2085","1890",
"가덕도동","총인구","2022.01 월","2481","4009","2105","1904",
"가덕도동","총인구","2022.02 월","2488","4026","2112","1914",
"가덕도동","총인구","2022.03 월","2511","4045","2126","1919",
"가덕도동","총인구","2022.04 월","2525","4060","2137","1923",
"가덕도동","총인구","2022.05 월","2534","4089","2155","1934",
"가덕도동","총인구","2022.06 월","2558","4118","2173","1945",
"가덕도동","총인구","2022.07 월","2565","4118","2175","1943",
"가덕도동","총인구","2022.08 월","2567","4126","2179","1947",
"가덕도동","총인구","2022.09 월","2563","4120","2176","1944",
"가덕도동","총인구","2022.10 월","2571","4121","2175","1946",
"가덕도동","총인구","2022.11 월","2597","4151","2195","1956",
"가덕도동","총인구","2022.12 월","2610","4161","2204","1957",
"가덕도동","총인구","2023.01 월","2615","4165","2208","1957",
"가덕도동","총인구","2023.02 월","2610","4184","2216","1968",
"가덕도동","총인구","2023.03 월","2625","4207","2222","1985",
"가덕도동","총인구","2023.04 월","2629","4232","2233","1999",
"가덕도동","총인구","2023.05 월","2629","4238","2237","2001",
"가덕도동","총인구","2023.06 월","2635","4270","2252","2018",
"가덕도동","총인구","2023.07 월","2648","4293","2265","2028",
"가덕도동","총인구","2023.08 월","2648","4295","2271","2024",
"가덕도동","총인구","2023.09 월","2669","4328","2289","2039",
"가덕도동","총인구","2023.10 월","2667","4343","2302","2041",
"가덕도동","총인구","2023.11 월","2663","4346","2306","2040",
"가덕도동","총인구","2023.12 월","2670","4356","2313","2043",
"가덕도동","총인구","2024.01 월","2675","4349","2307","2042",
"가덕도동","총인구","2024.02 월","2673","4343","2304","2039",
"가덕도동","총인구","2024.03 월","2675","4334","2301","2033",
"가덕도동","총인구","2024.04 월","2663","4327","2292","2035",
"가덕도동","총인구","2024.05 월","2662","4328","2291","2037",
"가덕도동","총인구","2024.06 월","2663","4325","2293","2032",
"가덕도동","총인구","2024.07 월","2665","4329","2300","2029",
"가덕도동","총인구","2024.08 월","2660","4321","2293","2028",
"가덕도동","총인구","2024.09 월","2667","4335","2299","2036",
"가덕도동","총인구","2024.10 월","2660","4340","2301","2039",
"가덕도동","총인구","2024.11 월","2668","4351","2308","2043",
"가덕도동","총인구","2024.12 월","2673","4347","2310","2037",
"연제구","총인구","2020.01 월","90601","211026","101888","109138",
"연제구","총인구","2020.02 월","90948","211562","102142","109420",
"연제구","총인구","2020.03 월","91106","211385","101999","109386",
"연제구","총인구","2020.04 월","91122","211136","101828","109308",
"연제구","총인구","2020.05 월","91287","210893","101643","109250",
"연제구","총인구","2020.06 월","91412","210515","101437","109078",
"연제구","총인구","2020.07 월","91608","210336","101353","108983",
"연제구","총인구","2020.08 월","92154","211128","101701","109427",
"연제구","총인구","2020.09 월","92418","211344","101768","109576",
"연제구","총인구","2020.10 월","92475","211174","101674","109500",
"연제구","총인구","2020.11 월","92535","210666","101381","109285",
"연제구","총인구","2020.12 월","92583","210128","101055","109073",
"연제구","총인구","2021.01 월","92694","209856","100913","108943",
"연제구","총인구","2021.02 월","92851","209692","100802","108890",
"연제구","총인구","2021.03 월","92104","208352","100297","108055",
"연제구","총인구","2021.04 월","92091","207912","100048","107864",
"연제구","총인구","2021.05 월","92100","207472","99817","107655",
"연제구","총인구","2021.06 월","92165","207173","99637","107536",
"연제구","총인구","2021.07 월","92192","206864","99444","107420",
"연제구","총인구","2021.08 월","92236","206624","99365","107259",
"연제구","총인구","2021.09 월","92451","206585","99349","107236",
"연제구","총인구","2021.10 월","92572","206511","99339","107172",
"연제구","총인구","2021.11 월","92850","206649","99389","107260",
"연제구","총인구","2021.12 월","93606","208050","100107","107943",
"연제구","총인구","2022.01 월","93890","208255","100213","108042",
"연제구","총인구","2022.02 월","94026","208090","100065","108025",
"연제구","총인구","2022.03 월","94091","207847","99905","107942",
"연제구","총인구","2022.04 월","94123","207592","99716","107876",
"연제구","총인구","2022.05 월","94182","207425","99622","107803",
"연제구","총인구","2022.06 월","94167","207060","99451","107609",
"연제구","총인구","2022.07 월","94147","206812","99295","107517",
"연제구","총인구","2022.08 월","94136","206433","99077","107356",
"연제구","총인구","2022.09 월","93840","205804","98703","107101",
"연제구","총인구","2022.10 월","93706","205309","98432","106877",
"연제구","총인구","2022.11 월","93581","204819","98167","106652",
"연제구","총인구","2022.12 월","93557","204504","97988","106516",
"연제구","총인구","2023.01 월","93490","204173","97821","106352",
"연제구","총인구","2023.02 월","93538","204025","97696","106329",
"연제구","총인구","2023.03 월","93650","204094","97715","106379",
"연제구","총인구","2023.04 월","93724","204073","97695","106378",
"연제구","총인구","2023.05 월","93852","204023","97637","106386",
"연제구","총인구","2023.06 월","93904","203939","97559","106380",
"연제구","총인구","2023.07 월","94064","204051","97566","106485",
"연제구","총인구","2023.08 월","94093","203961","97500","106461",
"연제구","총인구","2023.09 월","94338","203937","97480","106457",
"연제구","총인구","2023.10 월","94650","204073","97501","106572",
"연제구","총인구","2023.11 월","94760","204087","97442","106645",
"연제구","총인구","2023.12 월","95873","206853","98788","108065",
"연제구","총인구","2024.01 월","97257","210412","100471","109941",
"연제구","총인구","2024.02 월","97985","212085","101288","110797",
"연제구","총인구","2024.03 월","98268","212532","101465","111067",
"연제구","총인구","2024.04 월","98521","212962","101634","111328",
"연제구","총인구","2024.05 월","98715","213162","101696","111466",
"연제구","총인구","2024.06 월","98837","213212","101674","111538",
"연제구","총인구","2024.07 월","98999","213334","101698","111636",
"연제구","총인구","2024.08 월","99136","213352","101699","111653",
"연제구","총인구","2024.09 월","99274","213546","101808","111738",
"연제구","총인구","2024.10 월","99326","213536","101795","111741",
"연제구","총인구","2024.11 월","99440","213622","101897","111725",
"연제구","총인구","2024.12 월","99568","213732","101972","111760",
"거제1동","총인구","2020.01 월","11398","30634","14874","15760",
"거제1동","총인구","2020.02 월","11381","30594","14843","15751",
"거제1동","총인구","2020.03 월","11379","30459","14785","15674",
"거제1동","총인구","2020.04 월","11379","30375","14704","15671",
"거제1동","총인구","2020.05 월","11380","30270","14662","15608",
"거제1동","총인구","2020.06 월","11402","30238","14653","15585",
"거제1동","총인구","2020.07 월","11408","30177","14617","15560",
"거제1동","총인구","2020.08 월","11415","30102","14576","15526",
"거제1동","총인구","2020.09 월","11410","30037","14525","15512",
"거제1동","총인구","2020.10 월","11407","29988","14515","15473",
"거제1동","총인구","2020.11 월","11387","29875","14461","15414",
"거제1동","총인구","2020.12 월","11358","29772","14386","15386",
"거제1동","총인구","2021.01 월","11354","29727","14366","15361",
"거제1동","총인구","2021.02 월","11356","29699","14357","15342",
"거제1동","총인구","2021.03 월","11307","29622","14320","15302",
"거제1동","총인구","2021.04 월","11329","29590","14284","15306",
"거제1동","총인구","2021.05 월","11330","29505","14258","15247",
"거제1동","총인구","2021.06 월","11348","29493","14252","15241",
"거제1동","총인구","2021.07 월","11361","29471","14239","15232",
"거제1동","총인구","2021.08 월","11373","29446","14246","15200",
"거제1동","총인구","2021.09 월","11383","29423","14236","15187",
"거제1동","총인구","2021.10 월","11395","29384","14215","15169",
"거제1동","총인구","2021.11 월","11424","29405","14204","15201",
"거제1동","총인구","2021.12 월","11391","29302","14152","15150",
"거제1동","총인구","2022.01 월","11364","29154","14072","15082",
"거제1동","총인구","2022.02 월","11330","28985","13983","15002",
"거제1동","총인구","2022.03 월","11357","28966","13967","14999",
"거제1동","총인구","2022.04 월","11333","28887","13922","14965",
"거제1동","총인구","2022.05 월","11321","28798","13883","14915",
"거제1동","총인구","2022.06 월","11307","28731","13847","14884",
"거제1동","총인구","2022.07 월","11307","28703","13834","14869",
"거제1동","총인구","2022.08 월","11307","28677","13815","14862",
"거제1동","총인구","2022.09 월","11283","28624","13796","14828",
"거제1동","총인구","2022.10 월","11267","28600","13773","14827",
"거제1동","총인구","2022.11 월","11249","28542","13736","14806",
"거제1동","총인구","2022.12 월","11257","28538","13722","14816",
"거제1동","총인구","2023.01 월","11264","28496","13694","14802",
"거제1동","총인구","2023.02 월","11248","28371","13636","14735",
"거제1동","총인구","2023.03 월","11246","28338","13627","14711",
"거제1동","총인구","2023.04 월","11252","28357","13629","14728",
"거제1동","총인구","2023.05 월","11251","28309","13604","14705",
"거제1동","총인구","2023.06 월","11258","28279","13598","14681",
"거제1동","총인구","2023.07 월","11283","28300","13596","14704",
"거제1동","총인구","2023.08 월","11298","28328","13614","14714",
"거제1동","총인구","2023.09 월","11301","28296","13600","14696",
"거제1동","총인구","2023.10 월","11295","28296","13609","14687",
"거제1동","총인구","2023.11 월","11285","28268","13593","14675",
"거제1동","총인구","2023.12 월","11259","28139","13526","14613",
"거제1동","총인구","2024.01 월","11211","27947","13433","14514",
"거제1동","총인구","2024.02 월","11199","27831","13368","14463",
"거제1동","총인구","2024.03 월","11196","27772","13345","14427",
"거제1동","총인구","2024.04 월","11205","27778","13333","14445",
"거제1동","총인구","2024.05 월","11221","27767","13319","14448",
"거제1동","총인구","2024.06 월","11257","27814","13332","14482",
"거제1동","총인구","2024.07 월","11324","27943","13392","14551",
"거제1동","총인구","2024.08 월","11360","27966","13397","14569",
"거제1동","총인구","2024.09 월","11380","27974","13404","14570",
"거제1동","총인구","2024.10 월","11366","27915","13358","14557",
"거제1동","총인구","2024.11 월","11356","27876","13355","14521",
"거제1동","총인구","2024.12 월","11348","27854","13354","14500",
"거제2동","총인구","2020.01 월","4605","12849","6190","6659",
"거제2동","총인구","2020.02 월","4624","12914","6209","6705",
"거제2동","총인구","2020.03 월","4630","12842","6151","6691",
"거제2동","총인구","2020.04 월","4643","12830","6148","6682",
"거제2동","총인구","2020.05 월","4638","12805","6133","6672",
"거제2동","총인구","2020.06 월","4640","12744","6089","6655",
"거제2동","총인구","2020.07 월","4651","12719","6084","6635",
"거제2동","총인구","2020.08 월","4651","12667","6045","6622",
"거제2동","총인구","2020.09 월","4661","12669","6057","6612",
"거제2동","총인구","2020.10 월","4662","12665","6045","6620",
"거제2동","총인구","2020.11 월","4682","12688","6061","6627",
"거제2동","총인구","2020.12 월","4676","12623","6025","6598",
"거제2동","총인구","2021.01 월","4673","12600","6018","6582",
"거제2동","총인구","2021.02 월","4689","12642","6032","6610",
"거제2동","총인구","2021.03 월","4586","12498","5968","6530",
"거제2동","총인구","2021.04 월","4591","12491","5968","6523",
"거제2동","총인구","2021.05 월","4590","12463","5958","6505",
"거제2동","총인구","2021.06 월","4579","12430","5941","6489",
"거제2동","총인구","2021.07 월","4577","12402","5926","6476",
"거제2동","총인구","2021.08 월","4579","12374","5906","6468",
"거제2동","총인구","2021.09 월","4571","12345","5887","6458",
"거제2동","총인구","2021.10 월","4575","12333","5877","6456",
"거제2동","총인구","2021.11 월","4575","12290","5854","6436",
"거제2동","총인구","2021.12 월","4562","12267","5829","6438",
"거제2동","총인구","2022.01 월","4554","12209","5798","6411",
"거제2동","총인구","2022.02 월","4539","12182","5785","6397",
"거제2동","총인구","2022.03 월","4522","12128","5761","6367",
"거제2동","총인구","2022.04 월","4522","12107","5751","6356",
"거제2동","총인구","2022.05 월","4505","12058","5731","6327",
"거제2동","총인구","2022.06 월","4489","12017","5710","6307",
"거제2동","총인구","2022.07 월","4477","11986","5692","6294",
"거제2동","총인구","2022.08 월","4464","11934","5671","6263",
"거제2동","총인구","2022.09 월","4433","11853","5630","6223",
"거제2동","총인구","2022.10 월","4424","11822","5604","6218",
"거제2동","총인구","2022.11 월","4399","11785","5575","6210",
"거제2동","총인구","2022.12 월","4392","11795","5580","6215",
"거제2동","총인구","2023.01 월","4388","11790","5586","6204",
"거제2동","총인구","2023.02 월","4533","12122","5733","6389",
"거제2동","총인구","2023.03 월","4661","12415","5871","6544",
"거제2동","총인구","2023.04 월","4723","12564","5937","6627",
"거제2동","총인구","2023.05 월","4746","12622","5959","6663",
"거제2동","총인구","2023.06 월","4757","12666","5979","6687",
"거제2동","총인구","2023.07 월","4780","12722","6006","6716",
"거제2동","총인구","2023.08 월","4773","12709","6000","6709",
"거제2동","총인구","2023.09 월","4757","12675","5982","6693",
"거제2동","총인구","2023.10 월","4751","12693","5995","6698",
"거제2동","총인구","2023.11 월","4794","12819","6060","6759",
"거제2동","총인구","2023.12 월","5918","16062","7638","8424",
"거제2동","총인구","2024.01 월","7369","20389","9743","10646",
"거제2동","총인구","2024.02 월","8117","22622","10831","11791",
"거제2동","총인구","2024.03 월","8343","23235","11139","12096",
"거제2동","총인구","2024.04 월","8511","23709","11372","12337",
"거제2동","총인구","2024.05 월","8633","23998","11490","12508",
"거제2동","총인구","2024.06 월","8731","24222","11594","12628",
"거제2동","총인구","2024.07 월","8828","24404","11689","12715",
"거제2동","총인구","2024.08 월","8910","24572","11769","12803",
"거제2동","총인구","2024.09 월","8966","24658","11789","12869",
"거제2동","총인구","2024.10 월","8996","24720","11822","12898",
"거제2동","총인구","2024.11 월","9024","24890","11902","12988",
"거제2동","총인구","2024.12 월","9047","24940","11922","13018",
"거제3동","총인구","2020.01 월","4720","10627","5025","5602",
"거제3동","총인구","2020.02 월","4718","10596","5008","5588",
"거제3동","총인구","2020.03 월","4718","10587","5003","5584",
"거제3동","총인구","2020.04 월","4716","10592","5004","5588",
"거제3동","총인구","2020.05 월","4721","10595","4996","5599",
"거제3동","총인구","2020.06 월","4727","10570","4987","5583",
"거제3동","총인구","2020.07 월","4738","10550","4982","5568",
"거제3동","총인구","2020.08 월","4711","10447","4936","5511",
"거제3동","총인구","2020.09 월","4703","10388","4906","5482",
"거제3동","총인구","2020.10 월","4693","10337","4881","5456",
"거제3동","총인구","2020.11 월","4686","10255","4836","5419",
"거제3동","총인구","2020.12 월","4720","10256","4854","5402",
"거제3동","총인구","2021.01 월","4730","10233","4838","5395",
"거제3동","총인구","2021.02 월","4731","10213","4825","5388",
"거제3동","총인구","2021.03 월","4672","10127","4797","5330",
"거제3동","총인구","2021.04 월","4666","10105","4781","5324",
"거제3동","총인구","2021.05 월","4681","10121","4783","5338",
"거제3동","총인구","2021.06 월","4686","10114","4779","5335",
"거제3동","총인구","2021.07 월","4696","10100","4779","5321",
"거제3동","총인구","2021.08 월","4684","10061","4752","5309",
"거제3동","총인구","2021.09 월","4713","10115","4782","5333",
"거제3동","총인구","2021.10 월","4710","10082","4764","5318",
"거제3동","총인구","2021.11 월","4701","10060","4767","5293",
"거제3동","총인구","2021.12 월","4706","10028","4752","5276",
"거제3동","총인구","2022.01 월","4703","9986","4726","5260",
"거제3동","총인구","2022.02 월","4709","9960","4721","5239",
"거제3동","총인구","2022.03 월","4697","9939","4700","5239",
"거제3동","총인구","2022.04 월","4692","9900","4679","5221",
"거제3동","총인구","2022.05 월","4703","9890","4672","5218",
"거제3동","총인구","2022.06 월","4701","9865","4663","5202",
"거제3동","총인구","2022.07 월","4709","9883","4675","5208",
"거제3동","총인구","2022.08 월","4702","9855","4662","5193",
"거제3동","총인구","2022.09 월","4684","9830","4648","5182",
"거제3동","총인구","2022.10 월","4678","9819","4636","5183",
"거제3동","총인구","2022.11 월","4643","9744","4607","5137",
"거제3동","총인구","2022.12 월","4639","9724","4594","5130",
"거제3동","총인구","2023.01 월","4629","9683","4572","5111",
"거제3동","총인구","2023.02 월","4624","9676","4570","5106",
"거제3동","총인구","2023.03 월","4615","9653","4555","5098",
"거제3동","총인구","2023.04 월","4632","9662","4560","5102",
"거제3동","총인구","2023.05 월","4638","9662","4560","5102",
"거제3동","총인구","2023.06 월","4620","9613","4534","5079",
"거제3동","총인구","2023.07 월","4620","9584","4513","5071",
"거제3동","총인구","2023.08 월","4615","9576","4510","5066",
"거제3동","총인구","2023.09 월","4614","9567","4507","5060",
"거제3동","총인구","2023.10 월","4609","9544","4498","5046",
"거제3동","총인구","2023.11 월","4620","9517","4475","5042",
"거제3동","총인구","2023.12 월","4604","9462","4443","5019",
"거제3동","총인구","2024.01 월","4590","9415","4404","5011",
"거제3동","총인구","2024.02 월","4590","9386","4399","4987",
"거제3동","총인구","2024.03 월","4582","9343","4368","4975",
"거제3동","총인구","2024.04 월","4579","9335","4362","4973",
"거제3동","총인구","2024.05 월","4605","9359","4367","4992",
"거제3동","총인구","2024.06 월","4607","9347","4368","4979",
"거제3동","총인구","2024.07 월","4618","9348","4366","4982",
"거제3동","총인구","2024.08 월","4623","9321","4348","4973",
"거제3동","총인구","2024.09 월","4621","9308","4343","4965",
"거제3동","총인구","2024.10 월","4615","9299","4341","4958",
"거제3동","총인구","2024.11 월","4631","9306","4353","4953",
"거제3동","총인구","2024.12 월","4641","9302","4352","4950",
"거제4동","총인구","2020.01 월","4244","11117","5450","5667",
"거제4동","총인구","2020.02 월","4231","11087","5452","5635",
"거제4동","총인구","2020.03 월","4221","11044","5431","5613",
"거제4동","총인구","2020.04 월","4199","10989","5401","5588",
"거제4동","총인구","2020.05 월","4202","10956","5389","5567",
"거제4동","총인구","2020.06 월","4199","10936","5371","5565",
"거제4동","총인구","2020.07 월","4207","10905","5349","5556",
"거제4동","총인구","2020.08 월","4204","10882","5331","5551",
"거제4동","총인구","2020.09 월","4213","10856","5324","5532",
"거제4동","총인구","2020.10 월","4209","10831","5309","5522",
"거제4동","총인구","2020.11 월","4210","10811","5307","5504",
"거제4동","총인구","2020.12 월","4216","10805","5301","5504",
"거제4동","총인구","2021.01 월","4224","10802","5296","5506",
"거제4동","총인구","2021.02 월","4227","10793","5295","5498",
"거제4동","총인구","2021.03 월","4180","10705","5271","5434",
"거제4동","총인구","2021.04 월","4176","10676","5257","5419",
"거제4동","총인구","2021.05 월","4177","10658","5238","5420",
"거제4동","총인구","2021.06 월","4167","10621","5222","5399",
"거제4동","총인구","2021.07 월","4167","10594","5195","5399",
"거제4동","총인구","2021.08 월","4171","10552","5175","5377",
"거제4동","총인구","2021.09 월","4171","10536","5164","5372",
"거제4동","총인구","2021.10 월","4166","10515","5152","5363",
"거제4동","총인구","2021.11 월","4171","10496","5138","5358",
"거제4동","총인구","2021.12 월","4166","10462","5129","5333",
"거제4동","총인구","2022.01 월","4156","10428","5109","5319",
"거제4동","총인구","2022.02 월","4147","10401","5096","5305",
"거제4동","총인구","2022.03 월","4137","10338","5061","5277",
"거제4동","총인구","2022.04 월","4131","10315","5047","5268",
"거제4동","총인구","2022.05 월","4134","10282","5029","5253",
"거제4동","총인구","2022.06 월","4128","10250","5016","5234",
"거제4동","총인구","2022.07 월","4116","10210","4999","5211",
"거제4동","총인구","2022.08 월","4114","10184","4972","5212",
"거제4동","총인구","2022.09 월","4091","10140","4938","5202",
"거제4동","총인구","2022.10 월","4085","10116","4927","5189",
"거제4동","총인구","2022.11 월","4073","10071","4910","5161",
"거제4동","총인구","2022.12 월","4064","10024","4887","5137",
"거제4동","총인구","2023.01 월","4065","10016","4883","5133",
"거제4동","총인구","2023.02 월","4060","9992","4877","5115",
"거제4동","총인구","2023.03 월","4052","9947","4854","5093",
"거제4동","총인구","2023.04 월","4039","9908","4838","5070",
"거제4동","총인구","2023.05 월","4037","9879","4824","5055",
"거제4동","총인구","2023.06 월","4035","9858","4810","5048",
"거제4동","총인구","2023.07 월","4032","9842","4801","5041",
"거제4동","총인구","2023.08 월","4031","9821","4783","5038",
"거제4동","총인구","2023.09 월","4024","9782","4764","5018",
"거제4동","총인구","2023.10 월","4025","9767","4750","5017",
"거제4동","총인구","2023.11 월","4024","9761","4747","5014",
"거제4동","총인구","2023.12 월","4026","9722","4734","4988",
"거제4동","총인구","2024.01 월","4007","9651","4700","4951",
"거제4동","총인구","2024.02 월","4001","9582","4661","4921",
"거제4동","총인구","2024.03 월","4004","9559","4649","4910",
"거제4동","총인구","2024.04 월","4010","9556","4648","4908",
"거제4동","총인구","2024.05 월","4023","9559","4656","4903",
"거제4동","총인구","2024.06 월","4023","9538","4642","4896",
"거제4동","총인구","2024.07 월","4027","9517","4618","4899",
"거제4동","총인구","2024.08 월","4021","9489","4602","4887",
"거제4동","총인구","2024.09 월","4026","9481","4587","4894",
"거제4동","총인구","2024.10 월","4028","9468","4585","4883",
"거제4동","총인구","2024.11 월","4028","9463","4580","4883",
"거제4동","총인구","2024.12 월","4037","9462","4582","4880",
"연산1동","총인구","2020.01 월","6953","17049","8318","8731",
"연산1동","총인구","2020.02 월","6963","17006","8300","8706",
"연산1동","총인구","2020.03 월","6950","16952","8270","8682",
"연산1동","총인구","2020.04 월","6951","16919","8260","8659",
"연산1동","총인구","2020.05 월","6944","16869","8251","8618",
"연산1동","총인구","2020.06 월","6937","16815","8215","8600",
"연산1동","총인구","2020.07 월","6951","16823","8216","8607",
"연산1동","총인구","2020.08 월","6920","16720","8168","8552",
"연산1동","총인구","2020.09 월","6904","16648","8125","8523",
"연산1동","총인구","2020.10 월","6904","16623","8100","8523",
"연산1동","총인구","2020.11 월","6909","16584","8079","8505",
"연산1동","총인구","2020.12 월","6906","16528","8053","8475",
"연산1동","총인구","2021.01 월","6921","16517","8053","8464",
"연산1동","총인구","2021.02 월","6930","16494","8047","8447",
"연산1동","총인구","2021.03 월","6845","16375","8006","8369",
"연산1동","총인구","2021.04 월","6844","16343","7994","8349",
"연산1동","총인구","2021.05 월","6836","16287","7962","8325",
"연산1동","총인구","2021.06 월","6851","16273","7948","8325",
"연산1동","총인구","2021.07 월","6851","16249","7921","8328",
"연산1동","총인구","2021.08 월","6849","16234","7912","8322",
"연산1동","총인구","2021.09 월","6861","16214","7886","8328",
"연산1동","총인구","2021.10 월","6947","16389","7985","8404",
"연산1동","총인구","2021.11 월","7096","16719","8157","8562",
"연산1동","총인구","2021.12 월","7161","16853","8218","8635",
"연산1동","총인구","2022.01 월","7169","16795","8198","8597",
"연산1동","총인구","2022.02 월","7222","16864","8225","8639",
"연산1동","총인구","2022.03 월","7239","16876","8237","8639",
"연산1동","총인구","2022.04 월","7238","16875","8217","8658",
"연산1동","총인구","2022.05 월","7235","16847","8205","8642",
"연산1동","총인구","2022.06 월","7209","16789","8175","8614",
"연산1동","총인구","2022.07 월","7204","16759","8158","8601",
"연산1동","총인구","2022.08 월","7186","16690","8121","8569",
"연산1동","총인구","2022.09 월","7197","16687","8118","8569",
"연산1동","총인구","2022.10 월","7195","16682","8124","8558",
"연산1동","총인구","2022.11 월","7185","16621","8111","8510",
"연산1동","총인구","2022.12 월","7174","16573","8083","8490",
"연산1동","총인구","2023.01 월","7161","16558","8074","8484",
"연산1동","총인구","2023.02 월","7162","16528","8055","8473",
"연산1동","총인구","2023.03 월","7164","16534","8068","8466",
"연산1동","총인구","2023.04 월","7146","16467","8024","8443",
"연산1동","총인구","2023.05 월","7122","16420","7989","8431",
"연산1동","총인구","2023.06 월","7110","16405","7984","8421",
"연산1동","총인구","2023.07 월","7119","16408","7981","8427",
"연산1동","총인구","2023.08 월","7111","16376","7959","8417",
"연산1동","총인구","2023.09 월","7104","16330","7941","8389",
"연산1동","총인구","2023.10 월","7114","16343","7960","8383",
"연산1동","총인구","2023.11 월","7090","16280","7925","8355",
"연산1동","총인구","2023.12 월","7080","16226","7909","8317",
"연산1동","총인구","2024.01 월","7070","16159","7866","8293",
"연산1동","총인구","2024.02 월","7071","16135","7849","8286",
"연산1동","총인구","2024.03 월","7076","16140","7849","8291",
"연산1동","총인구","2024.04 월","7059","16088","7823","8265",
"연산1동","총인구","2024.05 월","7071","16076","7807","8269",
"연산1동","총인구","2024.06 월","7053","16039","7777","8262",
"연산1동","총인구","2024.07 월","7028","15994","7757","8237",
"연산1동","총인구","2024.08 월","7031","15984","7756","8228",
"연산1동","총인구","2024.09 월","7023","15976","7748","8228",
"연산1동","총인구","2024.10 월","7010","15919","7709","8210",
"연산1동","총인구","2024.11 월","7001","15873","7686","8187",
"연산1동","총인구","2024.12 월","6972","15797","7652","8145",
"연산2동","총인구","2020.01 월","7615","17205","8262","8943",
"연산2동","총인구","2020.02 월","7892","17927","8608","9319",
"연산2동","총인구","2020.03 월","7982","18142","8691","9451",
"연산2동","총인구","2020.04 월","8033","18235","8745","9490",
"연산2동","총인구","2020.05 월","8062","18292","8758","9534",
"연산2동","총인구","2020.06 월","8076","18272","8733","9539",
"연산2동","총인구","2020.07 월","8152","18453","8831","9622",
"연산2동","총인구","2020.08 월","8782","20121","9653","10468",
"연산2동","총인구","2020.09 월","9041","20772","9961","10811",
"연산2동","총인구","2020.10 월","9112","20932","10032","10900",
"연산2동","총인구","2020.11 월","9152","20969","10046","10923",
"연산2동","총인구","2020.12 월","9191","21015","10061","10954",
"연산2동","총인구","2021.01 월","9222","21022","10090","10932",
"연산2동","총인구","2021.02 월","9239","21065","10080","10985",
"연산2동","총인구","2021.03 월","9242","21031","10094","10937",
"연산2동","총인구","2021.04 월","9228","21006","10063","10943",
"연산2동","총인구","2021.05 월","9264","21048","10091","10957",
"연산2동","총인구","2021.06 월","9278","21041","10073","10968",
"연산2동","총인구","2021.07 월","9284","21050","10087","10963",
"연산2동","총인구","2021.08 월","9268","20992","10071","10921",
"연산2동","총인구","2021.09 월","9281","21006","10091","10915",
"연산2동","총인구","2021.10 월","9279","20997","10082","10915",
"연산2동","총인구","2021.11 월","9261","20950","10055","10895",
"연산2동","총인구","2021.12 월","9195","20749","9969","10780",
"연산2동","총인구","2022.01 월","9124","20549","9884","10665",
"연산2동","총인구","2022.02 월","9071","20417","9813","10604",
"연산2동","총인구","2022.03 월","9052","20358","9765","10593",
"연산2동","총인구","2022.04 월","9044","20315","9728","10587",
"연산2동","총인구","2022.05 월","9052","20302","9714","10588",
"연산2동","총인구","2022.06 월","9064","20268","9705","10563",
"연산2동","총인구","2022.07 월","9072","20263","9697","10566",
"연산2동","총인구","2022.08 월","9069","20212","9658","10554",
"연산2동","총인구","2022.09 월","8992","20089","9602","10487",
"연산2동","총인구","2022.10 월","8991","20029","9565","10464",
"연산2동","총인구","2022.11 월","9045","20057","9570","10487",
"연산2동","총인구","2022.12 월","9054","20026","9537","10489",
"연산2동","총인구","2023.01 월","9056","20026","9544","10482",
"연산2동","총인구","2023.02 월","9074","20093","9577","10516",
"연산2동","총인구","2023.03 월","9062","20060","9545","10515",
"연산2동","총인구","2023.04 월","9087","20083","9560","10523",
"연산2동","총인구","2023.05 월","9107","20098","9567","10531",
"연산2동","총인구","2023.06 월","9131","20176","9610","10566",
"연산2동","총인구","2023.07 월","9220","20372","9695","10677",
"연산2동","총인구","2023.08 월","9308","20564","9782","10782",
"연산2동","총인구","2023.09 월","9677","20980","9968","11012",
"연산2동","총인구","2023.10 월","10122","21514","10179","11335",
"연산2동","총인구","2023.11 월","10267","21707","10251","11456",
"연산2동","총인구","2023.12 월","10394","21835","10300","11535",
"연산2동","총인구","2024.01 월","10430","21832","10297","11535",
"연산2동","총인구","2024.02 월","10454","21851","10302","11549",
"연산2동","총인구","2024.03 월","10483","21865","10294","11571",
"연산2동","총인구","2024.04 월","10508","21879","10304","11575",
"연산2동","총인구","2024.05 월","10509","21890","10292","11598",
"연산2동","총인구","2024.06 월","10526","21889","10294","11595",
"연산2동","총인구","2024.07 월","10553","21945","10303","11642",
"연산2동","총인구","2024.08 월","10566","21935","10286","11649",
"연산2동","총인구","2024.09 월","10568","21933","10282","11651",
"연산2동","총인구","2024.10 월","10539","21857","10255","11602",
"연산2동","총인구","2024.11 월","10546","21838","10252","11586",
"연산2동","총인구","2024.12 월","10548","21834","10255","11579",
"연산3동","총인구","2020.01 월","3823","7888","3756","4132",
"연산3동","총인구","2020.02 월","3817","7849","3738","4111",
"연산3동","총인구","2020.03 월","3813","7826","3730","4096",
"연산3동","총인구","2020.04 월","3806","7801","3726","4075",
"연산3동","총인구","2020.05 월","3804","7773","3697","4076",
"연산3동","총인구","2020.06 월","3808","7776","3698","4078",
"연산3동","총인구","2020.07 월","3793","7698","3657","4041",
"연산3동","총인구","2020.08 월","3794","7650","3636","4014",
"연산3동","총인구","2020.09 월","3777","7595","3608","3987",
"연산3동","총인구","2020.10 월","3771","7560","3587","3973",
"연산3동","총인구","2020.11 월","3764","7517","3564","3953",
"연산3동","총인구","2020.12 월","3753","7471","3548","3923",
"연산3동","총인구","2021.01 월","3766","7465","3552","3913",
"연산3동","총인구","2021.02 월","3770","7452","3546","3906",
"연산3동","총인구","2021.03 월","3737","7417","3535","3882",
"연산3동","총인구","2021.04 월","3738","7384","3529","3855",
"연산3동","총인구","2021.05 월","3731","7343","3503","3840",
"연산3동","총인구","2021.06 월","3719","7298","3485","3813",
"연산3동","총인구","2021.07 월","3719","7273","3469","3804",
"연산3동","총인구","2021.08 월","3719","7269","3467","3802",
"연산3동","총인구","2021.09 월","3734","7269","3470","3799",
"연산3동","총인구","2021.10 월","3723","7227","3455","3772",
"연산3동","총인구","2021.11 월","3768","7297","3493","3804",
"연산3동","총인구","2021.12 월","4552","9214","4463","4751",
"연산3동","총인구","2022.01 월","4967","10260","4971","5289",
"연산3동","총인구","2022.02 월","5118","10634","5155","5479",
"연산3동","총인구","2022.03 월","5185","10785","5234","5551",
"연산3동","총인구","2022.04 월","5229","10854","5265","5589",
"연산3동","총인구","2022.05 월","5267","10944","5292","5652",
"연산3동","총인구","2022.06 월","5291","11004","5325","5679",
"연산3동","총인구","2022.07 월","5294","11020","5324","5696",
"연산3동","총인구","2022.08 월","5303","11024","5324","5700",
"연산3동","총인구","2022.09 월","5287","11005","5318","5687",
"연산3동","총인구","2022.10 월","5277","10988","5306","5682",
"연산3동","총인구","2022.11 월","5270","10992","5298","5694",
"연산3동","총인구","2022.12 월","5267","10979","5292","5687",
"연산3동","총인구","2023.01 월","5263","10956","5277","5679",
"연산3동","총인구","2023.02 월","5243","10908","5248","5660",
"연산3동","총인구","2023.03 월","5243","10938","5269","5669",
"연산3동","총인구","2023.04 월","5229","10904","5249","5655",
"연산3동","총인구","2023.05 월","5221","10889","5244","5645",
"연산3동","총인구","2023.06 월","5221","10880","5235","5645",
"연산3동","총인구","2023.07 월","5203","10853","5214","5639",
"연산3동","총인구","2023.08 월","5184","10827","5191","5636",
"연산3동","총인구","2023.09 월","5176","10793","5175","5618",
"연산3동","총인구","2023.10 월","5155","10736","5150","5586",
"연산3동","총인구","2023.11 월","5146","10716","5141","5575",
"연산3동","총인구","2023.12 월","5108","10607","5085","5522",
"연산3동","총인구","2024.01 월","5095","10547","5065","5482",
"연산3동","총인구","2024.02 월","5058","10477","5030","5447",
"연산3동","총인구","2024.03 월","5039","10411","4991","5420",
"연산3동","총인구","2024.04 월","5051","10442","4995","5447",
"연산3동","총인구","2024.05 월","5046","10444","4992","5452",
"연산3동","총인구","2024.06 월","5044","10421","4979","5442",
"연산3동","총인구","2024.07 월","5034","10402","4965","5437",
"연산3동","총인구","2024.08 월","5034","10385","4953","5432",
"연산3동","총인구","2024.09 월","5020","10352","4943","5409",
"연산3동","총인구","2024.10 월","5007","10320","4929","5391",
"연산3동","총인구","2024.11 월","5004","10315","4931","5384",
"연산3동","총인구","2024.12 월","5014","10324","4934","5390",
"연산4동","총인구","2020.01 월","8659","17329","8333","8996",
"연산4동","총인구","2020.02 월","8677","17353","8365","8988",
"연산4동","총인구","2020.03 월","8716","17360","8350","9010",
"연산4동","총인구","2020.04 월","8672","17277","8299","8978",
"연산4동","총인구","2020.05 월","8689","17236","8258","8978",
"연산4동","총인구","2020.06 월","8686","17166","8245","8921",
"연산4동","총인구","2020.07 월","8724","17150","8230","8920",
"연산4동","총인구","2020.08 월","8699","17042","8180","8862",
"연산4동","총인구","2020.09 월","8734","17077","8190","8887",
"연산4동","총인구","2020.10 월","8745","17108","8204","8904",
"연산4동","총인구","2020.11 월","8738","17016","8164","8852",
"연산4동","총인구","2020.12 월","8721","16934","8105","8829",
"연산4동","총인구","2021.01 월","8717","16876","8055","8821",
"연산4동","총인구","2021.02 월","8746","16857","8059","8798",
"연산4동","총인구","2021.03 월","8652","16693","8002","8691",
"연산4동","총인구","2021.04 월","8617","16603","7948","8655",
"연산4동","총인구","2021.05 월","8564","16479","7879","8600",
"연산4동","총인구","2021.06 월","8570","16443","7853","8590",
"연산4동","총인구","2021.07 월","8555","16366","7815","8551",
"연산4동","총인구","2021.08 월","8573","16392","7840","8552",
"연산4동","총인구","2021.09 월","8611","16380","7843","8537",
"연산4동","총인구","2021.10 월","8603","16361","7853","8508",
"연산4동","총인구","2021.11 월","8598","16294","7833","8461",
"연산4동","총인구","2021.12 월","8595","16264","7836","8428",
"연산4동","총인구","2022.01 월","8574","16193","7821","8372",
"연산4동","총인구","2022.02 월","8561","16143","7786","8357",
"연산4동","총인구","2022.03 월","8570","16078","7740","8338",
"연산4동","총인구","2022.04 월","8567","16063","7733","8330",
"연산4동","총인구","2022.05 월","8598","16091","7745","8346",
"연산4동","총인구","2022.06 월","8610","16078","7721","8357",
"연산4동","총인구","2022.07 월","8626","16057","7714","8343",
"연산4동","총인구","2022.08 월","8634","16062","7722","8340",
"연산4동","총인구","2022.09 월","8613","16006","7677","8329",
"연산4동","총인구","2022.10 월","8594","15958","7652","8306",
"연산4동","총인구","2022.11 월","8599","15939","7644","8295",
"연산4동","총인구","2022.12 월","8626","15954","7642","8312",
"연산4동","총인구","2023.01 월","8624","15933","7618","8315",
"연산4동","총인구","2023.02 월","8604","15891","7597","8294",
"연산4동","총인구","2023.03 월","8611","15876","7589","8287",
"연산4동","총인구","2023.04 월","8618","15859","7587","8272",
"연산4동","총인구","2023.05 월","8607","15820","7553","8267",
"연산4동","총인구","2023.06 월","8615","15800","7554","8246",
"연산4동","총인구","2023.07 월","8607","15757","7525","8232",
"연산4동","총인구","2023.08 월","8590","15691","7483","8208",
"연산4동","총인구","2023.09 월","8586","15649","7470","8179",
"연산4동","총인구","2023.10 월","8575","15648","7485","8163",
"연산4동","총인구","2023.11 월","8594","15650","7480","8170",
"연산4동","총인구","2023.12 월","8589","15618","7460","8158",
"연산4동","총인구","2024.01 월","8601","15588","7435","8153",
"연산4동","총인구","2024.02 월","8629","15584","7430","8154",
"연산4동","총인구","2024.03 월","8644","15595","7428","8167",
"연산4동","총인구","2024.04 월","8642","15584","7424","8160",
"연산4동","총인구","2024.05 월","8655","15593","7428","8165",
"연산4동","총인구","2024.06 월","8648","15557","7407","8150",
"연산4동","총인구","2024.07 월","8652","15571","7419","8152",
"연산4동","총인구","2024.08 월","8666","15564","7420","8144",
"연산4동","총인구","2024.09 월","8767","15800","7540","8260",
"연산4동","총인구","2024.10 월","8901","16145","7706","8439",
"연산4동","총인구","2024.11 월","9001","16357","7814","8543",
"연산4동","총인구","2024.12 월","9066","16498","7882","8616",
"연산5동","총인구","2020.01 월","9545","16469","7872","8597",
"연산5동","총인구","2020.02 월","9624","16541","7887","8654",
"연산5동","총인구","2020.03 월","9645","16572","7891","8681",
"연산5동","총인구","2020.04 월","9662","16596","7891","8705",
"연산5동","총인구","2020.05 월","9765","16685","7928","8757",
"연산5동","총인구","2020.06 월","9812","16690","7935","8755",
"연산5동","총인구","2020.07 월","9827","16683","7938","8745",
"연산5동","총인구","2020.08 월","9853","16637","7911","8726",
"연산5동","총인구","2020.09 월","9856","16638","7914","8724",
"연산5동","총인구","2020.10 월","9870","16676","7933","8743",
"연산5동","총인구","2020.11 월","9893","16670","7913","8757",
"연산5동","총인구","2020.12 월","9901","16679","7928","8751",
"연산5동","총인구","2021.01 월","9917","16664","7934","8730",
"연산5동","총인구","2021.02 월","9960","16651","7917","8734",
"연산5동","총인구","2021.03 월","9940","16644","7912","8732",
"연산5동","총인구","2021.04 월","9932","16563","7887","8676",
"연산5동","총인구","2021.05 월","9925","16569","7893","8676",
"연산5동","총인구","2021.06 월","9938","16565","7888","8677",
"연산5동","총인구","2021.07 월","9951","16571","7886","8685",
"연산5동","총인구","2021.08 월","9969","16564","7903","8661",
"연산5동","총인구","2021.09 월","10021","16613","7949","8664",
"연산5동","총인구","2021.10 월","10100","16688","7983","8705",
"연산5동","총인구","2021.11 월","10169","16741","7986","8755",
"연산5동","총인구","2021.12 월","10204","16717","7979","8738",
"연산5동","총인구","2022.01 월","10225","16711","7960","8751",
"연산5동","총인구","2022.02 월","10263","16699","7928","8771",
"연산5동","총인구","2022.03 월","10274","16695","7921","8774",
"연산5동","총인구","2022.04 월","10287","16702","7941","8761",
"연산5동","총인구","2022.05 월","10282","16700","7945","8755",
"연산5동","총인구","2022.06 월","10315","16721","7970","8751",
"연산5동","총인구","2022.07 월","10314","16692","7945","8747",
"연산5동","총인구","2022.08 월","10322","16651","7914","8737",
"연산5동","총인구","2022.09 월","10318","16643","7896","8747",
"연산5동","총인구","2022.10 월","10319","16587","7869","8718",
"연산5동","총인구","2022.11 월","10277","16523","7834","8689",
"연산5동","총인구","2022.12 월","10260","16474","7825","8649",
"연산5동","총인구","2023.01 월","10266","16470","7828","8642",
"연산5동","총인구","2023.02 월","10285","16483","7802","8681",
"연산5동","총인구","2023.03 월","10325","16523","7822","8701",
"연산5동","총인구","2023.04 월","10341","16548","7826","8722",
"연산5동","총인구","2023.05 월","10494","16723","7912","8811",
"연산5동","총인구","2023.06 월","10567","16835","7928","8907",
"연산5동","총인구","2023.07 월","10610","16880","7958","8922",
"연산5동","총인구","2023.08 월","10619","16897","7972","8925",
"연산5동","총인구","2023.09 월","10604","16874","7959","8915",
"연산5동","총인구","2023.10 월","10600","16864","7926","8938",
"연산5동","총인구","2023.11 월","10591","16859","7919","8940",
"연산5동","총인구","2023.12 월","10612","16872","7930","8942",
"연산5동","총인구","2024.01 월","10655","16890","7952","8938",
"연산5동","총인구","2024.02 월","10684","16878","7955","8923",
"연산5동","총인구","2024.03 월","10720","16934","7973","8961",
"연산5동","총인구","2024.04 월","10806","17025","8020","9005",
"연산5동","총인구","2024.05 월","10799","16996","8026","8970",
"연산5동","총인구","2024.06 월","10811","17001","8029","8972",
"연산5동","총인구","2024.07 월","10811","16977","8034","8943",
"연산5동","총인구","2024.08 월","10831","16979","8046","8933",
"연산5동","총인구","2024.09 월","10838","16975","8067","8908",
"연산5동","총인구","2024.10 월","10853","16980","8079","8901",
"연산5동","총인구","2024.11 월","10855","16970","8079","8891",
"연산5동","총인구","2024.12 월","10876","16979","8076","8903",
"연산6동","총인구","2020.01 월","8272","17783","8633","9150",
"연산6동","총인구","2020.02 월","8251","17740","8627","9113",
"연산6동","총인구","2020.03 월","8254","17724","8614","9110",
"연산6동","총인구","2020.04 월","8232","17659","8569","9090",
"연산6동","총인구","2020.05 월","8237","17641","8548","9093",
"연산6동","총인구","2020.06 월","8248","17611","8531","9080",
"연산6동","총인구","2020.07 월","8254","17592","8521","9071",
"연산6동","총인구","2020.08 월","8245","17508","8478","9030",
"연산6동","총인구","2020.09 월","8232","17448","8434","9014",
"연산6동","총인구","2020.10 월","8216","17346","8385","8961",
"연산6동","총인구","2020.11 월","8219","17302","8355","8947",
"연산6동","총인구","2020.12 월","8205","17200","8297","8903",
"연산6동","총인구","2021.01 월","8213","17181","8280","8901",
"연산6동","총인구","2021.02 월","8222","17128","8259","8869",
"연산6동","총인구","2021.03 월","8057","16898","8155","8743",
"연산6동","총인구","2021.04 월","8061","16879","8145","8734",
"연산6동","총인구","2021.05 월","8070","16865","8145","8720",
"연산6동","총인구","2021.06 월","8081","16841","8136","8705",
"연산6동","총인구","2021.07 월","8088","16831","8115","8716",
"연산6동","총인구","2021.08 월","8091","16826","8112","8714",
"연산6동","총인구","2021.09 월","8133","16853","8122","8731",
"연산6동","총인구","2021.10 월","8144","16822","8103","8719",
"연산6동","총인구","2021.11 월","8168","16854","8112","8742",
"연산6동","총인구","2021.12 월","8166","16801","8085","8716",
"연산6동","총인구","2022.01 월","8158","16736","8049","8687",
"연산6동","총인구","2022.02 월","8154","16690","8022","8668",
"연산6동","총인구","2022.03 월","8189","16699","8027","8672",
"연산6동","총인구","2022.04 월","8212","16693","8002","8691",
"연산6동","총인구","2022.05 월","8218","16689","8006","8683",
"연산6동","총인구","2022.06 월","8211","16643","7984","8659",
"연산6동","총인구","2022.07 월","8192","16596","7951","8645",
"연산6동","총인구","2022.08 월","8198","16577","7950","8627",
"연산6동","총인구","2022.09 월","8192","16549","7927","8622",
"연산6동","총인구","2022.10 월","8167","16479","7888","8591",
"연산6동","총인구","2022.11 월","8159","16418","7862","8556",
"연산6동","총인구","2022.12 월","8167","16410","7846","8564",
"연산6동","총인구","2023.01 월","8168","16380","7838","8542",
"연산6동","총인구","2023.02 월","8139","16310","7810","8500",
"연산6동","총인구","2023.03 월","8131","16277","7786","8491",
"연산6동","총인구","2023.04 월","8121","16257","7774","8483",
"연산6동","총인구","2023.05 월","8120","16232","7761","8471",
"연산6동","총인구","2023.06 월","8103","16170","7725","8445",
"연산6동","총인구","2023.07 월","8083","16114","7698","8416",
"연산6동","총인구","2023.08 월","8076","16097","7691","8406",
"연산6동","총인구","2023.09 월","8020","15995","7639","8356",
"연산6동","총인구","2023.10 월","7995","15880","7577","8303",
"연산6동","총인구","2023.11 월","7957","15824","7555","8269",
"연산6동","총인구","2023.12 월","7924","15730","7498","8232",
"연산6동","총인구","2024.01 월","7906","15680","7455","8225",
"연산6동","총인구","2024.02 월","7891","15623","7437","8186",
"연산6동","총인구","2024.03 월","7884","15602","7414","8188",
"연산6동","총인구","2024.04 월","7873","15588","7408","8180",
"연산6동","총인구","2024.05 월","7873","15588","7414","8174",
"연산6동","총인구","2024.06 월","7881","15564","7398","8166",
"연산6동","총인구","2024.07 월","7871","15515","7370","8145",
"연산6동","총인구","2024.08 월","7854","15512","7367","8145",
"연산6동","총인구","2024.09 월","7842","15475","7348","8127",
"연산6동","총인구","2024.10 월","7834","15470","7345","8125",
"연산6동","총인구","2024.11 월","7832","15441","7331","8110",
"연산6동","총인구","2024.12 월","7847","15474","7340","8134",
"연산8동","총인구","2020.01 월","6229","15019","7368","7651",
"연산8동","총인구","2020.02 월","6223","14986","7353","7633",
"연산8동","총인구","2020.03 월","6219","14945","7331","7614",
"연산8동","총인구","2020.04 월","6218","14913","7317","7596",
"연산8동","총인구","2020.05 월","6227","14877","7293","7584",
"연산8동","총인구","2020.06 월","6242","14872","7292","7580",
"연산8동","총인구","2020.07 월","6237","14818","7265","7553",
"연산8동","총인구","2020.08 월","6237","14758","7221","7537",
"연산8동","총인구","2020.09 월","6217","14694","7196","7498",
"연산8동","총인구","2020.10 월","6216","14639","7172","7467",
"연산8동","총인구","2020.11 월","6218","14597","7144","7453",
"연산8동","총인구","2020.12 월","6220","14549","7110","7439",
"연산8동","총인구","2021.01 월","6216","14496","7075","7421",
"연산8동","총인구","2021.02 월","6231","14498","7073","7425",
"연산8동","총인구","2021.03 월","6225","14421","7049","7372",
"연산8동","총인구","2021.04 월","6236","14407","7036","7371",
"연산8동","총인구","2021.05 월","6238","14383","7019","7364",
"연산8동","총인구","2021.06 월","6249","14378","7009","7369",
"연산8동","총인구","2021.07 월","6237","14342","7008","7334",
"연산8동","총인구","2021.08 월","6246","14332","6987","7345",
"연산8동","총인구","2021.09 월","6254","14319","6968","7351",
"연산8동","총인구","2021.10 월","6209","14272","6949","7323",
"연산8동","총인구","2021.11 월","6195","14208","6909","7299",
"연산8동","총인구","2021.12 월","6212","14201","6904","7297",
"연산8동","총인구","2022.01 월","6198","14108","6860","7248",
"연산8동","총인구","2022.02 월","6209","14070","6849","7221",
"연산8동","총인구","2022.03 월","6194","14008","6823","7185",
"연산8동","총인구","2022.04 월","6180","13963","6800","7163",
"연산8동","총인구","2022.05 월","6191","13976","6806","7170",
"연산8동","총인구","2022.06 월","6186","13951","6803","7148",
"연산8동","총인구","2022.07 월","6174","13913","6785","7128",
"연산8동","총인구","2022.08 월","6183","13924","6782","7142",
"연산8동","총인구","2022.09 월","6141","13866","6750","7116",
"연산8동","총인구","2022.10 월","6127","13830","6741","7089",
"연산8동","총인구","2022.11 월","6118","13813","6734","7079",
"연산8동","총인구","2022.12 월","6106","13776","6728","7048",
"연산8동","총인구","2023.01 월","6103","13745","6702","7043",
"연산8동","총인구","2023.02 월","6103","13732","6690","7042",
"연산8동","총인구","2023.03 월","6095","13692","6663","7029",
"연산8동","총인구","2023.04 월","6082","13674","6656","7018",
"연산8동","총인구","2023.05 월","6077","13644","6641","7003",
"연산8동","총인구","2023.06 월","6076","13612","6623","6989",
"연산8동","총인구","2023.07 월","6096","13614","6618","6996",
"연산8동","총인구","2023.08 월","6099","13604","6623","6981",
"연산8동","총인구","2023.09 월","6094","13569","6608","6961",
"연산8동","총인구","2023.10 월","6072","13517","6576","6941",
"연산8동","총인구","2023.11 월","6070","13505","6564","6941",
"연산8동","총인구","2023.12 월","6066","13480","6548","6932",
"연산8동","총인구","2024.01 월","6063","13425","6521","6904",
"연산8동","총인구","2024.02 월","6049","13379","6502","6877",
"연산8동","총인구","2024.03 월","6055","13379","6510","6869",
"연산8동","총인구","2024.04 월","6032","13332","6478","6854",
"연산8동","총인구","2024.05 월","6023","13297","6462","6835",
"연산8동","총인구","2024.06 월","6025","13309","6470","6839",
"연산8동","총인구","2024.07 월","6025","13301","6466","6835",
"연산8동","총인구","2024.08 월","6016","13262","6454","6808",
"연산8동","총인구","2024.09 월","6008","13231","6438","6793",
"연산8동","총인구","2024.10 월","5998","13199","6414","6785",
"연산8동","총인구","2024.11 월","5992","13161","6400","6761",
"연산8동","총인구","2024.12 월","5992","13139","6395","6744",
"연산9동","총인구","2020.01 월","14538","37057","17807","19250",
"연산9동","총인구","2020.02 월","14547","36969","17752","19217",
"연산9동","총인구","2020.03 월","14579","36932","17752","19180",
"연산9동","총인구","2020.04 월","14611","36950","17764","19186",
"연산9동","총인구","2020.05 월","14618","36894","17730","19164",
"연산9동","총인구","2020.06 월","14635","36825","17688","19137",
"연산9동","총인구","2020.07 월","14666","36768","17663","19105",
"연산9동","총인구","2020.08 월","14643","36594","17566","19028",
"연산9동","총인구","2020.09 월","14670","36522","17528","18994",
"연산9동","총인구","2020.10 월","14670","36469","17511","18958",
"연산9동","총인구","2020.11 월","14677","36382","17451","18931",
"연산9동","총인구","2020.12 월","14716","36296","17387","18909",
"연산9동","총인구","2021.01 월","14741","36273","17356","18917",
"연산9동","총인구","2021.02 월","14750","36200","17312","18888",
"연산9동","총인구","2021.03 월","14661","35921","17188","18733",
"연산9동","총인구","2021.04 월","14673","35865","17156","18709",
"연산9동","총인구","2021.05 월","14694","35751","17088","18663",
"연산9동","총인구","2021.06 월","14699","35676","17051","18625",
"연산9동","총인구","2021.07 월","14706","35615","17004","18611",
"연산9동","총인구","2021.08 월","14714","35582","16994","18588",
"연산9동","총인구","2021.09 월","14718","35512","16951","18561",
"연산9동","총인구","2021.10 월","14721","35441","16921","18520",
"연산9동","총인구","2021.11 월","14724","35335","16881","18454",
"연산9동","총인구","2021.12 월","14696","35192","16791","18401",
"연산9동","총인구","2022.01 월","14698","35126","16765","18361",
"연산9동","총인구","2022.02 월","14703","35045","16702","18343",
"연산9동","총인구","2022.03 월","14675","34977","16669","18308",
"연산9동","총인구","2022.04 월","14688","34918","16631","18287",
"연산9동","총인구","2022.05 월","14676","34848","16594","18254",
"연산9동","총인구","2022.06 월","14656","34743","16532","18211",
"연산9동","총인구","2022.07 월","14662","34730","16521","18209",
"연산9동","총인구","2022.08 월","14654","34643","16486","18157",
"연산9동","총인구","2022.09 월","14609","34512","16403","18109",
"연산9동","총인구","2022.10 월","14582","34399","16347","18052",
"연산9동","총인구","2022.11 월","14564","34314","16286","18028",
"연산9동","총인구","2022.12 월","14551","34231","16252","17979",
"연산9동","총인구","2023.01 월","14503","34120","16205","17915",
"연산9동","총인구","2023.02 월","14463","33919","16101","17818",
"연산9동","총인구","2023.03 월","14445","33841","16066","17775",
"연산9동","총인구","2023.04 월","14454","33790","16055","17735",
"연산9동","총인구","2023.05 월","14432","33725","16023","17702",
"연산9동","총인구","2023.06 월","14411","33645","15979","17666",
"연산9동","총인구","2023.07 월","14411","33605","15961","17644",
"연산9동","총인구","2023.08 월","14389","33471","15892","17579",
"연산9동","총인구","2023.09 월","14381","33427","15867","17560",
"연산9동","총인구","2023.10 월","14337","33271","15796","17475",
"연산9동","총인구","2023.11 월","14322","33181","15732","17449",
"연산9동","총인구","2023.12 월","14293","33100","15717","17383",
"연산9동","총인구","2024.01 월","14260","32889","15600","17289",
"연산9동","총인구","2024.02 월","14242","32737","15524","17213",
"연산9동","총인구","2024.03 월","14242","32697","15505","17192",
"연산9동","총인구","2024.04 월","14245","32646","15467","17179",
"연산9동","총인구","2024.05 월","14257","32595","15443","17152",
"연산9동","총인구","2024.06 월","14231","32511","15384","17127",
"연산9동","총인구","2024.07 월","14228","32417","15319","17098",
"연산9동","총인구","2024.08 월","14224","32383","15301","17082",
"연산9동","총인구","2024.09 월","14215","32383","15319","17064",
"연산9동","총인구","2024.10 월","14179","32244","15252","16992",
"연산9동","총인구","2024.11 월","14170","32132","15214","16918",
"연산9동","총인구","2024.12 월","14180","32129","15228","16901",
"수영구","총인구","2020.01 월","81608","177861","84307","93554",
"수영구","총인구","2020.02 월","82083","178637","84582","94055",
"수영구","총인구","2020.03 월","82334","178715","84577","94138",
"수영구","총인구","2020.04 월","82464","178722","84504","94218",
"수영구","총인구","2020.05 월","82670","178605","84422","94183",
"수영구","총인구","2020.06 월","82989","178702","84448","94254",
"수영구","총인구","2020.07 월","83207","178463","84334","94129",
"수영구","총인구","2020.08 월","83579","178642","84444","94198",
"수영구","총인구","2020.09 월","83906","178975","84598","94377",
"수영구","총인구","2020.10 월","83941","178780","84457","94323",
"수영구","총인구","2020.11 월","84049","178576","84335","94241",
"수영구","총인구","2020.12 월","84311","178589","84332","94257",
"수영구","총인구","2021.01 월","84460","178441","84273","94168",
"수영구","총인구","2021.02 월","84736","178389","84261","94128",
"수영구","총인구","2021.03 월","84569","177833","84027","93806",
"수영구","총인구","2021.04 월","84717","177962","84067","93895",
"수영구","총인구","2021.05 월","84790","177739","83958","93781",
"수영구","총인구","2021.06 월","84948","177568","83819","93749",
"수영구","총인구","2021.07 월","85083","177424","83772","93652",
"수영구","총인구","2021.08 월","85343","177520","83797","93723",
"수영구","총인구","2021.09 월","85573","177537","83785","93752",
"수영구","총인구","2021.10 월","85693","177319","83679","93640",
"수영구","총인구","2021.11 월","85830","177120","83560","93560",
"수영구","총인구","2021.12 월","85896","176812","83375","93437",
"수영구","총인구","2022.01 월","86014","176586","83261","93325",
"수영구","총인구","2022.02 월","86261","176542","83210","93332",
"수영구","총인구","2022.03 월","86445","176361","83049","93312",
"수영구","총인구","2022.04 월","86584","176350","83040","93310",
"수영구","총인구","2022.05 월","86829","176398","83060","93338",
"수영구","총인구","2022.06 월","86992","176490","83094","93396",
"수영구","총인구","2022.07 월","87128","176476","83055","93421",
"수영구","총인구","2022.08 월","87245","176370","82976","93394",
"수영구","총인구","2022.09 월","87065","176074","82810","93264",
"수영구","총인구","2022.10 월","87311","176481","82974","93507",
"수영구","총인구","2022.11 월","87360","176704","83024","93680",
"수영구","총인구","2022.12 월","87361","176615","82951","93664",
"수영구","총인구","2023.01 월","87487","176725","82964","93761",
"수영구","총인구","2023.02 월","87774","176992","83067","93925",
"수영구","총인구","2023.03 월","87985","177230","83140","94090",
"수영구","총인구","2023.04 월","88084","177271","83151","94120",
"수영구","총인구","2023.05 월","88211","177368","83143","94225",
"수영구","총인구","2023.06 월","88315","177435","83207","94228",
"수영구","총인구","2023.07 월","88385","177358","83183","94175",
"수영구","총인구","2023.08 월","88469","177416","83244","94172",
"수영구","총인구","2023.09 월","88357","177145","83123","94022",
"수영구","총인구","2023.10 월","88321","176992","83025","93967",
"수영구","총인구","2023.11 월","88285","176715","82896","93819",
"수영구","총인구","2023.12 월","88299","176486","82787","93699",
"수영구","총인구","2024.01 월","88195","176083","82556","93527",
"수영구","총인구","2024.02 월","88250","175915","82407","93508",
"수영구","총인구","2024.03 월","88285","175730","82314","93416",
"수영구","총인구","2024.04 월","88261","175539","82222","93317",
"수영구","총인구","2024.05 월","88266","175404","82192","93212",
"수영구","총인구","2024.06 월","88261","175259","82084","93175",
"수영구","총인구","2024.07 월","88287","175060","81999","93061",
"수영구","총인구","2024.08 월","88287","174952","81915","93037",
"수영구","총인구","2024.09 월","88281","174824","81791","93033",
"수영구","총인구","2024.10 월","88139","174503","81603","92900",
"수영구","총인구","2024.11 월","88095","174208","81452","92756",
"수영구","총인구","2024.12 월","88068","174124","81393","92731",
"남천1동","총인구","2020.01 월","6226","14352","6633","7719",
"남천1동","총인구","2020.02 월","6241","14358","6627","7731",
"남천1동","총인구","2020.03 월","6240","14329","6616","7713",
"남천1동","총인구","2020.04 월","6230","14311","6608","7703",
"남천1동","총인구","2020.05 월","6217","14276","6586","7690",
"남천1동","총인구","2020.06 월","6221","14266","6560","7706",
"남천1동","총인구","2020.07 월","6241","14231","6555","7676",
"남천1동","총인구","2020.08 월","6248","14208","6535","7673",
"남천1동","총인구","2020.09 월","6240","14201","6530","7671",
"남천1동","총인구","2020.10 월","6236","14174","6515","7659",
"남천1동","총인구","2020.11 월","6253","14191","6513","7678",
"남천1동","총인구","2020.12 월","6269","14186","6520","7666",
"남천1동","총인구","2021.01 월","6282","14199","6536","7663",
"남천1동","총인구","2021.02 월","6337","14234","6543","7691",
"남천1동","총인구","2021.03 월","6314","14156","6506","7650",
"남천1동","총인구","2021.04 월","6313","14146","6500","7646",
"남천1동","총인구","2021.05 월","6308","14100","6484","7616",
"남천1동","총인구","2021.06 월","6308","14061","6456","7605",
"남천1동","총인구","2021.07 월","6295","14036","6468","7568",
"남천1동","총인구","2021.08 월","6320","14037","6461","7576",
"남천1동","총인구","2021.09 월","6326","14025","6444","7581",
"남천1동","총인구","2021.10 월","6327","14008","6446","7562",
"남천1동","총인구","2021.11 월","6332","14011","6444","7567",
"남천1동","총인구","2021.12 월","6326","14009","6440","7569",
"남천1동","총인구","2022.01 월","6371","14028","6448","7580",
"남천1동","총인구","2022.02 월","6401","14035","6457","7578",
"남천1동","총인구","2022.03 월","6432","14018","6446","7572",
"남천1동","총인구","2022.04 월","6432","13994","6429","7565",
"남천1동","총인구","2022.05 월","6461","14026","6436","7590",
"남천1동","총인구","2022.06 월","6465","14012","6427","7585",
"남천1동","총인구","2022.07 월","6476","14022","6425","7597",
"남천1동","총인구","2022.08 월","6485","14025","6424","7601",
"남천1동","총인구","2022.09 월","6466","14015","6430","7585",
"남천1동","총인구","2022.10 월","6778","14910","6860","8050",
"남천1동","총인구","2022.11 월","7000","15507","7123","8384",
"남천1동","총인구","2022.12 월","7049","15706","7222","8484",
"남천1동","총인구","2023.01 월","7111","15869","7307","8562",
"남천1동","총인구","2023.02 월","7142","15932","7332","8600",
"남천1동","총인구","2023.03 월","7170","15984","7340","8644",
"남천1동","총인구","2023.04 월","7204","16043","7349","8694",
"남천1동","총인구","2023.05 월","7259","16130","7383","8747",
"남천1동","총인구","2023.06 월","7257","16119","7374","8745",
"남천1동","총인구","2023.07 월","7257","16119","7359","8760",
"남천1동","총인구","2023.08 월","7296","16206","7415","8791",
"남천1동","총인구","2023.09 월","7279","16197","7409","8788",
"남천1동","총인구","2023.10 월","7313","16274","7436","8838",
"남천1동","총인구","2023.11 월","7308","16249","7414","8835",
"남천1동","총인구","2023.12 월","7356","16321","7436","8885",
"남천1동","총인구","2024.01 월","7377","16411","7480","8931",
"남천1동","총인구","2024.02 월","7458","16619","7579","9040",
"남천1동","총인구","2024.03 월","7506","16713","7640","9073",
"남천1동","총인구","2024.04 월","7521","16742","7646","9096",
"남천1동","총인구","2024.05 월","7555","16803","7684","9119",
"남천1동","총인구","2024.06 월","7585","16865","7722","9143",
"남천1동","총인구","2024.07 월","7593","16861","7735","9126",
"남천1동","총인구","2024.08 월","7591","16849","7713","9136",
"남천1동","총인구","2024.09 월","7605","16865","7723","9142",
"남천1동","총인구","2024.10 월","7586","16866","7712","9154",
"남천1동","총인구","2024.11 월","7601","16876","7734","9142",
"남천1동","총인구","2024.12 월","7609","16906","7741","9165",
"남천2동","총인구","2020.01 월","4887","12605","5888","6717",
"남천2동","총인구","2020.02 월","4899","12641","5901","6740",
"남천2동","총인구","2020.03 월","4909","12609","5884","6725",
"남천2동","총인구","2020.04 월","4907","12598","5864","6734",
"남천2동","총인구","2020.05 월","4912","12588","5841","6747",
"남천2동","총인구","2020.06 월","4930","12596","5850","6746",
"남천2동","총인구","2020.07 월","4927","12535","5826","6709",
"남천2동","총인구","2020.08 월","4923","12501","5820","6681",
"남천2동","총인구","2020.09 월","4919","12492","5825","6667",
"남천2동","총인구","2020.10 월","4915","12460","5800","6660",
"남천2동","총인구","2020.11 월","4920","12479","5807","6672",
"남천2동","총인구","2020.12 월","4932","12490","5808","6682",
"남천2동","총인구","2021.01 월","4949","12508","5827","6681",
"남천2동","총인구","2021.02 월","4957","12473","5809","6664",
"남천2동","총인구","2021.03 월","4934","12429","5784","6645",
"남천2동","총인구","2021.04 월","4939","12436","5781","6655",
"남천2동","총인구","2021.05 월","4938","12400","5772","6628",
"남천2동","총인구","2021.06 월","4944","12391","5775","6616",
"남천2동","총인구","2021.07 월","4930","12347","5746","6601",
"남천2동","총인구","2021.08 월","4925","12304","5722","6582",
"남천2동","총인구","2021.09 월","4929","12326","5750","6576",
"남천2동","총인구","2021.10 월","4926","12255","5728","6527",
"남천2동","총인구","2021.11 월","4923","12216","5717","6499",
"남천2동","총인구","2021.12 월","4929","12228","5729","6499",
"남천2동","총인구","2022.01 월","4909","12189","5707","6482",
"남천2동","총인구","2022.02 월","4928","12226","5736","6490",
"남천2동","총인구","2022.03 월","4925","12164","5701","6463",
"남천2동","총인구","2022.04 월","4918","12135","5688","6447",
"남천2동","총인구","2022.05 월","4906","12119","5669","6450",
"남천2동","총인구","2022.06 월","4912","12122","5663","6459",
"남천2동","총인구","2022.07 월","4911","12106","5652","6454",
"남천2동","총인구","2022.08 월","4904","12080","5629","6451",
"남천2동","총인구","2022.09 월","4863","12050","5624","6426",
"남천2동","총인구","2022.10 월","4846","11974","5585","6389",
"남천2동","총인구","2022.11 월","4826","11905","5540","6365",
"남천2동","총인구","2022.12 월","4820","11874","5521","6353",
"남천2동","총인구","2023.01 월","4834","11899","5512","6387",
"남천2동","총인구","2023.02 월","4999","12276","5691","6585",
"남천2동","총인구","2023.03 월","5188","12670","5888","6782",
"남천2동","총인구","2023.04 월","5272","12873","5983","6890",
"남천2동","총인구","2023.05 월","5346","13042","6063","6979",
"남천2동","총인구","2023.06 월","5416","13235","6167","7068",
"남천2동","총인구","2023.07 월","5468","13370","6231","7139",
"남천2동","총인구","2023.08 월","5535","13493","6300","7193",
"남천2동","총인구","2023.09 월","5559","13540","6322","7218",
"남천2동","총인구","2023.10 월","5567","13563","6333","7230",
"남천2동","총인구","2023.11 월","5570","13605","6349","7256",
"남천2동","총인구","2023.12 월","5583","13651","6370","7281",
"남천2동","총인구","2024.01 월","5577","13660","6381","7279",
"남천2동","총인구","2024.02 월","5593","13668","6382","7286",
"남천2동","총인구","2024.03 월","5583","13607","6353","7254",
"남천2동","총인구","2024.04 월","5595","13621","6346","7275",
"남천2동","총인구","2024.05 월","5611","13612","6337","7275",
"남천2동","총인구","2024.06 월","5612","13591","6327","7264",
"남천2동","총인구","2024.07 월","5614","13582","6323","7259",
"남천2동","총인구","2024.08 월","5623","13586","6328","7258",
"남천2동","총인구","2024.09 월","5638","13642","6360","7282",
"남천2동","총인구","2024.10 월","5637","13632","6352","7280",
"남천2동","총인구","2024.11 월","5647","13622","6346","7276",
"남천2동","총인구","2024.12 월","5634","13586","6336","7250",
"수영동","총인구","2020.01 월","7783","15360","7380","7980",
"수영동","총인구","2020.02 월","7798","15338","7360","7978",
"수영동","총인구","2020.03 월","7785","15333","7360","7973",
"수영동","총인구","2020.04 월","7787","15297","7329","7968",
"수영동","총인구","2020.05 월","7808","15292","7327","7965",
"수영동","총인구","2020.06 월","7821","15264","7313","7951",
"수영동","총인구","2020.07 월","7870","15278","7315","7963",
"수영동","총인구","2020.08 월","7872","15199","7276","7923",
"수영동","총인구","2020.09 월","7874","15190","7275","7915",
"수영동","총인구","2020.10 월","7849","15103","7229","7874",
"수영동","총인구","2020.11 월","7865","15087","7210","7877",
"수영동","총인구","2020.12 월","7872","15076","7218","7858",
"수영동","총인구","2021.01 월","7886","15078","7219","7859",
"수영동","총인구","2021.02 월","7908","15077","7231","7846",
"수영동","총인구","2021.03 월","7864","15004","7197","7807",
"수영동","총인구","2021.04 월","7865","14984","7194","7790",
"수영동","총인구","2021.05 월","7873","14974","7196","7778",
"수영동","총인구","2021.06 월","7867","14956","7177","7779",
"수영동","총인구","2021.07 월","7870","14961","7183","7778",
"수영동","총인구","2021.08 월","7882","14943","7175","7768",
"수영동","총인구","2021.09 월","7899","14938","7160","7778",
"수영동","총인구","2021.10 월","7897","14900","7136","7764",
"수영동","총인구","2021.11 월","7915","14880","7134","7746",
"수영동","총인구","2021.12 월","7896","14800","7089","7711",
"수영동","총인구","2022.01 월","7891","14743","7077","7666",
"수영동","총인구","2022.02 월","7880","14704","7048","7656",
"수영동","총인구","2022.03 월","7869","14686","7028","7658",
"수영동","총인구","2022.04 월","7877","14683","7029","7654",
"수영동","총인구","2022.05 월","7883","14689","7034","7655",
"수영동","총인구","2022.06 월","7877","14675","7028","7647",
"수영동","총인구","2022.07 월","7866","14626","7004","7622",
"수영동","총인구","2022.08 월","7846","14591","6991","7600",
"수영동","총인구","2022.09 월","7838","14593","6978","7615",
"수영동","총인구","2022.10 월","7812","14516","6939","7577",
"수영동","총인구","2022.11 월","7782","14477","6931","7546",
"수영동","총인구","2022.12 월","7768","14429","6898","7531",
"수영동","총인구","2023.01 월","7738","14366","6858","7508",
"수영동","총인구","2023.02 월","7736","14318","6821","7497",
"수영동","총인구","2023.03 월","7740","14301","6818","7483",
"수영동","총인구","2023.04 월","7727","14251","6782","7469",
"수영동","총인구","2023.05 월","7734","14238","6778","7460",
"수영동","총인구","2023.06 월","7761","14231","6770","7461",
"수영동","총인구","2023.07 월","7807","14260","6788","7472",
"수영동","총인구","2023.08 월","7843","14293","6790","7503",
"수영동","총인구","2023.09 월","7839","14247","6767","7480",
"수영동","총인구","2023.10 월","7850","14259","6766","7493",
"수영동","총인구","2023.11 월","7838","14224","6756","7468",
"수영동","총인구","2023.12 월","7839","14180","6740","7440",
"수영동","총인구","2024.01 월","7822","14117","6701","7416",
"수영동","총인구","2024.02 월","7819","14089","6684","7405",
"수영동","총인구","2024.03 월","7819","14077","6688","7389",
"수영동","총인구","2024.04 월","7821","14072","6684","7388",
"수영동","총인구","2024.05 월","7795","14034","6666","7368",
"수영동","총인구","2024.06 월","7803","14025","6658","7367",
"수영동","총인구","2024.07 월","7805","14023","6657","7366",
"수영동","총인구","2024.08 월","7794","14016","6651","7365",
"수영동","총인구","2024.09 월","7767","13981","6630","7351",
"수영동","총인구","2024.10 월","7763","13985","6637","7348",
"수영동","총인구","2024.11 월","7732","13925","6605","7320",
"수영동","총인구","2024.12 월","7727","13897","6592","7305",
"망미1동","총인구","2020.01 월","12168","28611","13770","14841",
"망미1동","총인구","2020.02 월","12165","28597","13748","14849",
"망미1동","총인구","2020.03 월","12169","28489","13685","14804",
"망미1동","총인구","2020.04 월","12185","28461","13667","14794",
"망미1동","총인구","2020.05 월","12169","28335","13597","14738",
"망미1동","총인구","2020.06 월","12194","28252","13561","14691",
"망미1동","총인구","2020.07 월","12216","28177","13516","14661",
"망미1동","총인구","2020.08 월","12190","28077","13462","14615",
"망미1동","총인구","2020.09 월","12205","28042","13447","14595",
"망미1동","총인구","2020.10 월","12180","27963","13383","14580",
"망미1동","총인구","2020.11 월","12228","28004","13413","14591",
"망미1동","총인구","2020.12 월","12265","28026","13397","14629",
"망미1동","총인구","2021.01 월","12284","27960","13371","14589",
"망미1동","총인구","2021.02 월","12285","27881","13324","14557",
"망미1동","총인구","2021.03 월","12248","27794","13278","14516",
"망미1동","총인구","2021.04 월","12256","27758","13253","14505",
"망미1동","총인구","2021.05 월","12255","27712","13219","14493",
"망미1동","총인구","2021.06 월","12280","27658","13187","14471",
"망미1동","총인구","2021.07 월","12306","27634","13179","14455",
"망미1동","총인구","2021.08 월","12323","27615","13178","14437",
"망미1동","총인구","2021.09 월","12355","27616","13184","14432",
"망미1동","총인구","2021.10 월","12376","27617","13181","14436",
"망미1동","총인구","2021.11 월","12412","27596","13164","14432",
"망미1동","총인구","2021.12 월","12415","27523","13110","14413",
"망미1동","총인구","2022.01 월","12440","27517","13113","14404",
"망미1동","총인구","2022.02 월","12443","27481","13088","14393",
"망미1동","총인구","2022.03 월","12464","27448","13059","14389",
"망미1동","총인구","2022.04 월","12473","27416","13032","14384",
"망미1동","총인구","2022.05 월","12487","27393","13016","14377",
"망미1동","총인구","2022.06 월","12491","27375","13018","14357",
"망미1동","총인구","2022.07 월","12495","27376","13017","14359",
"망미1동","총인구","2022.08 월","12491","27319","12978","14341",
"망미1동","총인구","2022.09 월","12477","27305","12968","14337",
"망미1동","총인구","2022.10 월","12454","27218","12918","14300",
"망미1동","총인구","2022.11 월","12454","27195","12902","14293",
"망미1동","총인구","2022.12 월","12442","27147","12878","14269",
"망미1동","총인구","2023.01 월","12433","27121","12864","14257",
"망미1동","총인구","2023.02 월","12430","27051","12833","14218",
"망미1동","총인구","2023.03 월","12428","27044","12825","14219",
"망미1동","총인구","2023.04 월","12424","27035","12825","14210",
"망미1동","총인구","2023.05 월","12425","26964","12787","14177",
"망미1동","총인구","2023.06 월","12415","26907","12759","14148",
"망미1동","총인구","2023.07 월","12417","26865","12730","14135",
"망미1동","총인구","2023.08 월","12418","26795","12694","14101",
"망미1동","총인구","2023.09 월","12393","26723","12665","14058",
"망미1동","총인구","2023.10 월","12380","26651","12619","14032",
"망미1동","총인구","2023.11 월","12341","26549","12563","13986",
"망미1동","총인구","2023.12 월","12323","26475","12541","13934",
"망미1동","총인구","2024.01 월","12304","26376","12491","13885",
"망미1동","총인구","2024.02 월","12284","26290","12437","13853",
"망미1동","총인구","2024.03 월","12250","26214","12395","13819",
"망미1동","총인구","2024.04 월","12210","26133","12355","13778",
"망미1동","총인구","2024.05 월","12204","26079","12334","13745",
"망미1동","총인구","2024.06 월","12197","26037","12310","13727",
"망미1동","총인구","2024.07 월","12192","25983","12308","13675",
"망미1동","총인구","2024.08 월","12198","25992","12319","13673",
"망미1동","총인구","2024.09 월","12184","25918","12262","13656",
"망미1동","총인구","2024.10 월","12178","25892","12246","13646",
"망미1동","총인구","2024.11 월","12163","25791","12193","13598",
"망미1동","총인구","2024.12 월","12149","25761","12171","13590",
"망미2동","총인구","2020.01 월","5248","12002","5887","6115",
"망미2동","총인구","2020.02 월","5244","12001","5889","6112",
"망미2동","총인구","2020.03 월","5239","11964","5865","6099",
"망미2동","총인구","2020.04 월","5241","11948","5851","6097",
"망미2동","총인구","2020.05 월","5236","11902","5832","6070",
"망미2동","총인구","2020.06 월","5240","11886","5825","6061",
"망미2동","총인구","2020.07 월","5230","11846","5819","6027",
"망미2동","총인구","2020.08 월","5225","11789","5795","5994",
"망미2동","총인구","2020.09 월","5203","11713","5748","5965",
"망미2동","총인구","2020.10 월","5204","11690","5745","5945",
"망미2동","총인구","2020.11 월","5197","11632","5715","5917",
"망미2동","총인구","2020.12 월","5213","11579","5693","5886",
"망미2동","총인구","2021.01 월","5209","11537","5663","5874",
"망미2동","총인구","2021.02 월","5209","11499","5645","5854",
"망미2동","총인구","2021.03 월","5173","11404","5605","5799",
"망미2동","총인구","2021.04 월","5168","11378","5587","5791",
"망미2동","총인구","2021.05 월","5140","11311","5563","5748",
"망미2동","총인구","2021.06 월","5140","11269","5547","5722",
"망미2동","총인구","2021.07 월","5138","11246","5544","5702",
"망미2동","총인구","2021.08 월","5111","11191","5524","5667",
"망미2동","총인구","2021.09 월","5072","11082","5472","5610",
"망미2동","총인구","2021.10 월","5038","10977","5406","5571",
"망미2동","총인구","2021.11 월","4978","10841","5327","5514",
"망미2동","총인구","2021.12 월","4950","10779","5302","5477",
"망미2동","총인구","2022.01 월","4932","10708","5264","5444",
"망미2동","총인구","2022.02 월","4931","10679","5249","5430",
"망미2동","총인구","2022.03 월","4911","10618","5227","5391",
"망미2동","총인구","2022.04 월","4908","10616","5226","5390",
"망미2동","총인구","2022.05 월","4913","10600","5212","5388",
"망미2동","총인구","2022.06 월","4901","10587","5209","5378",
"망미2동","총인구","2022.07 월","4906","10572","5196","5376",
"망미2동","총인구","2022.08 월","4923","10589","5195","5394",
"망미2동","총인구","2022.09 월","4917","10558","5182","5376",
"망미2동","총인구","2022.10 월","4899","10500","5152","5348",
"망미2동","총인구","2022.11 월","4904","10492","5132","5360",
"망미2동","총인구","2022.12 월","4896","10450","5104","5346",
"망미2동","총인구","2023.01 월","4889","10444","5090","5354",
"망미2동","총인구","2023.02 월","4897","10427","5089","5338",
"망미2동","총인구","2023.03 월","4887","10388","5081","5307",
"망미2동","총인구","2023.04 월","4874","10351","5053","5298",
"망미2동","총인구","2023.05 월","4865","10322","5031","5291",
"망미2동","총인구","2023.06 월","4865","10309","5030","5279",
"망미2동","총인구","2023.07 월","4861","10285","5025","5260",
"망미2동","총인구","2023.08 월","4853","10258","5016","5242",
"망미2동","총인구","2023.09 월","4847","10231","4997","5234",
"망미2동","총인구","2023.10 월","4836","10207","4988","5219",
"망미2동","총인구","2023.11 월","4842","10184","4990","5194",
"망미2동","총인구","2023.12 월","4842","10160","4982","5178",
"망미2동","총인구","2024.01 월","4830","10106","4958","5148",
"망미2동","총인구","2024.02 월","4822","10080","4938","5142",
"망미2동","총인구","2024.03 월","4818","10065","4928","5137",
"망미2동","총인구","2024.04 월","4821","10058","4930","5128",
"망미2동","총인구","2024.05 월","4808","10040","4924","5116",
"망미2동","총인구","2024.06 월","4795","9994","4905","5089",
"망미2동","총인구","2024.07 월","4804","9994","4893","5101",
"망미2동","총인구","2024.08 월","4792","9950","4873","5077",
"망미2동","총인구","2024.09 월","4792","9939","4865","5074",
"망미2동","총인구","2024.10 월","4782","9904","4842","5062",
"망미2동","총인구","2024.11 월","4777","9876","4824","5052",
"망미2동","총인구","2024.12 월","4765","9834","4797","5037",
"광안1동","총인구","2020.01 월","13117","26459","12464","13995",
"광안1동","총인구","2020.02 월","13186","26467","12457","14010",
"광안1동","총인구","2020.03 월","13265","26484","12447","14037",
"광안1동","총인구","2020.04 월","13326","26464","12424","14040",
"광안1동","총인구","2020.05 월","13396","26457","12409","14048",
"광안1동","총인구","2020.06 월","13500","26560","12470","14090",
"광안1동","총인구","2020.07 월","13587","26610","12493","14117",
"광안1동","총인구","2020.08 월","13659","26545","12443","14102",
"광안1동","총인구","2020.09 월","13699","26494","12427","14067",
"광안1동","총인구","2020.10 월","13697","26421","12393","14028",
"광안1동","총인구","2020.11 월","13687","26289","12317","13972",
"광안1동","총인구","2020.12 월","13756","26284","12295","13989",
"광안1동","총인구","2021.01 월","13798","26238","12278","13960",
"광안1동","총인구","2021.02 월","13869","26281","12292","13989",
"광안1동","총인구","2021.03 월","13844","26139","12219","13920",
"광안1동","총인구","2021.04 월","13904","26150","12202","13948",
"광안1동","총인구","2021.05 월","13928","26064","12167","13897",
"광안1동","총인구","2021.06 월","13964","26048","12170","13878",
"광안1동","총인구","2021.07 월","14012","26027","12124","13903",
"광안1동","총인구","2021.08 월","14099","26121","12160","13961",
"광안1동","총인구","2021.09 월","14165","26146","12164","13982",
"광안1동","총인구","2021.10 월","14205","26138","12152","13986",
"광안1동","총인구","2021.11 월","14217","26122","12144","13978",
"광안1동","총인구","2021.12 월","14239","26079","12125","13954",
"광안1동","총인구","2022.01 월","14266","26050","12115","13935",
"광안1동","총인구","2022.02 월","14294","25992","12095","13897",
"광안1동","총인구","2022.03 월","14361","26034","12093","13941",
"광안1동","총인구","2022.04 월","14393","26015","12073","13942",
"광안1동","총인구","2022.05 월","14450","26040","12097","13943",
"광안1동","총인구","2022.06 월","14498","26078","12116","13962",
"광안1동","총인구","2022.07 월","14532","26095","12105","13990",
"광안1동","총인구","2022.08 월","14567","26078","12084","13994",
"광안1동","총인구","2022.09 월","14562","26019","12054","13965",
"광안1동","총인구","2022.10 월","14587","26012","12061","13951",
"광안1동","총인구","2022.11 월","14539","25947","12020","13927",
"광안1동","총인구","2022.12 월","14571","25958","12015","13943",
"광안1동","총인구","2023.01 월","14637","26004","12049","13955",
"광안1동","총인구","2023.02 월","14701","26073","12077","13996",
"광안1동","총인구","2023.03 월","14734","26089","12060","14029",
"광안1동","총인구","2023.04 월","14716","26021","12025","13996",
"광안1동","총인구","2023.05 월","14720","25998","12009","13989",
"광안1동","총인구","2023.06 월","14733","25967","12013","13954",
"광안1동","총인구","2023.07 월","14754","25945","12006","13939",
"광안1동","총인구","2023.08 월","14742","25918","11986","13932",
"광안1동","총인구","2023.09 월","14739","25886","11975","13911",
"광안1동","총인구","2023.10 월","14684","25789","11924","13865",
"광안1동","총인구","2023.11 월","14682","25707","11882","13825",
"광안1동","총인구","2023.12 월","14693","25659","11871","13788",
"광안1동","총인구","2024.01 월","14664","25558","11826","13732",
"광안1동","총인구","2024.02 월","14665","25501","11781","13720",
"광안1동","총인구","2024.03 월","14672","25464","11762","13702",
"광안1동","총인구","2024.04 월","14659","25391","11738","13653",
"광안1동","총인구","2024.05 월","14677","25393","11744","13649",
"광안1동","총인구","2024.06 월","14666","25371","11715","13656",
"광안1동","총인구","2024.07 월","14660","25323","11687","13636",
"광안1동","총인구","2024.08 월","14644","25271","11664","13607",
"광안1동","총인구","2024.09 월","14631","25224","11612","13612",
"광안1동","총인구","2024.10 월","14589","25099","11544","13555",
"광안1동","총인구","2024.11 월","14588","25098","11554","13544",
"광안1동","총인구","2024.12 월","14594","25122","11565","13557",
"광안2동","총인구","2020.01 월","9103","19278","9039","10239",
"광안2동","총인구","2020.02 월","9129","19283","9035","10248",
"광안2동","총인구","2020.03 월","9098","19169","8964","10205",
"광안2동","총인구","2020.04 월","9112","19177","8942","10235",
"광안2동","총인구","2020.05 월","9143","19149","8932","10217",
"광안2동","총인구","2020.06 월","9202","19192","8934","10258",
"광안2동","총인구","2020.07 월","9245","19204","8939","10265",
"광안2동","총인구","2020.08 월","9273","19135","8899","10236",
"광안2동","총인구","2020.09 월","9259","19013","8852","10161",
"광안2동","총인구","2020.10 월","9269","19010","8832","10178",
"광안2동","총인구","2020.11 월","9291","19001","8822","10179",
"광안2동","총인구","2020.12 월","9315","19001","8828","10173",
"광안2동","총인구","2021.01 월","9330","19022","8824","10198",
"광안2동","총인구","2021.02 월","9345","19004","8813","10191",
"광안2동","총인구","2021.03 월","9371","18968","8813","10155",
"광안2동","총인구","2021.04 월","9358","18939","8805","10134",
"광안2동","총인구","2021.05 월","9383","18961","8812","10149",
"광안2동","총인구","2021.06 월","9434","18949","8789","10160",
"광안2동","총인구","2021.07 월","9509","19017","8832","10185",
"광안2동","총인구","2021.08 월","9552","19057","8865","10192",
"광안2동","총인구","2021.09 월","9602","19051","8846","10205",
"광안2동","총인구","2021.10 월","9628","19035","8846","10189",
"광안2동","총인구","2021.11 월","9618","19016","8833","10183",
"광안2동","총인구","2021.12 월","9632","18994","8810","10184",
"광안2동","총인구","2022.01 월","9656","18966","8805","10161",
"광안2동","총인구","2022.02 월","9710","18991","8790","10201",
"광안2동","총인구","2022.03 월","9778","19076","8827","10249",
"광안2동","총인구","2022.04 월","9825","19137","8854","10283",
"광안2동","총인구","2022.05 월","9878","19152","8873","10279",
"광안2동","총인구","2022.06 월","9918","19195","8890","10305",
"광안2동","총인구","2022.07 월","9976","19209","8901","10308",
"광안2동","총인구","2022.08 월","10012","19252","8941","10311",
"광안2동","총인구","2022.09 월","9991","19217","8903","10314",
"광안2동","총인구","2022.10 월","9992","19173","8879","10294",
"광안2동","총인구","2022.11 월","9973","19160","8863","10297",
"광안2동","총인구","2022.12 월","9958","19122","8851","10271",
"광안2동","총인구","2023.01 월","9944","19094","8838","10256",
"광안2동","총인구","2023.02 월","9953","19040","8802","10238",
"광안2동","총인구","2023.03 월","9927","18961","8751","10210",
"광안2동","총인구","2023.04 월","9944","18967","8774","10193",
"광안2동","총인구","2023.05 월","9942","18976","8755","10221",
"광안2동","총인구","2023.06 월","9942","18973","8759","10214",
"광안2동","총인구","2023.07 월","9926","18930","8746","10184",
"광안2동","총인구","2023.08 월","9888","18874","8739","10135",
"광안2동","총인구","2023.09 월","9880","18867","8744","10123",
"광안2동","총인구","2023.10 월","9885","18871","8735","10136",
"광안2동","총인구","2023.11 월","9891","18874","8744","10130",
"광안2동","총인구","2023.12 월","9877","18828","8711","10117",
"광안2동","총인구","2024.01 월","9884","18779","8666","10113",
"광안2동","총인구","2024.02 월","9919","18783","8673","10110",
"광안2동","총인구","2024.03 월","9939","18773","8658","10115",
"광안2동","총인구","2024.04 월","9943","18748","8632","10116",
"광안2동","총인구","2024.05 월","9953","18750","8639","10111",
"광안2동","총인구","2024.06 월","9954","18725","8620","10105",
"광안2동","총인구","2024.07 월","9946","18672","8592","10080",
"광안2동","총인구","2024.08 월","9958","18676","8601","10075",
"광안2동","총인구","2024.09 월","9963","18692","8582","10110",
"광안2동","총인구","2024.10 월","9940","18682","8570","10112",
"광안2동","총인구","2024.11 월","9943","18677","8559","10118",
"광안2동","총인구","2024.12 월","9956","18690","8572","10118",
"광안3동","총인구","2020.01 월","5937","10441","4979","5462",
"광안3동","총인구","2020.02 월","5956","10465","4990","5475",
"광안3동","총인구","2020.03 월","5957","10451","4964","5487",
"광안3동","총인구","2020.04 월","5947","10439","4949","5490",
"광안3동","총인구","2020.05 월","5978","10458","4962","5496",
"광안3동","총인구","2020.06 월","5994","10460","4964","5496",
"광안3동","총인구","2020.07 월","5975","10373","4912","5461",
"광안3동","총인구","2020.08 월","5941","10228","4861","5367",
"광안3동","총인구","2020.09 월","5888","10064","4771","5293",
"광안3동","총인구","2020.10 월","5846","9956","4718","5238",
"광안3동","총인구","2020.11 월","5800","9848","4682","5166",
"광안3동","총인구","2020.12 월","5788","9789","4655","5134",
"광안3동","총인구","2021.01 월","5769","9734","4630","5104",
"광안3동","총인구","2021.02 월","5792","9709","4632","5077",
"광안3동","총인구","2021.03 월","5774","9639","4600","5039",
"광안3동","총인구","2021.04 월","5753","9606","4581","5025",
"광안3동","총인구","2021.05 월","5771","9597","4577","5020",
"광안3동","총인구","2021.06 월","5754","9548","4551","4997",
"광안3동","총인구","2021.07 월","5748","9511","4522","4989",
"광안3동","총인구","2021.08 월","5818","9569","4531","5038",
"광안3동","총인구","2021.09 월","5840","9594","4548","5046",
"광안3동","총인구","2021.10 월","5856","9590","4546","5044",
"광안3동","총인구","2021.11 월","5951","9675","4564","5111",
"광안3동","총인구","2021.12 월","5986","9680","4569","5111",
"광안3동","총인구","2022.01 월","6013","9684","4569","5115",
"광안3동","총인구","2022.02 월","6057","9717","4564","5153",
"광안3동","총인구","2022.03 월","6051","9673","4542","5131",
"광안3동","총인구","2022.04 월","6066","9684","4544","5140",
"광안3동","총인구","2022.05 월","6096","9682","4547","5135",
"광안3동","총인구","2022.06 월","6126","9728","4556","5172",
"광안3동","총인구","2022.07 월","6143","9745","4561","5184",
"광안3동","총인구","2022.08 월","6177","9784","4584","5200",
"광안3동","총인구","2022.09 월","6164","9740","4567","5173",
"광안3동","총인구","2022.10 월","6167","9715","4551","5164",
"광안3동","총인구","2022.11 월","6146","9679","4518","5161",
"광안3동","총인구","2022.12 월","6161","9678","4515","5163",
"광안3동","총인구","2023.01 월","6202","9699","4500","5199",
"광안3동","총인구","2023.02 월","6212","9688","4490","5198",
"광안3동","총인구","2023.03 월","6223","9691","4480","5211",
"광안3동","총인구","2023.04 월","6237","9683","4488","5195",
"광안3동","총인구","2023.05 월","6232","9687","4495","5192",
"광안3동","총인구","2023.06 월","6240","9681","4499","5182",
"광안3동","총인구","2023.07 월","6225","9647","4485","5162",
"광안3동","총인구","2023.08 월","6231","9654","4495","5159",
"광안3동","총인구","2023.09 월","6196","9616","4481","5135",
"광안3동","총인구","2023.10 월","6183","9597","4480","5117",
"광안3동","총인구","2023.11 월","6186","9587","4476","5111",
"광안3동","총인구","2023.12 월","6168","9532","4459","5073",
"광안3동","총인구","2024.01 월","6163","9518","4457","5061",
"광안3동","총인구","2024.02 월","6148","9469","4425","5044",
"광안3동","총인구","2024.03 월","6153","9444","4420","5024",
"광안3동","총인구","2024.04 월","6154","9421","4413","5008",
"광안3동","총인구","2024.05 월","6142","9396","4404","4992",
"광안3동","총인구","2024.06 월","6139","9391","4389","5002",
"광안3동","총인구","2024.07 월","6127","9352","4352","5000",
"광안3동","총인구","2024.08 월","6109","9316","4329","4987",
"광안3동","총인구","2024.09 월","6119","9332","4349","4983",
"광안3동","총인구","2024.10 월","6107","9305","4325","4980",
"광안3동","총인구","2024.11 월","6112","9295","4313","4982",
"광안3동","총인구","2024.12 월","6112","9286","4307","4979",
"광안4동","총인구","2020.01 월","5082","11294","5046","6248",
"광안4동","총인구","2020.02 월","5082","11257","5014","6243",
"광안4동","총인구","2020.03 월","5081","11222","5002","6220",
"광안4동","총인구","2020.04 월","5066","11199","4993","6206",
"광안4동","총인구","2020.05 월","5070","11175","4973","6202",
"광안4동","총인구","2020.06 월","5048","11091","4926","6165",
"광안4동","총인구","2020.07 월","5049","11056","4914","6142",
"광안4동","총인구","2020.08 월","5365","11847","5316","6531",
"광안4동","총인구","2020.09 월","5686","12641","5698","6943",
"광안4동","총인구","2020.10 월","5802","12937","5828","7109",
"광안4동","총인구","2020.11 월","5866","13067","5890","7177",
"광안4동","총인구","2020.12 월","5928","13222","5968","7254",
"광안4동","총인구","2021.01 월","5962","13274","5992","7282",
"광안4동","총인구","2021.02 월","5993","13347","6023","7324",
"광안4동","총인구","2021.03 월","6055","13496","6118","7378",
"광안4동","총인구","2021.04 월","6123","13672","6207","7465",
"광안4동","총인구","2021.05 월","6149","13729","6235","7494",
"광안4동","총인구","2021.06 월","6214","13838","6277","7561",
"광안4동","총인구","2021.07 월","6221","13802","6261","7541",
"광안4동","총인구","2021.08 월","6247","13841","6275","7566",
"광안4동","총인구","2021.09 월","6248","13827","6256","7571",
"광안4동","총인구","2021.10 월","6257","13844","6267","7577",
"광안4동","총인구","2021.11 월","6277","13861","6276","7585",
"광안4동","총인구","2021.12 월","6284","13825","6251","7574",
"광안4동","총인구","2022.01 월","6283","13817","6233","7584",
"광안4동","총인구","2022.02 월","6301","13811","6238","7573",
"광안4동","총인구","2022.03 월","6309","13786","6213","7573",
"광안4동","총인구","2022.04 월","6333","13812","6232","7580",
"광안4동","총인구","2022.05 월","6361","13854","6254","7600",
"광안4동","총인구","2022.06 월","6368","13862","6264","7598",
"광안4동","총인구","2022.07 월","6364","13846","6265","7581",
"광안4동","총인구","2022.08 월","6383","13831","6258","7573",
"광안4동","총인구","2022.09 월","6369","13828","6256","7572",
"광안4동","총인구","2022.10 월","6352","13749","6204","7545",
"광안4동","총인구","2022.11 월","6339","13700","6198","7502",
"광안4동","총인구","2022.12 월","6330","13699","6182","7517",
"광안4동","총인구","2023.01 월","6334","13666","6169","7497",
"광안4동","총인구","2023.02 월","6337","13636","6155","7481",
"광안4동","총인구","2023.03 월","6343","13628","6152","7476",
"광안4동","총인구","2023.04 월","6322","13587","6131","7456",
"광안4동","총인구","2023.05 월","6325","13573","6115","7458",
"광안4동","총인구","2023.06 월","6326","13585","6120","7465",
"광안4동","총인구","2023.07 월","6317","13559","6117","7442",
"광안4동","총인구","2023.08 월","6314","13559","6124","7435",
"광안4동","총인구","2023.09 월","6313","13544","6111","7433",
"광안4동","총인구","2023.10 월","6315","13524","6104","7420",
"광안4동","총인구","2023.11 월","6308","13503","6086","7417",
"광안4동","총인구","2023.12 월","6299","13480","6081","7399",
"광안4동","총인구","2024.01 월","6272","13434","6059","7375",
"광안4동","총인구","2024.02 월","6278","13399","6040","7359",
"광안4동","총인구","2024.03 월","6270","13386","6028","7358",
"광안4동","총인구","2024.04 월","6268","13385","6028","7357",
"광안4동","총인구","2024.05 월","6273","13348","6001","7347",
"광안4동","총인구","2024.06 월","6271","13316","5992","7324",
"광안4동","총인구","2024.07 월","6285","13325","5992","7333",
"광안4동","총인구","2024.08 월","6306","13332","5986","7346",
"광안4동","총인구","2024.09 월","6301","13303","5967","7336",
"광안4동","총인구","2024.10 월","6302","13251","5945","7306",
"광안4동","총인구","2024.11 월","6310","13234","5945","7289",
"광안4동","총인구","2024.12 월","6314","13232","5946","7286",
"민락동","총인구","2020.01 월","12057","27459","13221","14238",
"민락동","총인구","2020.02 월","12383","28230","13561","14669",
"민락동","총인구","2020.03 월","12591","28665","13790","14875",
"민락동","총인구","2020.04 월","12663","28828","13877","14951",
"민락동","총인구","2020.05 월","12741","28973","13963","15010",
"민락동","총인구","2020.06 월","12839","29135","14045","15090",
"민락동","총인구","2020.07 월","12867","29153","14045","15108",
"민락동","총인구","2020.08 월","12883","29113","14037","15076",
"민락동","총인구","2020.09 월","12933","29125","14025","15100",
"민락동","총인구","2020.10 월","12943","29066","14014","15052",
"민락동","총인구","2020.11 월","12942","28978","13966","15012",
"민락동","총인구","2020.12 월","12973","28936","13950","14986",
"민락동","총인구","2021.01 월","12991","28891","13933","14958",
"민락동","총인구","2021.02 월","13041","28884","13949","14935",
"민락동","총인구","2021.03 월","12992","28804","13907","14897",
"민락동","총인구","2021.04 월","13038","28893","13957","14936",
"민락동","총인구","2021.05 월","13045","28891","13933","14958",
"민락동","총인구","2021.06 월","13043","28850","13890","14960",
"민락동","총인구","2021.07 월","13054","28843","13913","14930",
"민락동","총인구","2021.08 월","13066","28842","13906","14936",
"민락동","총인구","2021.09 월","13137","28932","13961","14971",
"민락동","총인구","2021.10 월","13183","28955","13971","14984",
"민락동","총인구","2021.11 월","13207","28902","13957","14945",
"민락동","총인구","2021.12 월","13239","28895","13950","14945",
"민락동","총인구","2022.01 월","13253","28884","13930","14954",
"민락동","총인구","2022.02 월","13316","28906","13945","14961",
"민락동","총인구","2022.03 월","13345","28858","13913","14945",
"민락동","총인구","2022.04 월","13359","28858","13933","14925",
"민락동","총인구","2022.05 월","13394","28843","13922","14921",
"민락동","총인구","2022.06 월","13436","28856","13923","14933",
"민락동","총인구","2022.07 월","13459","28879","13929","14950",
"민락동","총인구","2022.08 월","13457","28821","13892","14929",
"민락동","총인구","2022.09 월","13418","28749","13848","14901",
"민락동","총인구","2022.10 월","13424","28714","13825","14889",
"민락동","총인구","2022.11 월","13397","28642","13797","14845",
"민락동","총인구","2022.12 월","13366","28552","13765","14787",
"민락동","총인구","2023.01 월","13365","28563","13777","14786",
"민락동","총인구","2023.02 월","13367","28551","13777","14774",
"민락동","총인구","2023.03 월","13345","28474","13745","14729",
"민락동","총인구","2023.04 월","13364","28460","13741","14719",
"민락동","총인구","2023.05 월","13363","28438","13727","14711",
"민락동","총인구","2023.06 월","13360","28428","13716","14712",
"민락동","총인구","2023.07 월","13353","28378","13696","14682",
"민락동","총인구","2023.08 월","13349","28366","13685","14681",
"민락동","총인구","2023.09 월","13312","28294","13652","14642",
"민락동","총인구","2023.10 월","13308","28257","13640","14617",
"민락동","총인구","2023.11 월","13319","28233","13636","14597",
"민락동","총인구","2023.12 월","13319","28200","13596","14604",
"민락동","총인구","2024.01 월","13302","28124","13537","14587",
"민락동","총인구","2024.02 월","13264","28017","13468","14549",
"민락동","총인구","2024.03 월","13275","27987","13442","14545",
"민락동","총인구","2024.04 월","13269","27968","13450","14518",
"민락동","총인구","2024.05 월","13248","27949","13459","14490",
"민락동","총인구","2024.06 월","13239","27944","13446","14498",
"민락동","총인구","2024.07 월","13261","27945","13460","14485",
"민락동","총인구","2024.08 월","13272","27964","13451","14513",
"민락동","총인구","2024.09 월","13281","27928","13441","14487",
"민락동","총인구","2024.10 월","13255","27887","13430","14457",
"민락동","총인구","2024.11 월","13222","27814","13379","14435",
"민락동","총인구","2024.12 월","13208","27810","13366","14444",
"사상구","총인구","2020.01 월","96652","222840","112913","109927",
"사상구","총인구","2020.02 월","96781","222476","112720","109756",
"사상구","총인구","2020.03 월","96859","221983","112448","109535",
"사상구","총인구","2020.04 월","96924","221480","112219","109261",
"사상구","총인구","2020.05 월","97038","220861","111907","108954",
"사상구","총인구","2020.06 월","97113","220468","111722","108746",
"사상구","총인구","2020.07 월","97215","220011","111480","108531",
"사상구","총인구","2020.08 월","97274","219383","111114","108269",
"사상구","총인구","2020.09 월","97357","218913","110845","108068",
"사상구","총인구","2020.10 월","97343","218344","110547","107797",
"사상구","총인구","2020.11 월","97419","217787","110221","107566",
"사상구","총인구","2020.12 월","97556","217135","109876","107259",
"사상구","총인구","2021.01 월","97687","216678","109640","107038",
"사상구","총인구","2021.02 월","97946","216436","109530","106906",
"사상구","총인구","2021.03 월","97727","215731","109124","106607",
"사상구","총인구","2021.04 월","97841","215465","108954","106511",
"사상구","총인구","2021.05 월","98003","215117","108761","106356",
"사상구","총인구","2021.06 월","98179","214810","108587","106223",
"사상구","총인구","2021.07 월","98304","214401","108376","106025",
"사상구","총인구","2021.08 월","98305","213856","108131","105725",
"사상구","총인구","2021.09 월","98505","213940","108100","105840",
"사상구","총인구","2021.10 월","98616","213685","107961","105724",
"사상구","총인구","2021.11 월","98627","213290","107732","105558",
"사상구","총인구","2021.12 월","98621","212771","107440","105331",
"사상구","총인구","2022.01 월","98536","212177","107160","105017",
"사상구","총인구","2022.02 월","98603","211432","106793","104639",
"사상구","총인구","2022.03 월","98651","211304","106596","104708",
"사상구","총인구","2022.04 월","98618","210863","106360","104503",
"사상구","총인구","2022.05 월","98702","210605","106220","104385",
"사상구","총인구","2022.06 월","98741","210294","106072","104222",
"사상구","총인구","2022.07 월","98690","209771","105780","103991",
"사상구","총인구","2022.08 월","98694","209199","105492","103707",
"사상구","총인구","2022.09 월","98256","208630","105155","103475",
"사상구","총인구","2022.10 월","98135","208037","104846","103191",
"사상구","총인구","2022.11 월","98324","208272","104977","103295",
"사상구","총인구","2022.12 월","98625","208553","105119","103434",
"사상구","총인구","2023.01 월","98779","208500","105074","103426",
"사상구","총인구","2023.02 월","99040","208353","104972","103381",
"사상구","총인구","2023.03 월","99173","208557","104973","103584",
"사상구","총인구","2023.04 월","99293","208601","104954","103647",
"사상구","총인구","2023.05 월","99353","208586","104953","103633",
"사상구","총인구","2023.06 월","99364","208275","104792","103483",
"사상구","총인구","2023.07 월","99400","208162","104724","103438",
"사상구","총인구","2023.08 월","99813","208823","105017","103806",
"사상구","총인구","2023.09 월","100053","209605","105396","104209",
"사상구","총인구","2023.10 월","100043","209302","105216","104086",
"사상구","총인구","2023.11 월","99998","209015","105052","103963",
"사상구","총인구","2023.12 월","100003","208794","105007","103787",
"사상구","총인구","2024.01 월","99827","208373","104747","103626",
"사상구","총인구","2024.02 월","99966","207974","104538","103436",
"사상구","총인구","2024.03 월","100076","208231","104558","103673",
"사상구","총인구","2024.04 월","100051","207977","104452","103525",
"사상구","총인구","2024.05 월","100110","207812","104376","103436",
"사상구","총인구","2024.06 월","100047","207440","104140","103300",
"사상구","총인구","2024.07 월","99970","207029","103882","103147",
"사상구","총인구","2024.08 월","99870","206579","103683","102896",
"사상구","총인구","2024.09 월","99812","206531","103645","102886",
"사상구","총인구","2024.10 월","99707","206401","103632","102769",
"사상구","총인구","2024.11 월","99661","206106","103492","102614",
"사상구","총인구","2024.12 월","99563","205618","103254","102364",
"삼락동","총인구","2020.01 월","3238","6696","3617","3079",
"삼락동","총인구","2020.02 월","3228","6652","3594","3058",
"삼락동","총인구","2020.03 월","3223","6623","3575","3048",
"삼락동","총인구","2020.04 월","3211","6602","3571","3031",
"삼락동","총인구","2020.05 월","3207","6585","3546","3039",
"삼락동","총인구","2020.06 월","3214","6578","3548","3030",
"삼락동","총인구","2020.07 월","3239","6599","3569","3030",
"삼락동","총인구","2020.08 월","3239","6580","3562","3018",
"삼락동","총인구","2020.09 월","3235","6549","3546","3003",
"삼락동","총인구","2020.10 월","3229","6520","3531","2989",
"삼락동","총인구","2020.11 월","3223","6474","3498","2976",
"삼락동","총인구","2020.12 월","3223","6436","3482","2954",
"삼락동","총인구","2021.01 월","3228","6430","3478","2952",
"삼락동","총인구","2021.02 월","3229","6435","3481","2954",
"삼락동","총인구","2021.03 월","3146","6328","3409","2919",
"삼락동","총인구","2021.04 월","3150","6304","3403","2901",
"삼락동","총인구","2021.05 월","3128","6257","3372","2885",
"삼락동","총인구","2021.06 월","3130","6234","3361","2873",
"삼락동","총인구","2021.07 월","3132","6218","3348","2870",
"삼락동","총인구","2021.08 월","3146","6221","3353","2868",
"삼락동","총인구","2021.09 월","3151","6224","3350","2874",
"삼락동","총인구","2021.10 월","3148","6213","3345","2868",
"삼락동","총인구","2021.11 월","3151","6210","3337","2873",
"삼락동","총인구","2021.12 월","3144","6202","3325","2877",
"삼락동","총인구","2022.01 월","3138","6175","3310","2865",
"삼락동","총인구","2022.02 월","3139","6155","3304","2851",
"삼락동","총인구","2022.03 월","3125","6124","3280","2844",
"삼락동","총인구","2022.04 월","3111","6090","3264","2826",
"삼락동","총인구","2022.05 월","3100","6069","3247","2822",
"삼락동","총인구","2022.06 월","3104","6069","3242","2827",
"삼락동","총인구","2022.07 월","3104","6065","3234","2831",
"삼락동","총인구","2022.08 월","3103","6052","3234","2818",
"삼락동","총인구","2022.09 월","3093","6051","3231","2820",
"삼락동","총인구","2022.10 월","3085","6029","3226","2803",
"삼락동","총인구","2022.11 월","3084","5999","3203","2796",
"삼락동","총인구","2022.12 월","3081","5969","3186","2783",
"삼락동","총인구","2023.01 월","3054","5921","3155","2766",
"삼락동","총인구","2023.02 월","3036","5897","3128","2769",
"삼락동","총인구","2023.03 월","3040","5881","3122","2759",
"삼락동","총인구","2023.04 월","3033","5872","3112","2760",
"삼락동","총인구","2023.05 월","3033","5865","3108","2757",
"삼락동","총인구","2023.06 월","3032","5858","3107","2751",
"삼락동","총인구","2023.07 월","3022","5830","3092","2738",
"삼락동","총인구","2023.08 월","3004","5789","3074","2715",
"삼락동","총인구","2023.09 월","2980","5752","3052","2700",
"삼락동","총인구","2023.10 월","2959","5699","3021","2678",
"삼락동","총인구","2023.11 월","2952","5691","3023","2668",
"삼락동","총인구","2023.12 월","2950","5681","3020","2661",
"삼락동","총인구","2024.01 월","2935","5637","2990","2647",
"삼락동","총인구","2024.02 월","2933","5629","2989","2640",
"삼락동","총인구","2024.03 월","2924","5601","2974","2627",
"삼락동","총인구","2024.04 월","2927","5609","2970","2639",
"삼락동","총인구","2024.05 월","2930","5606","2972","2634",
"삼락동","총인구","2024.06 월","2926","5587","2958","2629",
"삼락동","총인구","2024.07 월","2916","5567","2950","2617",
"삼락동","총인구","2024.08 월","2906","5545","2935","2610",
"삼락동","총인구","2024.09 월","2899","5539","2937","2602",
"삼락동","총인구","2024.10 월","2888","5529","2936","2593",
"삼락동","총인구","2024.11 월","2877","5492","2912","2580",
"삼락동","총인구","2024.12 월","2865","5469","2896","2573",
"모라1동","총인구","2020.01 월","11982","29072","14621","14451",
"모라1동","총인구","2020.02 월","11994","29048","14611","14437",
"모라1동","총인구","2020.03 월","12005","29008","14589","14419",
"모라1동","총인구","2020.04 월","12020","28974","14562","14412",
"모라1동","총인구","2020.05 월","12042","28959","14559","14400",
"모라1동","총인구","2020.06 월","12040","28883","14521","14362",
"모라1동","총인구","2020.07 월","12039","28805","14473","14332",
"모라1동","총인구","2020.08 월","12048","28768","14436","14332",
"모라1동","총인구","2020.09 월","12051","28730","14406","14324",
"모라1동","총인구","2020.10 월","12048","28657","14368","14289",
"모라1동","총인구","2020.11 월","12063","28625","14343","14282",
"모라1동","총인구","2020.12 월","12042","28501","14271","14230",
"모라1동","총인구","2021.01 월","12082","28493","14267","14226",
"모라1동","총인구","2021.02 월","12095","28428","14222","14206",
"모라1동","총인구","2021.03 월","12116","28383","14203","14180",
"모라1동","총인구","2021.04 월","12139","28356","14191","14165",
"모라1동","총인구","2021.05 월","12296","28469","14215","14254",
"모라1동","총인구","2021.06 월","12431","28571","14261","14310",
"모라1동","총인구","2021.07 월","12471","28522","14231","14291",
"모라1동","총인구","2021.08 월","12480","28483","14199","14284",
"모라1동","총인구","2021.09 월","12497","28457","14173","14284",
"모라1동","총인구","2021.10 월","12503","28388","14142","14246",
"모라1동","총인구","2021.11 월","12510","28330","14106","14224",
"모라1동","총인구","2021.12 월","12502","28282","14076","14206",
"모라1동","총인구","2022.01 월","12513","28243","14059","14184",
"모라1동","총인구","2022.02 월","12519","28175","14030","14145",
"모라1동","총인구","2022.03 월","12527","28148","14008","14140",
"모라1동","총인구","2022.04 월","12525","28106","13994","14112",
"모라1동","총인구","2022.05 월","12529","28081","13998","14083",
"모라1동","총인구","2022.06 월","12530","28059","13983","14076",
"모라1동","총인구","2022.07 월","12539","27999","13946","14053",
"모라1동","총인구","2022.08 월","12548","27942","13910","14032",
"모라1동","총인구","2022.09 월","12484","27816","13853","13963",
"모라1동","총인구","2022.10 월","12485","27790","13831","13959",
"모라1동","총인구","2022.11 월","12462","27706","13789","13917",
"모라1동","총인구","2022.12 월","12438","27613","13739","13874",
"모라1동","총인구","2023.01 월","12412","27527","13686","13841",
"모라1동","총인구","2023.02 월","12376","27447","13642","13805",
"모라1동","총인구","2023.03 월","12367","27422","13644","13778",
"모라1동","총인구","2023.04 월","12382","27397","13622","13775",
"모라1동","총인구","2023.05 월","12376","27348","13598","13750",
"모라1동","총인구","2023.06 월","12365","27302","13584","13718",
"모라1동","총인구","2023.07 월","12342","27231","13550","13681",
"모라1동","총인구","2023.08 월","12296","27065","13452","13613",
"모라1동","총인구","2023.09 월","12257","26936","13386","13550",
"모라1동","총인구","2023.10 월","12230","26826","13332","13494",
"모라1동","총인구","2023.11 월","12242","26793","13315","13478",
"모라1동","총인구","2023.12 월","12241","26726","13278","13448",
"모라1동","총인구","2024.01 월","12247","26710","13257","13453",
"모라1동","총인구","2024.02 월","12255","26658","13223","13435",
"모라1동","총인구","2024.03 월","12275","26658","13228","13430",
"모라1동","총인구","2024.04 월","12262","26620","13220","13400",
"모라1동","총인구","2024.05 월","12269","26585","13199","13386",
"모라1동","총인구","2024.06 월","12253","26536","13175","13361",
"모라1동","총인구","2024.07 월","12246","26485","13152","13333",
"모라1동","총인구","2024.08 월","12233","26441","13138","13303",
"모라1동","총인구","2024.09 월","12234","26398","13116","13282",
"모라1동","총인구","2024.10 월","12237","26326","13081","13245",
"모라1동","총인구","2024.11 월","12236","26298","13053","13245",
"모라1동","총인구","2024.12 월","12223","26220","13009","13211",
"모라3동","총인구","2020.01 월","6903","11534","5490","6044",
"모라3동","총인구","2020.02 월","6906","11508","5472","6036",
"모라3동","총인구","2020.03 월","6912","11470","5460","6010",
"모라3동","총인구","2020.04 월","6903","11422","5432","5990",
"모라3동","총인구","2020.05 월","6892","11375","5419","5956",
"모라3동","총인구","2020.06 월","6888","11349","5416","5933",
"모라3동","총인구","2020.07 월","6898","11323","5402","5921",
"모라3동","총인구","2020.08 월","6897","11302","5383","5919",
"모라3동","총인구","2020.09 월","6886","11240","5354","5886",
"모라3동","총인구","2020.10 월","6882","11195","5335","5860",
"모라3동","총인구","2020.11 월","6873","11141","5306","5835",
"모라3동","총인구","2020.12 월","6872","11079","5288","5791",
"모라3동","총인구","2021.01 월","6869","11043","5274","5769",
"모라3동","총인구","2021.02 월","6875","11027","5269","5758",
"모라3동","총인구","2021.03 월","6873","10986","5253","5733",
"모라3동","총인구","2021.04 월","6865","10944","5221","5723",
"모라3동","총인구","2021.05 월","6842","10854","5183","5671",
"모라3동","총인구","2021.06 월","6825","10775","5138","5637",
"모라3동","총인구","2021.07 월","6803","10722","5110","5612",
"모라3동","총인구","2021.08 월","6782","10664","5086","5578",
"모라3동","총인구","2021.09 월","6767","10611","5056","5555",
"모라3동","총인구","2021.10 월","6766","10584","5041","5543",
"모라3동","총인구","2021.11 월","6737","10504","5006","5498",
"모라3동","총인구","2021.12 월","6718","10462","4991","5471",
"모라3동","총인구","2022.01 월","6706","10421","4972","5449",
"모라3동","총인구","2022.02 월","6682","10356","4934","5422",
"모라3동","총인구","2022.03 월","6666","10317","4910","5407",
"모라3동","총인구","2022.04 월","6646","10260","4871","5389",
"모라3동","총인구","2022.05 월","6625","10214","4853","5361",
"모라3동","총인구","2022.06 월","6610","10167","4836","5331",
"모라3동","총인구","2022.07 월","6590","10118","4809","5309",
"모라3동","총인구","2022.08 월","6560","10047","4761","5286",
"모라3동","총인구","2022.09 월","6519","9979","4722","5257",
"모라3동","총인구","2022.10 월","6489","9929","4694","5235",
"모라3동","총인구","2022.11 월","6474","9886","4672","5214",
"모라3동","총인구","2022.12 월","6456","9823","4633","5190",
"모라3동","총인구","2023.01 월","6446","9786","4617","5169",
"모라3동","총인구","2023.02 월","6454","9767","4607","5160",
"모라3동","총인구","2023.03 월","6446","9735","4594","5141",
"모라3동","총인구","2023.04 월","6421","9689","4583","5106",
"모라3동","총인구","2023.05 월","6421","9682","4576","5106",
"모라3동","총인구","2023.06 월","6413","9650","4557","5093",
"모라3동","총인구","2023.07 월","6393","9608","4533","5075",
"모라3동","총인구","2023.08 월","6366","9548","4505","5043",
"모라3동","총인구","2023.09 월","6363","9516","4491","5025",
"모라3동","총인구","2023.10 월","6350","9476","4472","5004",
"모라3동","총인구","2023.11 월","6322","9415","4445","4970",
"모라3동","총인구","2023.12 월","6306","9372","4421","4951",
"모라3동","총인구","2024.01 월","6285","9331","4399","4932",
"모라3동","총인구","2024.02 월","6271","9302","4389","4913",
"모라3동","총인구","2024.03 월","6253","9262","4375","4887",
"모라3동","총인구","2024.04 월","6251","9222","4353","4869",
"모라3동","총인구","2024.05 월","6243","9191","4336","4855",
"모라3동","총인구","2024.06 월","6248","9188","4328","4860",
"모라3동","총인구","2024.07 월","6237","9182","4317","4865",
"모라3동","총인구","2024.08 월","6230","9150","4306","4844",
"모라3동","총인구","2024.09 월","6209","9107","4279","4828",
"모라3동","총인구","2024.10 월","6203","9075","4267","4808",
"모라3동","총인구","2024.11 월","6204","9065","4274","4791",
"모라3동","총인구","2024.12 월","6199","9040","4256","4784",
"덕포1동","총인구","2020.01 월","4281","9580","4903","4677",
"덕포1동","총인구","2020.02 월","4278","9542","4874","4668",
"덕포1동","총인구","2020.03 월","4277","9536","4871","4665",
"덕포1동","총인구","2020.04 월","4288","9508","4866","4642",
"덕포1동","총인구","2020.05 월","4277","9440","4839","4601",
"덕포1동","총인구","2020.06 월","4291","9451","4846","4605",
"덕포1동","총인구","2020.07 월","4285","9375","4805","4570",
"덕포1동","총인구","2020.08 월","4288","9348","4787","4561",
"덕포1동","총인구","2020.09 월","4274","9288","4761","4527",
"덕포1동","총인구","2020.10 월","4271","9276","4755","4521",
"덕포1동","총인구","2020.11 월","4272","9244","4733","4511",
"덕포1동","총인구","2020.12 월","4276","9230","4728","4502",
"덕포1동","총인구","2021.01 월","4273","9210","4710","4500",
"덕포1동","총인구","2021.02 월","4289","9199","4717","4482",
"덕포1동","총인구","2021.03 월","4264","9134","4680","4454",
"덕포1동","총인구","2021.04 월","4259","9140","4689","4451",
"덕포1동","총인구","2021.05 월","4270","9126","4684","4442",
"덕포1동","총인구","2021.06 월","4279","9111","4676","4435",
"덕포1동","총인구","2021.07 월","4286","9101","4667","4434",
"덕포1동","총인구","2021.08 월","4283","9092","4666","4426",
"덕포1동","총인구","2021.09 월","4285","9068","4646","4422",
"덕포1동","총인구","2021.10 월","4278","9032","4632","4400",
"덕포1동","총인구","2021.11 월","4275","9025","4636","4389",
"덕포1동","총인구","2021.12 월","4278","9033","4633","4400",
"덕포1동","총인구","2022.01 월","4264","9010","4626","4384",
"덕포1동","총인구","2022.02 월","4255","8984","4614","4370",
"덕포1동","총인구","2022.03 월","4247","8941","4588","4353",
"덕포1동","총인구","2022.04 월","4229","8884","4548","4336",
"덕포1동","총인구","2022.05 월","4254","8912","4555","4357",
"덕포1동","총인구","2022.06 월","4255","8913","4552","4361",
"덕포1동","총인구","2022.07 월","4247","8890","4535","4355",
"덕포1동","총인구","2022.08 월","4245","8858","4523","4335",
"덕포1동","총인구","2022.09 월","4219","8824","4499","4325",
"덕포1동","총인구","2022.10 월","4213","8788","4467","4321",
"덕포1동","총인구","2022.11 월","4214","8774","4455","4319",
"덕포1동","총인구","2022.12 월","4201","8732","4436","4296",
"덕포1동","총인구","2023.01 월","4186","8705","4429","4276",
"덕포1동","총인구","2023.02 월","4195","8691","4434","4257",
"덕포1동","총인구","2023.03 월","4177","8643","4419","4224",
"덕포1동","총인구","2023.04 월","4174","8628","4409","4219",
"덕포1동","총인구","2023.05 월","4175","8639","4422","4217",
"덕포1동","총인구","2023.06 월","4179","8658","4436","4222",
"덕포1동","총인구","2023.07 월","4268","8812","4520","4292",
"덕포1동","총인구","2023.08 월","4883","10343","5273","5070",
"덕포1동","총인구","2023.09 월","5248","11201","5712","5489",
"덕포1동","총인구","2023.10 월","5430","11612","5912","5700",
"덕포1동","총인구","2023.11 월","5492","11760","5985","5775",
"덕포1동","총인구","2023.12 월","5552","11938","6056","5882",
"덕포1동","총인구","2024.01 월","5572","11992","6077","5915",
"덕포1동","총인구","2024.02 월","5609","12067","6120","5947",
"덕포1동","총인구","2024.03 월","5627","12159","6165","5994",
"덕포1동","총인구","2024.04 월","5619","12153","6163","5990",
"덕포1동","총인구","2024.05 월","5626","12155","6161","5994",
"덕포1동","총인구","2024.06 월","5605","12101","6130","5971",
"덕포1동","총인구","2024.07 월","5631","12141","6141","6000",
"덕포1동","총인구","2024.08 월","5634","12168","6155","6013",
"덕포1동","총인구","2024.09 월","5623","12184","6166","6018",
"덕포1동","총인구","2024.10 월","5612","12190","6177","6013",
"덕포1동","총인구","2024.11 월","5610","12201","6193","6008",
"덕포1동","총인구","2024.12 월","5609","12203","6181","6022",
"덕포2동","총인구","2020.01 월","5657","13751","7018","6733",
"덕포2동","총인구","2020.02 월","5671","13723","6990","6733",
"덕포2동","총인구","2020.03 월","5719","13758","7006","6752",
"덕포2동","총인구","2020.04 월","5749","13776","7019","6757",
"덕포2동","총인구","2020.05 월","5772","13751","6993","6758",
"덕포2동","총인구","2020.06 월","5764","13673","6953","6720",
"덕포2동","총인구","2020.07 월","5761","13618","6925","6693",
"덕포2동","총인구","2020.08 월","5764","13590","6902","6688",
"덕포2동","총인구","2020.09 월","5778","13597","6915","6682",
"덕포2동","총인구","2020.10 월","5765","13567","6896","6671",
"덕포2동","총인구","2020.11 월","5755","13483","6854","6629",
"덕포2동","총인구","2020.12 월","5770","13462","6837","6625",
"덕포2동","총인구","2021.01 월","5774","13416","6815","6601",
"덕포2동","총인구","2021.02 월","5760","13375","6775","6600",
"덕포2동","총인구","2021.03 월","5736","13317","6743","6574",
"덕포2동","총인구","2021.04 월","5732","13271","6705","6566",
"덕포2동","총인구","2021.05 월","5732","13254","6706","6548",
"덕포2동","총인구","2021.06 월","5734","13232","6703","6529",
"덕포2동","총인구","2021.07 월","5734","13203","6686","6517",
"덕포2동","총인구","2021.08 월","5734","13207","6696","6511",
"덕포2동","총인구","2021.09 월","5755","13221","6717","6504",
"덕포2동","총인구","2021.10 월","5767","13206","6710","6496",
"덕포2동","총인구","2021.11 월","5768","13206","6716","6490",
"덕포2동","총인구","2021.12 월","5766","13172","6686","6486",
"덕포2동","총인구","2022.01 월","5768","13149","6662","6487",
"덕포2동","총인구","2022.02 월","5773","13120","6655","6465",
"덕포2동","총인구","2022.03 월","5760","13064","6620","6444",
"덕포2동","총인구","2022.04 월","5754","13033","6605","6428",
"덕포2동","총인구","2022.05 월","5753","12998","6577","6421",
"덕포2동","총인구","2022.06 월","5747","12971","6561","6410",
"덕포2동","총인구","2022.07 월","5752","12953","6554","6399",
"덕포2동","총인구","2022.08 월","5761","12936","6545","6391",
"덕포2동","총인구","2022.09 월","5766","12924","6537","6387",
"덕포2동","총인구","2022.10 월","5774","12908","6528","6380",
"덕포2동","총인구","2022.11 월","5762","12863","6508","6355",
"덕포2동","총인구","2022.12 월","5747","12830","6492","6338",
"덕포2동","총인구","2023.01 월","5729","12799","6484","6315",
"덕포2동","총인구","2023.02 월","5719","12770","6470","6300",
"덕포2동","총인구","2023.03 월","5738","12753","6469","6284",
"덕포2동","총인구","2023.04 월","5741","12733","6459","6274",
"덕포2동","총인구","2023.05 월","5736","12712","6446","6266",
"덕포2동","총인구","2023.06 월","5736","12688","6431","6257",
"덕포2동","총인구","2023.07 월","5731","12657","6421","6236",
"덕포2동","총인구","2023.08 월","5696","12570","6373","6197",
"덕포2동","총인구","2023.09 월","5671","12491","6340","6151",
"덕포2동","총인구","2023.10 월","5663","12434","6320","6114",
"덕포2동","총인구","2023.11 월","5649","12416","6301","6115",
"덕포2동","총인구","2023.12 월","5650","12419","6312","6107",
"덕포2동","총인구","2024.01 월","5647","12423","6322","6101",
"덕포2동","총인구","2024.02 월","5637","12372","6293","6079",
"덕포2동","총인구","2024.03 월","5639","12344","6274","6070",
"덕포2동","총인구","2024.04 월","5632","12319","6258","6061",
"덕포2동","총인구","2024.05 월","5641","12309","6250","6059",
"덕포2동","총인구","2024.06 월","5651","12316","6244","6072",
"덕포2동","총인구","2024.07 월","5647","12295","6231","6064",
"덕포2동","총인구","2024.08 월","5633","12277","6213","6064",
"덕포2동","총인구","2024.09 월","5627","12245","6199","6046",
"덕포2동","총인구","2024.10 월","5612","12193","6167","6026",
"덕포2동","총인구","2024.11 월","5613","12194","6167","6027",
"덕포2동","총인구","2024.12 월","5608","12176","6162","6014",
"괘법동","총인구","2020.01 월","11402","22732","11733","10999",
"괘법동","총인구","2020.02 월","11502","22807","11786","11021",
"괘법동","총인구","2020.03 월","11525","22790","11759","11031",
"괘법동","총인구","2020.04 월","11576","22744","11753","10991",
"괘법동","총인구","2020.05 월","11634","22672","11716","10956",
"괘법동","총인구","2020.06 월","11662","22656","11685","10971",
"괘법동","총인구","2020.07 월","11718","22713","11711","11002",
"괘법동","총인구","2020.08 월","11790","22759","11748","11011",
"괘법동","총인구","2020.09 월","11833","22755","11764","10991",
"괘법동","총인구","2020.10 월","11879","22801","11781","11020",
"괘법동","총인구","2020.11 월","11944","22811","11793","11018",
"괘법동","총인구","2020.12 월","12023","22818","11800","11018",
"괘법동","총인구","2021.01 월","12087","22832","11823","11009",
"괘법동","총인구","2021.02 월","12212","22914","11873","11041",
"괘법동","총인구","2021.03 월","12268","22992","11903","11089",
"괘법동","총인구","2021.04 월","12368","23057","11935","11122",
"괘법동","총인구","2021.05 월","12409","23060","11938","11122",
"괘법동","총인구","2021.06 월","12464","23074","11936","11138",
"괘법동","총인구","2021.07 월","12510","23066","11947","11119",
"괘법동","총인구","2021.08 월","12558","23078","11958","11120",
"괘법동","총인구","2021.09 월","12645","23219","12003","11216",
"괘법동","총인구","2021.10 월","12713","23243","12013","11230",
"괘법동","총인구","2021.11 월","12751","23191","11973","11218",
"괘법동","총인구","2021.12 월","12792","23172","11965","11207",
"괘법동","총인구","2022.01 월","12848","23206","12005","11201",
"괘법동","총인구","2022.02 월","12964","23241","12022","11219",
"괘법동","총인구","2022.03 월","13020","23335","12057","11278",
"괘법동","총인구","2022.04 월","13072","23383","12071","11312",
"괘법동","총인구","2022.05 월","13150","23465","12115","11350",
"괘법동","총인구","2022.06 월","13205","23461","12110","11351",
"괘법동","총인구","2022.07 월","13253","23453","12114","11339",
"괘법동","총인구","2022.08 월","13340","23470","12120","11350",
"괘법동","총인구","2022.09 월","13389","23641","12225","11416",
"괘법동","총인구","2022.10 월","13432","23669","12253","11416",
"괘법동","총인구","2022.11 월","13548","23841","12348","11493",
"괘법동","총인구","2022.12 월","13858","24362","12608","11754",
"괘법동","총인구","2023.01 월","14082","24680","12749","11931",
"괘법동","총인구","2023.02 월","14291","24944","12890","12054",
"괘법동","총인구","2023.03 월","14421","25250","13012","12238",
"괘법동","총인구","2023.04 월","14540","25484","13099","12385",
"괘법동","총인구","2023.05 월","14619","25638","13164","12474",
"괘법동","총인구","2023.06 월","14659","25647","13155","12492",
"괘법동","총인구","2023.07 월","14669","25684","13162","12522",
"괘법동","총인구","2023.08 월","14620","25509","13062","12447",
"괘법동","총인구","2023.09 월","14600","25614","13117","12497",
"괘법동","총인구","2023.10 월","14592","25632","13115","12517",
"괘법동","총인구","2023.11 월","14552","25526","13057","12469",
"괘법동","총인구","2023.12 월","14573","25474","13048","12426",
"괘법동","총인구","2024.01 월","14552","25381","12997","12384",
"괘법동","총인구","2024.02 월","14607","25336","12979","12357",
"괘법동","총인구","2024.03 월","14657","25554","13074","12480",
"괘법동","총인구","2024.04 월","14687","25623","13115","12508",
"괘법동","총인구","2024.05 월","14718","25604","13110","12494",
"괘법동","총인구","2024.06 월","14727","25556","13104","12452",
"괘법동","총인구","2024.07 월","14718","25496","13074","12422",
"괘법동","총인구","2024.08 월","14699","25457","13051","12406",
"괘법동","총인구","2024.09 월","14709","25437","13036","12401",
"괘법동","총인구","2024.10 월","14728","25706","13176","12530",
"괘법동","총인구","2024.11 월","14741","25691","13162","12529",
"괘법동","총인구","2024.12 월","14742","25635","13165","12470",
"감전동","총인구","2020.01 월","7281","14800","7909","6891",
"감전동","총인구","2020.02 월","7299","14783","7896","6887",
"감전동","총인구","2020.03 월","7278","14723","7870","6853",
"감전동","총인구","2020.04 월","7277","14682","7861","6821",
"감전동","총인구","2020.05 월","7281","14630","7836","6794",
"감전동","총인구","2020.06 월","7291","14602","7822","6780",
"감전동","총인구","2020.07 월","7291","14568","7813","6755",
"감전동","총인구","2020.08 월","7286","14483","7759","6724",
"감전동","총인구","2020.09 월","7303","14464","7736","6728",
"감전동","총인구","2020.10 월","7305","14425","7719","6706",
"감전동","총인구","2020.11 월","7304","14387","7701","6686",
"감전동","총인구","2020.12 월","7315","14352","7684","6668",
"감전동","총인구","2021.01 월","7320","14327","7675","6652",
"감전동","총인구","2021.02 월","7315","14267","7642","6625",
"감전동","총인구","2021.03 월","7274","14171","7581","6590",
"감전동","총인구","2021.04 월","7250","14113","7543","6570",
"감전동","총인구","2021.05 월","7230","14037","7505","6532",
"감전동","총인구","2021.06 월","7241","14041","7507","6534",
"감전동","총인구","2021.07 월","7246","14012","7490","6522",
"감전동","총인구","2021.08 월","7222","13924","7439","6485",
"감전동","총인구","2021.09 월","7226","13901","7431","6470",
"감전동","총인구","2021.10 월","7230","13857","7416","6441",
"감전동","총인구","2021.11 월","7239","13848","7413","6435",
"감전동","총인구","2021.12 월","7237","13811","7379","6432",
"감전동","총인구","2022.01 월","7225","13763","7355","6408",
"감전동","총인구","2022.02 월","7230","13716","7320","6396",
"감전동","총인구","2022.03 월","7228","13692","7311","6381",
"감전동","총인구","2022.04 월","7216","13644","7289","6355",
"감전동","총인구","2022.05 월","7222","13638","7282","6356",
"감전동","총인구","2022.06 월","7218","13638","7283","6355",
"감전동","총인구","2022.07 월","7202","13590","7265","6325",
"감전동","총인구","2022.08 월","7192","13585","7271","6314",
"감전동","총인구","2022.09 월","7152","13517","7247","6270",
"감전동","총인구","2022.10 월","7137","13458","7211","6247",
"감전동","총인구","2022.11 월","7130","13444","7212","6232",
"감전동","총인구","2022.12 월","7107","13354","7170","6184",
"감전동","총인구","2023.01 월","7097","13315","7143","6172",
"감전동","총인구","2023.02 월","7086","13270","7117","6153",
"감전동","총인구","2023.03 월","7076","13211","7085","6126",
"감전동","총인구","2023.04 월","7049","13163","7063","6100",
"감전동","총인구","2023.05 월","7018","13093","7034","6059",
"감전동","총인구","2023.06 월","7012","13081","7029","6052",
"감전동","총인구","2023.07 월","7000","13073","7026","6047",
"감전동","총인구","2023.08 월","6984","13012","6999","6013",
"감전동","총인구","2023.09 월","6963","12962","6966","5996",
"감전동","총인구","2023.10 월","6920","12866","6919","5947",
"감전동","총인구","2023.11 월","6919","12836","6894","5942",
"감전동","총인구","2023.12 월","6903","12799","6879","5920",
"감전동","총인구","2024.01 월","6872","12738","6843","5895",
"감전동","총인구","2024.02 월","6885","12708","6833","5875",
"감전동","총인구","2024.03 월","6880","12662","6819","5843",
"감전동","총인구","2024.04 월","6876","12629","6799","5830",
"감전동","총인구","2024.05 월","6874","12596","6778","5818",
"감전동","총인구","2024.06 월","6862","12600","6783","5817",
"감전동","총인구","2024.07 월","6856","12536","6749","5787",
"감전동","총인구","2024.08 월","6840","12477","6720","5757",
"감전동","총인구","2024.09 월","6836","12449","6700","5749",
"감전동","총인구","2024.10 월","6823","12432","6693","5739",
"감전동","총인구","2024.11 월","6811","12387","6661","5726",
"감전동","총인구","2024.12 월","6799","12353","6633","5720",
"주례1동","총인구","2020.01 월","6454","16147","8269","7878",
"주례1동","총인구","2020.02 월","6449","16133","8263","7870",
"주례1동","총인구","2020.03 월","6436","16084","8228","7856",
"주례1동","총인구","2020.04 월","6438","16042","8206","7836",
"주례1동","총인구","2020.05 월","6432","15989","8170","7819",
"주례1동","총인구","2020.06 월","6423","15953","8145","7808",
"주례1동","총인구","2020.07 월","6421","15923","8126","7797",
"주례1동","총인구","2020.08 월","6405","15870","8099","7771",
"주례1동","총인구","2020.09 월","6409","15827","8081","7746",
"주례1동","총인구","2020.10 월","6400","15776","8061","7715",
"주례1동","총인구","2020.11 월","6415","15766","8055","7711",
"주례1동","총인구","2020.12 월","6413","15651","8002","7649",
"주례1동","총인구","2021.01 월","6425","15605","7985","7620",
"주례1동","총인구","2021.02 월","6449","15627","7994","7633",
"주례1동","총인구","2021.03 월","6421","15552","7951","7601",
"주례1동","총인구","2021.04 월","6435","15548","7952","7596",
"주례1동","총인구","2021.05 월","6439","15522","7937","7585",
"주례1동","총인구","2021.06 월","6431","15447","7896","7551",
"주례1동","총인구","2021.07 월","6434","15406","7874","7532",
"주례1동","총인구","2021.08 월","6424","15358","7838","7520",
"주례1동","총인구","2021.09 월","6430","15339","7831","7508",
"주례1동","총인구","2021.10 월","6431","15332","7826","7506",
"주례1동","총인구","2021.11 월","6430","15301","7808","7493",
"주례1동","총인구","2021.12 월","6436","15253","7778","7475",
"주례1동","총인구","2022.01 월","6421","15188","7739","7449",
"주례1동","총인구","2022.02 월","6406","15143","7708","7435",
"주례1동","총인구","2022.03 월","6404","15116","7688","7428",
"주례1동","총인구","2022.04 월","6396","15074","7664","7410",
"주례1동","총인구","2022.05 월","6401","15053","7669","7384",
"주례1동","총인구","2022.06 월","6406","15035","7674","7361",
"주례1동","총인구","2022.07 월","6402","14999","7651","7348",
"주례1동","총인구","2022.08 월","6399","14970","7632","7338",
"주례1동","총인구","2022.09 월","6380","14918","7597","7321",
"주례1동","총인구","2022.10 월","6377","14872","7567","7305",
"주례1동","총인구","2022.11 월","6656","15605","7921","7684",
"주례1동","총인구","2022.12 월","6908","16264","8239","8025",
"주례1동","총인구","2023.01 월","7008","16560","8389","8171",
"주례1동","총인구","2023.02 월","7078","16653","8417","8236",
"주례1동","총인구","2023.03 월","7105","16672","8424","8248",
"주례1동","총인구","2023.04 월","7131","16730","8452","8278",
"주례1동","총인구","2023.05 월","7147","16776","8491","8285",
"주례1동","총인구","2023.06 월","7156","16796","8490","8306",
"주례1동","총인구","2023.07 월","7172","16809","8491","8318",
"주례1동","총인구","2023.08 월","7168","16799","8483","8316",
"주례1동","총인구","2023.09 월","7173","16785","8482","8303",
"주례1동","총인구","2023.10 월","7148","16723","8450","8273",
"주례1동","총인구","2023.11 월","7154","16721","8455","8266",
"주례1동","총인구","2023.12 월","7140","16685","8445","8240",
"주례1동","총인구","2024.01 월","7125","16640","8433","8207",
"주례1동","총인구","2024.02 월","7105","16566","8406","8160",
"주례1동","총인구","2024.03 월","7106","16549","8381","8168",
"주례1동","총인구","2024.04 월","7102","16540","8368","8172",
"주례1동","총인구","2024.05 월","7110","16545","8366","8179",
"주례1동","총인구","2024.06 월","7105","16534","8347","8187",
"주례1동","총인구","2024.07 월","7116","16530","8333","8197",
"주례1동","총인구","2024.08 월","7114","16533","8333","8200",
"주례1동","총인구","2024.09 월","7110","16512","8323","8189",
"주례1동","총인구","2024.10 월","7103","16502","8322","8180",
"주례1동","총인구","2024.11 월","7086","16485","8316","8169",
"주례1동","총인구","2024.12 월","7082","16452","8297","8155",
"주례2동","총인구","2020.01 월","10792","24707","12368","12339",
"주례2동","총인구","2020.02 월","10811","24617","12330","12287",
"주례2동","총인구","2020.03 월","10865","24561","12294","12267",
"주례2동","총인구","2020.04 월","10882","24507","12268","12239",
"주례2동","총인구","2020.05 월","10940","24481","12267","12214",
"주례2동","총인구","2020.06 월","10965","24494","12297","12197",
"주례2동","총인구","2020.07 월","11003","24452","12266","12186",
"주례2동","총인구","2020.08 월","11021","24338","12199","12139",
"주례2동","총인구","2020.09 월","11056","24347","12185","12162",
"주례2동","총인구","2020.10 월","11068","24302","12152","12150",
"주례2동","총인구","2020.11 월","11073","24316","12148","12168",
"주례2동","총인구","2020.12 월","11090","24238","12084","12154",
"주례2동","총인구","2021.01 월","11071","24118","12030","12088",
"주례2동","총인구","2021.02 월","11150","24096","12027","12069",
"주례2동","총인구","2021.03 월","11189","24147","12047","12100",
"주례2동","총인구","2021.04 월","11199","24189","12071","12118",
"주례2동","총인구","2021.05 월","11224","24173","12075","12098",
"주례2동","총인구","2021.06 월","11204","24083","12026","12057",
"주례2동","총인구","2021.07 월","11247","24071","12015","12056",
"주례2동","총인구","2021.08 월","11239","23942","11979","11963",
"주례2동","총인구","2021.09 월","11297","24099","12034","12065",
"주례2동","총인구","2021.10 월","11320","24148","12030","12118",
"주례2동","총인구","2021.11 월","11308","24092","12009","12083",
"주례2동","총인구","2021.12 월","11285","23943","11949","11994",
"주례2동","총인구","2022.01 월","11256","23842","11907","11935",
"주례2동","총인구","2022.02 월","11275","23690","11834","11856",
"주례2동","총인구","2022.03 월","11319","23864","11861","12003",
"주례2동","총인구","2022.04 월","11334","23820","11856","11964",
"주례2동","총인구","2022.05 월","11345","23801","11851","11950",
"주례2동","총인구","2022.06 월","11354","23736","11824","11912",
"주례2동","총인구","2022.07 월","11355","23680","11785","11895",
"주례2동","총인구","2022.08 월","11403","23631","11782","11849",
"주례2동","총인구","2022.09 월","11234","23555","11704","11851",
"주례2동","총인구","2022.10 월","11221","23494","11686","11808",
"주례2동","총인구","2022.11 월","11173","23381","11662","11719",
"주례2동","총인구","2022.12 월","11121","23220","11583","11637",
"주례2동","총인구","2023.01 월","11093","23080","11527","11553",
"주례2동","총인구","2023.02 월","11181","23058","11516","11542",
"주례2동","총인구","2023.03 월","11239","23388","11583","11805",
"주례2동","총인구","2023.04 월","11253","23391","11595","11796",
"주례2동","총인구","2023.05 월","11278","23428","11615","11813",
"주례2동","총인구","2023.06 월","11294","23374","11608","11766",
"주례2동","총인구","2023.07 월","11320","23361","11601","11760",
"주례2동","총인구","2023.08 월","11352","23329","11590","11739",
"주례2동","총인구","2023.09 월","11378","23648","11740","11908",
"주례2동","총인구","2023.10 월","11372","23546","11675","11871",
"주례2동","총인구","2023.11 월","11346","23469","11643","11826",
"주례2동","총인구","2023.12 월","11326","23380","11620","11760",
"주례2동","총인구","2024.01 월","11264","23392","11600","11792",
"주례2동","총인구","2024.02 월","11346","23366","11563","11803",
"주례2동","총인구","2024.03 월","11403","23606","11610","11996",
"주례2동","총인구","2024.04 월","11396","23533","11620","11913",
"주례2동","총인구","2024.05 월","11408","23570","11655","11915",
"주례2동","총인구","2024.06 월","11390","23476","11579","11897",
"주례2동","총인구","2024.07 월","11377","23433","11558","11875",
"주례2동","총인구","2024.08 월","11389","23338","11539","11799",
"주례2동","총인구","2024.09 월","11383","23590","11649","11941",
"주례2동","총인구","2024.10 월","11368","23527","11632","11895",
"주례2동","총인구","2024.11 월","11359","23526","11653","11873",
"주례2동","총인구","2024.12 월","11323","23376","11590","11786",
"주례3동","총인구","2020.01 월","5705","13865","6801","7064",
"주례3동","총인구","2020.02 월","5703","13841","6788","7053",
"주례3동","총인구","2020.03 월","5680","13776","6767","7009",
"주례3동","총인구","2020.04 월","5672","13714","6737","6977",
"주례3동","총인구","2020.05 월","5670","13683","6723","6960",
"주례3동","총인구","2020.06 월","5695","13703","6737","6966",
"주례3동","총인구","2020.07 월","5695","13663","6709","6954",
"주례3동","총인구","2020.08 월","5683","13604","6672","6932",
"주례3동","총인구","2020.09 월","5681","13582","6657","6925",
"주례3동","총인구","2020.10 월","5677","13536","6632","6904",
"주례3동","총인구","2020.11 월","5678","13498","6606","6892",
"주례3동","총인구","2020.12 월","5709","13503","6609","6894",
"주례3동","총인구","2021.01 월","5725","13489","6601","6888",
"주례3동","총인구","2021.02 월","5730","13437","6586","6851",
"주례3동","총인구","2021.03 월","5711","13370","6557","6813",
"주례3동","총인구","2021.04 월","5708","13343","6529","6814",
"주례3동","총인구","2021.05 월","5703","13321","6511","6810",
"주례3동","총인구","2021.06 월","5705","13289","6493","6796",
"주례3동","총인구","2021.07 월","5698","13249","6472","6777",
"주례3동","총인구","2021.08 월","5711","13227","6463","6764",
"주례3동","총인구","2021.09 월","5712","13231","6469","6762",
"주례3동","총인구","2021.10 월","5720","13247","6477","6770",
"주례3동","총인구","2021.11 월","5734","13255","6479","6776",
"주례3동","총인구","2021.12 월","5741","13241","6479","6762",
"주례3동","총인구","2022.01 월","5720","13199","6461","6738",
"주례3동","총인구","2022.02 월","5707","13147","6433","6714",
"주례3동","총인구","2022.03 월","5716","13126","6418","6708",
"주례3동","총인구","2022.04 월","5705","13080","6401","6679",
"주례3동","총인구","2022.05 월","5713","13075","6387","6688",
"주례3동","총인구","2022.06 월","5707","13043","6372","6671",
"주례3동","총인구","2022.07 월","5707","13012","6347","6665",
"주례3동","총인구","2022.08 월","5713","13009","6336","6673",
"주례3동","총인구","2022.09 월","5706","12992","6325","6667",
"주례3동","총인구","2022.10 월","5699","12956","6291","6665",
"주례3동","총인구","2022.11 월","5668","12844","6247","6597",
"주례3동","총인구","2022.12 월","5631","12726","6205","6521",
"주례3동","총인구","2023.01 월","5619","12698","6188","6510",
"주례3동","총인구","2023.02 월","5614","12636","6157","6479",
"주례3동","총인구","2023.03 월","5612","12585","6135","6450",
"주례3동","총인구","2023.04 월","5620","12572","6121","6451",
"주례3동","총인구","2023.05 월","5630","12568","6123","6445",
"주례3동","총인구","2023.06 월","5614","12520","6090","6430",
"주례3동","총인구","2023.07 월","5604","12492","6073","6419",
"주례3동","총인구","2023.08 월","5600","12438","6034","6404",
"주례3동","총인구","2023.09 월","5594","12415","6024","6391",
"주례3동","총인구","2023.10 월","5581","12371","6012","6359",
"주례3동","총인구","2023.11 월","5594","12380","6015","6365",
"주례3동","총인구","2023.12 월","5598","12383","6026","6357",
"주례3동","총인구","2024.01 월","5589","12324","5994","6330",
"주례3동","총인구","2024.02 월","5588","12309","5983","6326",
"주례3동","총인구","2024.03 월","5577","12261","5953","6308",
"주례3동","총인구","2024.04 월","5569","12246","5945","6301",
"주례3동","총인구","2024.05 월","5572","12230","5936","6294",
"주례3동","총인구","2024.06 월","5574","12232","5941","6291",
"주례3동","총인구","2024.07 월","5567","12193","5919","6274",
"주례3동","총인구","2024.08 월","5559","12141","5883","6258",
"주례3동","총인구","2024.09 월","5565","12135","5880","6255",
"주례3동","총인구","2024.10 월","5546","12105","5867","6238",
"주례3동","총인구","2024.11 월","5535","12028","5820","6208",
"주례3동","총인구","2024.12 월","5527","12006","5797","6209",
"학장동","총인구","2020.01 월","12186","30706","15511","15195",
"학장동","총인구","2020.02 월","12173","30609","15463","15146",
"학장동","총인구","2020.03 월","12176","30553","15441","15112",
"학장동","총인구","2020.04 월","12158","30463","15383","15080",
"학장동","총인구","2020.05 월","12151","30331","15316","15015",
"학장동","총인구","2020.06 월","12140","30201","15245","14956",
"학장동","총인구","2020.07 월","12133","30122","15207","14915",
"학장동","총인구","2020.08 월","12132","30015","15153","14862",
"학장동","총인구","2020.09 월","12134","29895","15101","14794",
"학장동","총인구","2020.10 월","12136","29821","15069","14752",
"학장동","총인구","2020.11 월","12130","29665","14994","14671",
"학장동","총인구","2020.12 월","12129","29572","14946","14626",
"학장동","총인구","2021.01 월","12151","29521","14903","14618",
"학장동","총인구","2021.02 월","12163","29500","14892","14608",
"학장동","총인구","2021.03 월","12132","29358","14809","14549",
"학장동","총인구","2021.04 월","12140","29271","14769","14502",
"학장동","총인구","2021.05 월","12121","29157","14706","14451",
"학장동","총인구","2021.06 월","12141","29148","14703","14445",
"학장동","총인구","2021.07 월","12145","29064","14664","14400",
"학장동","총인구","2021.08 월","12137","28992","14625","14367",
"학장동","총인구","2021.09 월","12137","28940","14588","14352",
"학장동","총인구","2021.10 월","12158","28918","14590","14328",
"학장동","총인구","2021.11 월","12165","28901","14572","14329",
"학장동","총인구","2021.12 월","12171","28860","14542","14318",
"학장동","총인구","2022.01 월","12145","28777","14497","14280",
"학장동","총인구","2022.02 월","12139","28660","14435","14225",
"학장동","총인구","2022.03 월","12145","28624","14395","14229",
"학장동","총인구","2022.04 월","12145","28576","14357","14219",
"학장동","총인구","2022.05 월","12134","28493","14305","14188",
"학장동","총인구","2022.06 월","12157","28478","14291","14187",
"학장동","총인구","2022.07 월","12152","28415","14263","14152",
"학장동","총인구","2022.08 월","12144","28320","14213","14107",
"학장동","총인구","2022.09 월","12141","28252","14158","14094",
"학장동","총인구","2022.10 월","12141","28196","14134","14062",
"학장동","총인구","2022.11 월","12124","28115","14072","14043",
"학장동","총인구","2022.12 월","12104","27974","14003","13971",
"학장동","총인구","2023.01 월","12111","27889","13954","13935",
"학장동","총인구","2023.02 월","12089","27775","13879","13896",
"학장동","총인구","2023.03 월","12064","27691","13845","13846",
"학장동","총인구","2023.04 월","12070","27692","13833","13859",
"학장동","총인구","2023.05 월","12047","27615","13792","13823",
"학장동","총인구","2023.06 월","12047","27576","13776","13800",
"학장동","총인구","2023.07 월","12031","27525","13747","13778",
"학장동","총인구","2023.08 월","12021","27425","13704","13721",
"학장동","총인구","2023.09 월","12019","27353","13660","13693",
"학장동","총인구","2023.10 월","11993","27222","13582","13640",
"학장동","총인구","2023.11 월","11990","27155","13539","13616",
"학장동","총인구","2023.12 월","11991","27153","13559","13594",
"학장동","총인구","2024.01 월","11996","27103","13531","13572",
"학장동","총인구","2024.02 월","12000","27028","13487","13541",
"학장동","총인구","2024.03 월","12007","26994","13462","13532",
"학장동","총인구","2024.04 월","12019","26945","13435","13510",
"학장동","총인구","2024.05 월","12022","26911","13420","13491",
"학장동","총인구","2024.06 월","12014","26874","13392","13482",
"학장동","총인구","2024.07 월","11999","26835","13363","13472",
"학장동","총인구","2024.08 월","11980","26769","13325","13444",
"학장동","총인구","2024.09 월","11972","26693","13292","13401",
"학장동","총인구","2024.10 월","11968","26671","13283","13388",
"학장동","총인구","2024.11 월","11981","26628","13253","13375",
"학장동","총인구","2024.12 월","11975","26574","13241","13333",
"엄궁동","총인구","2020.01 월","10771","29250","14673","14577",
"엄궁동","총인구","2020.02 월","10767","29213","14653","14560",
"엄궁동","총인구","2020.03 월","10763","29101","14588","14513",
"엄궁동","총인구","2020.04 월","10750","29046","14561","14485",
"엄궁동","총인구","2020.05 월","10740","28965","14523","14442",
"엄궁동","총인구","2020.06 월","10740","28925","14507","14418",
"엄궁동","총인구","2020.07 월","10732","28850","14474","14376",
"엄궁동","총인구","2020.08 월","10721","28726","14414","14312",
"엄궁동","총인구","2020.09 월","10717","28639","14339","14300",
"엄궁동","총인구","2020.10 월","10683","28468","14248","14220",
"엄궁동","총인구","2020.11 월","10689","28377","14190","14187",
"엄궁동","총인구","2020.12 월","10694","28293","14145","14148",
"엄궁동","총인구","2021.01 월","10682","28194","14079","14115",
"엄궁동","총인구","2021.02 월","10679","28131","14052","14079",
"엄궁동","총인구","2021.03 월","10597","27993","13988","14005",
"엄궁동","총인구","2021.04 월","10596","27929","13946","13983",
"엄궁동","총인구","2021.05 월","10609","27887","13929","13958",
"엄궁동","총인구","2021.06 월","10594","27805","13887","13918",
"엄궁동","총인구","2021.07 월","10598","27767","13872","13895",
"엄궁동","총인구","2021.08 월","10589","27668","13829","13839",
"엄궁동","총인구","2021.09 월","10603","27630","13802","13828",
"엄궁동","총인구","2021.10 월","10582","27517","13739","13778",
"엄궁동","총인구","2021.11 월","10559","27427","13677","13750",
"엄궁동","총인구","2021.12 월","10551","27340","13637","13703",
"엄궁동","총인구","2022.01 월","10532","27204","13567","13637",
"엄궁동","총인구","2022.02 월","10514","27045","13504","13541",
"엄궁동","총인구","2022.03 월","10494","26953","13460","13493",
"엄궁동","총인구","2022.04 월","10485","26913","13440","13473",
"엄궁동","총인구","2022.05 월","10476","26806","13381","13425",
"엄궁동","총인구","2022.06 월","10448","26724","13344","13380",
"엄궁동","총인구","2022.07 월","10387","26597","13277","13320",
"엄궁동","총인구","2022.08 월","10286","26379","13165","13214",
"엄궁동","총인구","2022.09 월","10173","26161","13057","13104",
"엄궁동","총인구","2022.10 월","10082","25948","12958","12990",
"엄궁동","총인구","2022.11 월","10029","25814","12888","12926",
"엄궁동","총인구","2022.12 월","9973","25686","12825","12861",
"엄궁동","총인구","2023.01 월","9942","25540","12753","12787",
"엄궁동","총인구","2023.02 월","9921","25445","12715","12730",
"엄궁동","총인구","2023.03 월","9888","25326","12641","12685",
"엄궁동","총인구","2023.04 월","9879","25250","12606","12644",
"엄궁동","총인구","2023.05 월","9873","25222","12584","12638",
"엄궁동","총인구","2023.06 월","9857","25125","12529","12596",
"엄궁동","총인구","2023.07 월","9848","25080","12508","12572",
"엄궁동","총인구","2023.08 월","9823","24996","12468","12528",
"엄궁동","총인구","2023.09 월","9807","24932","12426","12506",
"엄궁동","총인구","2023.10 월","9805","24895","12406","12489",
"엄궁동","총인구","2023.11 월","9786","24853","12380","12473",
"엄궁동","총인구","2023.12 월","9773","24784","12343","12441",
"엄궁동","총인구","2024.01 월","9743","24702","12304","12398",
"엄궁동","총인구","2024.02 월","9730","24633","12273","12360",
"엄궁동","총인구","2024.03 월","9728","24581","12243","12338",
"엄궁동","총인구","2024.04 월","9711","24538","12206","12332",
"엄궁동","총인구","2024.05 월","9697","24510","12193","12317",
"엄궁동","총인구","2024.06 월","9692","24440","12159","12281",
"엄궁동","총인구","2024.07 월","9660","24336","12095","12241",
"엄궁동","총인구","2024.08 월","9653","24283","12085","12198",
"엄궁동","총인구","2024.09 월","9645","24242","12068","12174",
"엄궁동","총인구","2024.10 월","9619","24145","12031","12114",
"엄궁동","총인구","2024.11 월","9608","24111","12028","12083",
"엄궁동","총인구","2024.12 월","9611","24114","12027","12087",
"기장군","총인구","2020.01 월","69244","166943","83126","83817",
"기장군","총인구","2020.02 월","70005","168560","83878","84682",
"기장군","총인구","2020.03 월","70686","169797","84487","85310",
"기장군","총인구","2020.04 월","71059","170313","84740","85573",
"기장군","총인구","2020.05 월","71661","171301","85207","86094",
"기장군","총인구","2020.06 월","72166","172280","85639","86641",
"기장군","총인구","2020.07 월","72804","173495","86236","87259",
"기장군","총인구","2020.08 월","73320","174425","86717","87708",
"기장군","총인구","2020.09 월","73657","174882","86962","87920",
"기장군","총인구","2020.10 월","73915","175259","87135","88124",
"기장군","총인구","2020.11 월","74280","176013","87529","88484",
"기장군","총인구","2020.12 월","74649","176635","87811","88824",
"기장군","총인구","2021.01 월","75182","177505","88202","89303",
"기장군","총인구","2021.02 월","75533","178176","88533","89643",
"기장군","총인구","2021.03 월","75496","178121","88509","89612",
"기장군","총인구","2021.04 월","75708","178323","88616","89707",
"기장군","총인구","2021.05 월","75858","178443","88672","89771",
"기장군","총인구","2021.06 월","76058","178637","88783","89854",
"기장군","총인구","2021.07 월","76241","178812","88852","89960",
"기장군","총인구","2021.08 월","76369","178840","88837","90003",
"기장군","총인구","2021.09 월","76434","178822","88790","90032",
"기장군","총인구","2021.10 월","76577","178898","88810","90088",
"기장군","총인구","2021.11 월","76725","179202","88960","90242",
"기장군","총인구","2021.12 월","76853","179174","88992","90182",
"기장군","총인구","2022.01 월","76901","178998","88883","90115",
"기장군","총인구","2022.02 월","76959","178779","88781","89998",
"기장군","총인구","2022.03 월","77015","178618","88723","89895",
"기장군","총인구","2022.04 월","77093","178558","88691","89867",
"기장군","총인구","2022.05 월","77472","178883","88867","90016",
"기장군","총인구","2022.06 월","77954","179607","89238","90369",
"기장군","총인구","2022.07 월","78044","179751","89281","90470",
"기장군","총인구","2022.08 월","78169","179819","89311","90508",
"기장군","총인구","2022.09 월","78402","180339","89556","90783",
"기장군","총인구","2022.10 월","78528","180428","89604","90824",
"기장군","총인구","2022.11 월","78629","180652","89717","90935",
"기장군","총인구","2022.12 월","78736","180878","89880","90998",
"기장군","총인구","2023.01 월","78917","181365","90096","91269",
"기장군","총인구","2023.02 월","79089","181611","90253","91358",
"기장군","총인구","2023.03 월","79179","181475","90243","91232",
"기장군","총인구","2023.04 월","79487","181742","90360","91382",
"기장군","총인구","2023.05 월","79623","181897","90429","91468",
"기장군","총인구","2023.06 월","79691","181873","90476","91397",
"기장군","총인구","2023.07 월","79745","181833","90452","91381",
"기장군","총인구","2023.08 월","79823","181811","90457","91354",
"기장군","총인구","2023.09 월","79864","181836","90484","91352",
"기장군","총인구","2023.10 월","79812","181799","90479","91320",
"기장군","총인구","2023.11 월","79779","181696","90456","91240",
"기장군","총인구","2023.12 월","79746","181475","90369","91106",
"기장군","총인구","2024.01 월","79694","181172","90255","90917",
"기장군","총인구","2024.02 월","79730","180776","90113","90663",
"기장군","총인구","2024.03 월","79696","180521","89995","90526",
"기장군","총인구","2024.04 월","79603","180277","89883","90394",
"기장군","총인구","2024.05 월","79637","180260","89913","90347",
"기장군","총인구","2024.06 월","79571","180099","89808","90291",
"기장군","총인구","2024.07 월","79474","179865","89677","90188",
"기장군","총인구","2024.08 월","79499","179658","89573","90085",
"기장군","총인구","2024.09 월","79456","179399","89442","89957",
"기장군","총인구","2024.10 월","79381","179201","89344","89857",
"기장군","총인구","2024.11 월","79261","178901","89183","89718",
"기장군","총인구","2024.12 월","79195","178774","89162","89612",
"기장읍","총인구","2020.01 월","25267","56033","27362","28671",
"기장읍","총인구","2020.02 월","25110","55327","27015","28312",
"기장읍","총인구","2020.03 월","25119","55123","26891","28232",
"기장읍","총인구","2020.04 월","25060","54691","26675","28016",
"기장읍","총인구","2020.05 월","25094","54463","26576","27887",
"기장읍","총인구","2020.06 월","25119","54311","26494","27817",
"기장읍","총인구","2020.07 월","25066","53887","26287","27600",
"기장읍","총인구","2020.08 월","25061","53658","26182","27476",
"기장읍","총인구","2020.09 월","25130","53643","26193","27450",
"기장읍","총인구","2020.10 월","25216","53692","26223","27469",
"기장읍","총인구","2020.11 월","25285","53754","26261","27493",
"기장읍","총인구","2020.12 월","25318","53740","26249","27491",
"기장읍","총인구","2021.01 월","25328","53564","26158","27406",
"기장읍","총인구","2021.02 월","25326","53382","26072","27310",
"기장읍","총인구","2021.03 월","25206","53215","26009","27206",
"기장읍","총인구","2021.04 월","25219","53200","26001","27199",
"기장읍","총인구","2021.05 월","25241","53168","25977","27191",
"기장읍","총인구","2021.06 월","25290","53184","25978","27206",
"기장읍","총인구","2021.07 월","25334","53258","26002","27256",
"기장읍","총인구","2021.08 월","25375","53249","25997","27252",
"기장읍","총인구","2021.09 월","25398","53220","25974","27246",
"기장읍","총인구","2021.10 월","25499","53323","26015","27308",
"기장읍","총인구","2021.11 월","25556","53410","26055","27355",
"기장읍","총인구","2021.12 월","25598","53378","26043","27335",
"기장읍","총인구","2022.01 월","25651","53378","26041","27337",
"기장읍","총인구","2022.02 월","25709","53372","26050","27322",
"기장읍","총인구","2022.03 월","25737","53307","26012","27295",
"기장읍","총인구","2022.04 월","25786","53308","25992","27316",
"기장읍","총인구","2022.05 월","25755","53068","25888","27180",
"기장읍","총인구","2022.06 월","25672","52741","25708","27033",
"기장읍","총인구","2022.07 월","25650","52649","25649","27000",
"기장읍","총인구","2022.08 월","25757","52759","25697","27062",
"기장읍","총인구","2022.09 월","26047","53391","26022","27369",
"기장읍","총인구","2022.10 월","26176","53636","26127","27509",
"기장읍","총인구","2022.11 월","26174","53613","26124","27489",
"기장읍","총인구","2022.12 월","26169","53620","26155","27465",
"기장읍","총인구","2023.01 월","26210","53694","26194","27500",
"기장읍","총인구","2023.02 월","26274","53781","26235","27546",
"기장읍","총인구","2023.03 월","26237","53624","26181","27443",
"기장읍","총인구","2023.04 월","26187","53507","26123","27384",
"기장읍","총인구","2023.05 월","26138","53336","26042","27294",
"기장읍","총인구","2023.06 월","26102","53255","26024","27231",
"기장읍","총인구","2023.07 월","26086","53157","25970","27187",
"기장읍","총인구","2023.08 월","26058","53045","25916","27129",
"기장읍","총인구","2023.09 월","26078","53040","25909","27131",
"기장읍","총인구","2023.10 월","26042","52958","25873","27085",
"기장읍","총인구","2023.11 월","26022","52909","25866","27043",
"기장읍","총인구","2023.12 월","26016","52840","25841","26999",
"기장읍","총인구","2024.01 월","26000","52758","25810","26948",
"기장읍","총인구","2024.02 월","25969","52620","25774","26846",
"기장읍","총인구","2024.03 월","25963","52560","25741","26819",
"기장읍","총인구","2024.04 월","25923","52436","25697","26739",
"기장읍","총인구","2024.05 월","25957","52445","25701","26744",
"기장읍","총인구","2024.06 월","25906","52338","25635","26703",
"기장읍","총인구","2024.07 월","25871","52237","25571","26666",
"기장읍","총인구","2024.08 월","25855","52088","25477","26611",
"기장읍","총인구","2024.09 월","25820","51979","25415","26564",
"기장읍","총인구","2024.10 월","25801","51965","25406","26559",
"기장읍","총인구","2024.11 월","25784","51870","25351","26519",
"기장읍","총인구","2024.12 월","25773","51832","25358","26474",
"장안읍","총인구","2020.01 월","4713","9382","5171","4211",
"장안읍","총인구","2020.02 월","4701","9315","5139","4176",
"장안읍","총인구","2020.03 월","4714","9264","5117","4147",
"장안읍","총인구","2020.04 월","4692","9207","5084","4123",
"장안읍","총인구","2020.05 월","4670","9133","5030","4103",
"장안읍","총인구","2020.06 월","4678","9133","5016","4117",
"장안읍","총인구","2020.07 월","4677","9122","5003","4119",
"장안읍","총인구","2020.08 월","4677","9106","5000","4106",
"장안읍","총인구","2020.09 월","4680","9086","4980","4106",
"장안읍","총인구","2020.10 월","4679","9039","4957","4082",
"장안읍","총인구","2020.11 월","4674","9009","4938","4071",
"장안읍","총인구","2020.12 월","4676","9003","4931","4072",
"장안읍","총인구","2021.01 월","4706","9010","4935","4075",
"장안읍","총인구","2021.02 월","4722","9026","4957","4069",
"장안읍","총인구","2021.03 월","4660","8921","4904","4017",
"장안읍","총인구","2021.04 월","4672","8902","4895","4007",
"장안읍","총인구","2021.05 월","4664","8883","4882","4001",
"장안읍","총인구","2021.06 월","4690","8912","4908","4004",
"장안읍","총인구","2021.07 월","4716","8926","4917","4009",
"장안읍","총인구","2021.08 월","4720","8918","4923","3995",
"장안읍","총인구","2021.09 월","4713","8892","4910","3982",
"장안읍","총인구","2021.10 월","4732","8925","4938","3987",
"장안읍","총인구","2021.11 월","4722","8930","4937","3993",
"장안읍","총인구","2021.12 월","4732","8949","4947","4002",
"장안읍","총인구","2022.01 월","4718","8902","4919","3983",
"장안읍","총인구","2022.02 월","4704","8890","4922","3968",
"장안읍","총인구","2022.03 월","4731","8924","4947","3977",
"장안읍","총인구","2022.04 월","4720","8876","4922","3954",
"장안읍","총인구","2022.05 월","4716","8847","4913","3934",
"장안읍","총인구","2022.06 월","4708","8801","4889","3912",
"장안읍","총인구","2022.07 월","4713","8811","4895","3916",
"장안읍","총인구","2022.08 월","4709","8812","4889","3923",
"장안읍","총인구","2022.09 월","4701","8793","4883","3910",
"장안읍","총인구","2022.10 월","4728","8798","4893","3905",
"장안읍","총인구","2022.11 월","4867","9009","5002","4007",
"장안읍","총인구","2022.12 월","4946","9143","5071","4072",
"장안읍","총인구","2023.01 월","4969","9194","5099","4095",
"장안읍","총인구","2023.02 월","4989","9225","5121","4104",
"장안읍","총인구","2023.03 월","5008","9268","5150","4118",
"장안읍","총인구","2023.04 월","5007","9259","5143","4116",
"장안읍","총인구","2023.05 월","4999","9275","5165","4110",
"장안읍","총인구","2023.06 월","4998","9267","5164","4103",
"장안읍","총인구","2023.07 월","5018","9316","5205","4111",
"장안읍","총인구","2023.08 월","5060","9384","5259","4125",
"장안읍","총인구","2023.09 월","5082","9420","5275","4145",
"장안읍","총인구","2023.10 월","5067","9404","5267","4137",
"장안읍","총인구","2023.11 월","5067","9413","5276","4137",
"장안읍","총인구","2023.12 월","5058","9423","5303","4120",
"장안읍","총인구","2024.01 월","5048","9416","5308","4108",
"장안읍","총인구","2024.02 월","5052","9418","5326","4092",
"장안읍","총인구","2024.03 월","5041","9410","5327","4083",
"장안읍","총인구","2024.04 월","5031","9407","5318","4089",
"장안읍","총인구","2024.05 월","5021","9423","5339","4084",
"장안읍","총인구","2024.06 월","5024","9433","5336","4097",
"장안읍","총인구","2024.07 월","5007","9429","5339","4090",
"장안읍","총인구","2024.08 월","4989","9414","5336","4078",
"장안읍","총인구","2024.09 월","4984","9379","5318","4061",
"장안읍","총인구","2024.10 월","4966","9369","5313","4056",
"장안읍","총인구","2024.11 월","4937","9321","5289","4032",
"장안읍","총인구","2024.12 월","4941","9342","5312","4030",
"정관읍","총인구","2020.01 월","30904","84087","41696","42391",
"정관읍","총인구","2020.02 월","30823","83553","41389","42164",
"정관읍","총인구","2020.03 월","30940","83636","41422","42214",
"정관읍","총인구","2020.04 월","30929","83443","41357","42086",
"정관읍","총인구","2020.05 월","30941","83267","41274","41993",
"정관읍","총인구","2020.06 월","30946","83246","41249","41997",
"정관읍","총인구","2020.07 월","30947","83068","41172","41896",
"정관읍","총인구","2020.08 월","30977","82997","41139","41858",
"정관읍","총인구","2020.09 월","31013","82946","41129","41817",
"정관읍","총인구","2020.10 월","31045","82910","41095","41815",
"정관읍","총인구","2020.11 월","31137","83084","41200","41884",
"정관읍","총인구","2020.12 월","31205","83056","41195","41861",
"정관읍","총인구","2021.01 월","31246","82896","41106","41790",
"정관읍","총인구","2021.02 월","31266","82735","41020","41715",
"정관읍","총인구","2021.03 월","31322","82682","40975","41707",
"정관읍","총인구","2021.04 월","31402","82701","40981","41720",
"정관읍","총인구","2021.05 월","31458","82693","40991","41702",
"정관읍","총인구","2021.06 월","31512","82737","41033","41704",
"정관읍","총인구","2021.07 월","31605","82733","41022","41711",
"정관읍","총인구","2021.08 월","31662","82707","40984","41723",
"정관읍","총인구","2021.09 월","31709","82744","40972","41772",
"정관읍","총인구","2021.10 월","31745","82745","40969","41776",
"정관읍","총인구","2021.11 월","31815","82842","41021","41821",
"정관읍","총인구","2021.12 월","31904","82889","41085","41804",
"정관읍","총인구","2022.01 월","31906","82802","41051","41751",
"정관읍","총인구","2022.02 월","31917","82619","40960","41659",
"정관읍","총인구","2022.03 월","31922","82547","40923","41624",
"정관읍","총인구","2022.04 월","31950","82535","40920","41615",
"정관읍","총인구","2022.05 월","31993","82498","40910","41588",
"정관읍","총인구","2022.06 월","32032","82404","40885","41519",
"정관읍","총인구","2022.07 월","32013","82306","40831","41475",
"정관읍","총인구","2022.08 월","32042","82195","40771","41424",
"정관읍","총인구","2022.09 월","32020","82140","40732","41408",
"정관읍","총인구","2022.10 월","32027","82054","40706","41348",
"정관읍","총인구","2022.11 월","31968","82000","40682","41318",
"정관읍","총인구","2022.12 월","31972","82001","40704","41297",
"정관읍","총인구","2023.01 월","32022","82144","40755","41389",
"정관읍","총인구","2023.02 월","32051","82123","40770","41353",
"정관읍","총인구","2023.03 월","32040","81938","40694","41244",
"정관읍","총인구","2023.04 월","32028","81903","40690","41213",
"정관읍","총인구","2023.05 월","32054","81942","40703","41239",
"정관읍","총인구","2023.06 월","32054","81889","40708","41181",
"정관읍","총인구","2023.07 월","32054","81868","40706","41162",
"정관읍","총인구","2023.08 월","32097","81865","40705","41160",
"정관읍","총인구","2023.09 월","32096","81855","40709","41146",
"정관읍","총인구","2023.10 월","32084","81836","40703","41133",
"정관읍","총인구","2023.11 월","32050","81760","40671","41089",
"정관읍","총인구","2023.12 월","32020","81607","40597","41010",
"정관읍","총인구","2024.01 월","31959","81423","40519","40904",
"정관읍","총인구","2024.02 월","31936","81086","40347","40739",
"정관읍","총인구","2024.03 월","31896","80903","40240","40663",
"정관읍","총인구","2024.04 월","31835","80789","40190","40599",
"정관읍","총인구","2024.05 월","31800","80707","40156","40551",
"정관읍","총인구","2024.06 월","31772","80606","40111","40495",
"정관읍","총인구","2024.07 월","31717","80497","40043","40454",
"정관읍","총인구","2024.08 월","31755","80444","40033","40411",
"정관읍","총인구","2024.09 월","31740","80330","39987","40343",
"정관읍","총인구","2024.10 월","31708","80178","39913","40265",
"정관읍","총인구","2024.11 월","31646","80025","39839","40186",
"정관읍","총인구","2024.12 월","31599","79884","39777","40107",
"일광읍","총인구","2020.01 월","4470","8994","4626","4368",
"일광읍","총인구","2020.02 월","5501","11996","6110","5886",
"일광읍","총인구","2020.03 월","6053","13445","6859","6586",
"일광읍","총인구","2020.04 월","6523","14692","7460","7232",
"일광읍","총인구","2020.05 월","7116","16233","8201","8032",
"일광읍","총인구","2020.06 월","7569","17370","8746","8624",
"일광읍","총인구","2020.07 월","8262","19237","9656","9581",
"일광읍","총인구","2020.08 월","8746","20493","10281","10212",
"일광읍","총인구","2020.09 월","8971","21061","10557","10504",
"일광읍","총인구","2020.10 월","9126","21499","10774","10725",
"일광읍","총인구","2020.11 월","9324","22038","11032","11006",
"일광읍","총인구","2020.12 월","9576","22696","11327","11369",
"일광읍","총인구","2021.01 월","10035","23924","11909","12015",
"일광읍","총인구","2021.02 월","10359","24949","12401","12548",
"일광읍","총인구","2021.03 월","10457","25235","12548","12687",
"일광읍","총인구","2021.04 월","10558","25473","12675","12798",
"일광읍","총인구","2021.05 월","10636","25672","12764","12908",
"일광읍","총인구","2021.06 월","10695","25792","12810","12982",
"일광읍","총인구","2021.07 월","10713","25902","12864","13038",
"일광읍","총인구","2021.08 월","10738","25975","12882","13093",
"일광읍","총인구","2021.09 월","10743","25992","12892","13100",
"일광읍","총인구","2021.10 월","10738","25966","12868","13098",
"일광읍","총인구","2021.11 월","10742","26029","12897","13132",
"일광읍","총인구","2021.12 월","10728","25983","12871","13112",
"일광읍","총인구","2022.01 월","10731","25950","12832","13118",
"일광읍","총인구","2022.02 월","10734","25955","12824","13131",
"일광읍","총인구","2022.03 월","10717","25909","12810","13099",
"일광읍","총인구","2022.04 월","10723","25903","12815","13088",
"일광읍","총인구","2022.05 월","11101","26570","13129","13441",
"일광읍","총인구","2022.06 월","11648","27794","13745","14049",
"일광읍","총인구","2022.07 월","11774","28116","13895","14221",
"일광읍","총인구","2022.08 월","11772","28197","13943","14254",
"일광읍","총인구","2022.09 월","11745","28185","13931","14254",
"일광읍","총인구","2022.10 월","11724","28145","13917","14228",
"일광읍","총인구","2022.11 월","11747","28247","13955","14292",
"일광읍","총인구","2022.12 월","11779","28336","13998","14338",
"일광읍","총인구","2023.01 월","11827","28504","14068","14436",
"일광읍","총인구","2023.02 월","11876","28647","14147","14500",
"일광읍","총인구","2023.03 월","11993","28813","14232","14581",
"일광읍","총인구","2023.04 월","12354","29238","14426","14812",
"일광읍","총인구","2023.05 월","12496","29484","14537","14947",
"일광읍","총인구","2023.06 월","12621","29630","14615","15015",
"일광읍","총인구","2023.07 월","12667","29682","14622","15060",
"일광읍","총인구","2023.08 월","12694","29730","14634","15096",
"일광읍","총인구","2023.09 월","12703","29762","14659","15103",
"일광읍","총인구","2023.10 월","12725","29861","14717","15144",
"일광읍","총인구","2023.11 월","12745","29875","14733","15142",
"일광읍","총인구","2023.12 월","12758","29877","14729","15148",
"일광읍","총인구","2024.01 월","12800","29891","14750","15141",
"일광읍","총인구","2024.02 월","12897","29995","14802","15193",
"일광읍","총인구","2024.03 월","12926","30021","14837","15184",
"일광읍","총인구","2024.04 월","12953","30045","14854","15191",
"일광읍","총인구","2024.05 월","13004","30109","14893","15216",
"일광읍","총인구","2024.06 월","13015","30150","14906","15244",
"일광읍","총인구","2024.07 월","13030","30149","14918","15231",
"일광읍","총인구","2024.08 월","13058","30194","14945","15249",
"일광읍","총인구","2024.09 월","13075","30214","14951","15263",
"일광읍","총인구","2024.10 월","13069","30205","14952","15253",
"일광읍","총인구","2024.11 월","13057","30231","14962","15269",
"일광읍","총인구","2024.12 월","13051","30272","14977","15295",
"철마면","총인구","2020.01 월","3890","8447","4271","4176",
"철마면","총인구","2020.02 월","3870","8369","4225","4144",
"철마면","총인구","2020.03 월","3860","8329","4198","4131",
"철마면","총인구","2020.04 월","3855","8280","4164","4116",
"철마면","총인구","2020.05 월","3840","8205","4126","4079",
"철마면","총인구","2020.06 월","3854","8220","4134","4086",
"철마면","총인구","2020.07 월","3852","8181","4118","4063",
"철마면","총인구","2020.08 월","3859","8171","4115","4056",
"철마면","총인구","2020.09 월","3863","8146","4103","4043",
"철마면","총인구","2020.10 월","3849","8119","4086","4033",
"철마면","총인구","2020.11 월","3860","8128","4098","4030",
"철마면","총인구","2020.12 월","3874","8140","4109","4031",
"철마면","총인구","2021.01 월","3867","8111","4094","4017",
"철마면","총인구","2021.02 월","3860","8084","4083","4001",
"철마면","총인구","2021.03 월","3851","8068","4073","3995",
"철마면","총인구","2021.04 월","3857","8047","4064","3983",
"철마면","총인구","2021.05 월","3859","8027","4058","3969",
"철마면","총인구","2021.06 월","3871","8012","4054","3958",
"철마면","총인구","2021.07 월","3873","7993","4047","3946",
"철마면","총인구","2021.08 월","3874","7991","4051","3940",
"철마면","총인구","2021.09 월","3871","7974","4042","3932",
"철마면","총인구","2021.10 월","3863","7939","4020","3919",
"철마면","총인구","2021.11 월","3890","7991","4050","3941",
"철마면","총인구","2021.12 월","3891","7975","4046","3929",
"철마면","총인구","2022.01 월","3895","7966","4040","3926",
"철마면","총인구","2022.02 월","3895","7943","4025","3918",
"철마면","총인구","2022.03 월","3908","7931","4031","3900",
"철마면","총인구","2022.04 월","3914","7936","4042","3894",
"철마면","총인구","2022.05 월","3907","7900","4027","3873",
"철마면","총인구","2022.06 월","3894","7867","4011","3856",
"철마면","총인구","2022.07 월","3894","7869","4011","3858",
"철마면","총인구","2022.08 월","3889","7856","4011","3845",
"철마면","총인구","2022.09 월","3889","7830","3988","3842",
"철마면","총인구","2022.10 월","3873","7795","3961","3834",
"철마면","총인구","2022.11 월","3873","7783","3954","3829",
"철마면","총인구","2022.12 월","3870","7778","3952","3826",
"철마면","총인구","2023.01 월","3889","7829","3980","3849",
"철마면","총인구","2023.02 월","3899","7835","3980","3855",
"철마면","총인구","2023.03 월","3901","7832","3986","3846",
"철마면","총인구","2023.04 월","3911","7835","3978","3857",
"철마면","총인구","2023.05 월","3936","7860","3982","3878",
"철마면","총인구","2023.06 월","3916","7832","3965","3867",
"철마면","총인구","2023.07 월","3920","7810","3949","3861",
"철마면","총인구","2023.08 월","3914","7787","3943","3844",
"철마면","총인구","2023.09 월","3905","7759","3932","3827",
"철마면","총인구","2023.10 월","3894","7740","3919","3821",
"철마면","총인구","2023.11 월","3895","7739","3910","3829",
"철마면","총인구","2023.12 월","3894","7728","3899","3829",
"철마면","총인구","2024.01 월","3887","7684","3868","3816",
"철마면","총인구","2024.02 월","3876","7657","3864","3793",
"철마면","총인구","2024.03 월","3870","7627","3850","3777",
"철마면","총인구","2024.04 월","3861","7600","3824","3776",
"철마면","총인구","2024.05 월","3855","7576","3824","3752",
"철마면","총인구","2024.06 월","3854","7572","3820","3752",
"철마면","총인구","2024.07 월","3849","7553","3806","3747",
"철마면","총인구","2024.08 월","3842","7518","3782","3736",
"철마면","총인구","2024.09 월","3837","7497","3771","3726",
"철마면","총인구","2024.10 월","3837","7484","3760","3724",
"철마면","총인구","2024.11 월","3837","7454","3742","3712",
"철마면","총인구","2024.12 월","3831","7444","3738","3706",
